State,Year,Cause,Male upto 14 years,Male 15-29 years,Male 30-44 years,Male 45-59 years,Male 60 years and above,Total Male,Female upto 14 years,Female 15-29 years,Female 30-44 years,Female 45-59 years,Female 60 years and above,Total Female,Grand Total
TOTAL (ALL INDIA),2013,Bankruptcy or Sudden change in Economic Status,3,412,1076,711,159,2361,2,69,117,93,36,317,2678
TOTAL (ALL INDIA),2013,Suspected/Illicit Relation,2,255,266,109,22,654,12,273,177,38,1,501,1155
TOTAL (ALL INDIA),2013,Cancellation/Non-Settlement of Marriage,0,368,177,28,5,578,1,357,109,29,7,503,1081
TOTAL (ALL INDIA),2013,Not having Children (Barrenness/Impotency),0,66,114,43,7,230,0,188,191,42,2,423,653
TOTAL (ALL INDIA),2013,Illness (Aids/STD),0,74,171,118,57,420,7,35,72,43,13,170,590
TOTAL (ALL INDIA),2013,Cancer,2,41,182,220,125,570,1,24,71,73,42,211,781
TOTAL (ALL INDIA),2013,Paralysis,0,39,89,222,161,511,0,33,70,69,41,213,724
TOTAL (ALL INDIA),2013,Insanity/Mental Illness,52,1454,1787,1349,566,5208,49,916,915,609,309,2798,8006
TOTAL (ALL INDIA),2013,Other Prolonged Illness,69,2057,3371,3182,2142,10821,120,1844,1521,1098,921,5504,16325
TOTAL (ALL INDIA),2013,Death of Dear Person,5,177,182,124,84,572,4,171,130,79,40,424,996
TOTAL (ALL INDIA),2013,Dowry Dispute,0,26,15,22,2,65,10,1630,506,53,3,2202,2267
TOTAL (ALL INDIA),2013,Divorce,0,51,65,41,5,162,0,87,86,27,3,203,365
TOTAL (ALL INDIA),2013,Drug Abuse/Addiction,10,1058,1842,1257,312,4479,1,28,43,30,10,112,4591
TOTAL (ALL INDIA),2013,Failure in Examination,159,1122,99,9,3,1392,100,926,52,1,0,1079,2471
TOTAL (ALL INDIA),2013,Fall in Social Reputation,3,278,402,262,66,1011,7,181,171,72,24,455,1466
TOTAL (ALL INDIA),2013,Family Problems,139,5805,8171,5201,1780,21096,172,4917,3841,1676,623,11229,32325
TOTAL (ALL INDIA),2013,Ideological Causes/Hero Worshipping,5,72,38,17,7,139,2,54,19,5,2,82,221
TOTAL (ALL INDIA),2013,Illegitimate Pregnancy,0,0,0,0,0,0,7,115,30,1,0,153,153
TOTAL (ALL INDIA),2013,Love Affairs,43,1766,665,91,0,2565,77,1464,343,45,1,1930,4495
TOTAL (ALL INDIA),2013,"Physical Abuse (Rape,Incest Etc.)",0,18,23,30,3,74,7,103,69,16,1,196,270
TOTAL (ALL INDIA),2013,Poverty,3,325,571,437,84,1420,0,109,153,124,60,446,1866
TOTAL (ALL INDIA),2013,Professional/Career Problem,1,354,449,305,54,1163,0,75,46,23,4,148,1311
TOTAL (ALL INDIA),2013,Property Dispute,0,206,354,286,43,889,0,69,89,57,12,227,1116
TOTAL (ALL INDIA),2013,Unemployment,8,788,696,275,35,1802,5,147,109,24,3,288,2090
TOTAL (ALL INDIA),2013,Causes Not known,406,4753,5179,3274,1092,14704,317,2709,1920,955,360,6261,20965
TOTAL (ALL INDIA),2013,Other Causes (Please Specify),636,5151,6115,4212,1543,17657,444,3128,2657,1378,574,8181,25838
TOTAL (ALL INDIA),2013,Total,1546,26716,32099,21825,8357,90543,1345,19652,13507,6660,3092,44256,134799
TOTAL (ALL INDIA),2013,Total Illness,123,3665,5600,5091,3051,17530,177,2852,2649,1892,1326,8896,26426
TOTAL (STATES),2013,Bankruptcy or Sudden change in Economic Status,3,409,1068,707,159,2346,2,69,116,91,36,314,2660
TOTAL (STATES),2013,Suspected/Illicit Relation,2,253,263,109,22,649,12,270,177,38,1,498,1147
TOTAL (STATES),2013,Cancellation/Non-Settlement of Marriage,0,359,174,27,5,565,1,350,106,29,7,493,1058
TOTAL (STATES),2013,Not having Children (Barrenness/Impotency),0,65,114,43,7,229,0,186,191,42,2,421,650
TOTAL (STATES),2013,Illness (Aids/STD),0,65,160,87,37,349,7,31,64,40,9,151,500
TOTAL (STATES),2013,Cancer,2,39,180,215,120,556,1,24,71,70,41,207,763
TOTAL (STATES),2013,Paralysis,0,39,89,222,161,511,0,33,70,69,41,213,724
TOTAL (STATES),2013,Insanity/Mental Illness,52,1432,1771,1336,558,5149,49,907,907,607,301,2771,7920
TOTAL (STATES),2013,Other Prolonged Illness,69,2035,3349,3160,2130,10743,119,1831,1512,1093,915,5470,16213
TOTAL (STATES),2013,Death of Dear Person,5,172,182,122,83,564,4,169,127,77,39,416,980
TOTAL (STATES),2013,Dowry Dispute,0,25,15,22,2,64,10,1587,501,53,3,2154,2218
TOTAL (STATES),2013,Divorce,0,51,65,41,5,162,0,85,85,27,3,200,362
TOTAL (STATES),2013,Drug Abuse/Addiction,10,1049,1831,1255,312,4457,1,28,43,30,10,112,4569
TOTAL (STATES),2013,Failure in Examination,158,1092,99,9,3,1361,97,894,52,1,0,1044,2405
TOTAL (STATES),2013,Fall in Social Reputation,3,271,393,256,65,988,7,174,170,72,24,447,1435
TOTAL (STATES),2013,Family Problems,136,5654,7929,5071,1764,20554,168,4773,3756,1660,613,10970,31524
TOTAL (STATES),2013,Ideological Causes/Hero Worshipping,5,72,38,17,7,139,2,54,19,5,2,82,221
TOTAL (STATES),2013,Illegitimate Pregnancy,0,0,0,0,0,0,7,114,30,1,0,152,152
TOTAL (STATES),2013,Love Affairs,42,1707,653,91,0,2493,74,1418,339,45,1,1877,4370
TOTAL (STATES),2013,"Physical Abuse (Rape,Incest Etc.)",0,18,23,30,3,74,7,102,69,16,1,195,269
TOTAL (STATES),2013,Poverty,3,324,568,436,84,1415,0,109,153,124,60,446,1861
TOTAL (STATES),2013,Professional/Career Problem,1,352,448,305,54,1160,0,73,46,23,4,146,1306
TOTAL (STATES),2013,Property Dispute,0,205,352,285,43,885,0,69,89,57,12,227,1112
TOTAL (STATES),2013,Unemployment,8,750,649,272,35,1714,5,145,109,24,3,286,2000
TOTAL (STATES),2013,Causes Not known,395,4481,4974,3143,1033,14026,304,2541,1858,941,358,6002,20028
TOTAL (STATES),2013,Other Causes (Please Specify),624,5030,6009,4157,1506,17326,439,3060,2623,1363,572,8057,25383
TOTAL (STATES),2013,Total,1518,25949,31396,21418,8198,88479,1316,19096,13283,6598,3058,43351,131830
TOTAL (STATES),2013,Total Illness,123,3610,5549,5020,3006,17308,176,2826,2624,1879,1307,8812,26120
TOTAL (UTs),2013,Bankruptcy or Sudden change in Economic Status,0,3,8,4,0,15,0,0,1,2,0,3,18
TOTAL (UTs),2013,Suspected/Illicit Relation,0,2,3,0,0,5,0,3,0,0,0,3,8
TOTAL (UTs),2013,Cancellation/Non-Settlement of Marriage,0,9,3,1,0,13,0,7,3,0,0,10,23
TOTAL (UTs),2013,Not having Children (Barrenness/Impotency),0,1,0,0,0,1,0,2,0,0,0,2,3
TOTAL (UTs),2013,Illness (Aids/STD),0,9,11,31,20,71,0,4,8,3,4,19,90
TOTAL (UTs),2013,Cancer,0,2,2,5,5,14,0,0,0,3,1,4,18
TOTAL (UTs),2013,Paralysis,0,0,0,0,0,0,0,0,0,0,0,0,0
TOTAL (UTs),2013,Insanity/Mental Illness,0,22,16,13,8,59,0,9,8,2,8,27,86
TOTAL (UTs),2013,Other Prolonged Illness,0,22,22,22,12,78,1,13,9,5,6,34,112
TOTAL (UTs),2013,Death of Dear Person,0,5,0,2,1,8,0,2,3,2,1,8,16
TOTAL (UTs),2013,Dowry Dispute,0,1,0,0,0,1,0,43,5,0,0,48,49
TOTAL (UTs),2013,Divorce,0,0,0,0,0,0,0,2,1,0,0,3,3
TOTAL (UTs),2013,Drug Abuse/Addiction,0,9,11,2,0,22,0,0,0,0,0,0,22
TOTAL (UTs),2013,Failure in Examination,1,30,0,0,0,31,3,32,0,0,0,35,66
TOTAL (UTs),2013,Fall in Social Reputation,0,7,9,6,1,23,0,7,1,0,0,8,31
TOTAL (UTs),2013,Family Problems,3,151,242,130,16,542,4,144,85,16,10,259,801
TOTAL (UTs),2013,Ideological Causes/Hero Worshipping,0,0,0,0,0,0,0,0,0,0,0,0,0
TOTAL (UTs),2013,Illegitimate Pregnancy,0,0,0,0,0,0,0,1,0,0,0,1,1
TOTAL (UTs),2013,Love Affairs,1,59,12,0,0,72,3,46,4,0,0,53,125
TOTAL (UTs),2013,"Physical Abuse (Rape,Incest Etc.)",0,0,0,0,0,0,0,1,0,0,0,1,1
TOTAL (UTs),2013,Poverty,0,1,3,1,0,5,0,0,0,0,0,0,5
TOTAL (UTs),2013,Professional/Career Problem,0,2,1,0,0,3,0,2,0,0,0,2,5
TOTAL (UTs),2013,Property Dispute,0,1,2,1,0,4,0,0,0,0,0,0,4
TOTAL (UTs),2013,Unemployment,0,38,47,3,0,88,0,2,0,0,0,2,90
TOTAL (UTs),2013,Causes Not known,11,272,205,131,59,678,13,168,62,14,2,259,937
TOTAL (UTs),2013,Other Causes (Please Specify),12,121,106,55,37,331,5,68,34,15,2,124,455
TOTAL (UTs),2013,Total,28,767,703,407,159,2064,29,556,224,62,34,905,2969
TOTAL (UTs),2013,Total Illness,0,55,51,71,45,222,1,26,25,13,19,84,306
A & N ISLANDS,2013,Bankruptcy or Sudden change in Economic,0,0,0,0,0,0,0,0,0,0,0,0,0
A & N ISLANDS,2013,Suspected/Illicit Relation,0,0,1,0,0,1,0,0,0,0,0,0,1
A & N ISLANDS,2013,Cancellation/Non-Settlement of Marriage,0,0,0,0,0,0,0,0,0,0,0,0,0
A & N ISLANDS,2013,Not having Children(Barrenness/Impotency,0,0,0,0,0,0,0,0,0,0,0,0,0
A & N ISLANDS,2013,Illness (Aids/STD),0,0,0,0,0,0,0,0,0,0,0,0,0
A & N ISLANDS,2013,Cancer,0,0,0,0,1,1,0,0,0,0,0,0,1
A & N ISLANDS,2013,Paralysis,0,0,0,0,0,0,0,0,0,0,0,0,0
A & N ISLANDS,2013,Insanity/Mental Illness,0,5,6,6,2,19,0,3,1,0,0,4,23
A & N ISLANDS,2013,Other Prolonged Illness,0,3,1,3,7,14,0,2,2,1,1,6,20
A & N ISLANDS,2013,Death of Dear Person,0,0,0,0,0,0,0,0,1,0,0,1,1
A & N ISLANDS,2013,Dowry Dispute,0,0,0,0,0,0,0,0,0,0,0,0,0
A & N ISLANDS,2013,Divorce,0,0,0,0,0,0,0,0,0,0,0,0,0
A & N ISLANDS,2013,Drug Abuse/Addiction,0,0,0,0,0,0,0,0,0,0,0,0,0
A & N ISLANDS,2013,Failure in Examination,0,0,0,0,0,0,0,0,0,0,0,0,0
A & N ISLANDS,2013,Fall in Social Reputation,0,0,0,0,0,0,0,0,0,0,0,0,0
A & N ISLANDS,2013,Family Problems,0,1,0,1,0,2,0,0,0,0,0,0,2
A & N ISLANDS,2013,Ideological Causes/Hero Worshipping,0,0,0,0,0,0,0,0,0,0,0,0,0
A & N ISLANDS,2013,Illegitimate Pregnancy,0,0,0,0,0,0,0,0,0,0,0,0,0
A & N ISLANDS,2013,Love Affairs,0,11,1,0,0,12,1,4,0,0,0,5,17
A & N ISLANDS,2013,"Physical Abuse (Rape,Incest Etc.)",0,0,0,0,0,0,0,0,0,0,0,0,0
A & N ISLANDS,2013,Poverty,0,0,0,0,0,0,0,0,0,0,0,0,0
A & N ISLANDS,2013,Professional/Career Problem,0,0,0,0,0,0,0,0,0,0,0,0,0
A & N ISLANDS,2013,Property Dispute,0,0,0,0,0,0,0,0,0,0,0,0,0
A & N ISLANDS,2013,Unemployment,0,0,1,0,0,1,0,0,0,0,0,0,1
A & N ISLANDS,2013,Causes Not known,2,5,5,5,1,18,0,6,0,1,0,7,25
A & N ISLANDS,2013,Other Causes (Please Specity),2,10,14,13,4,43,1,7,7,2,0,17,60
A & N ISLANDS,2013,Total,4,35,29,28,15,111,2,22,11,4,1,40,151
A & N ISLANDS,2013,Total Illness,0,8,7,9,10,34,0,5,3,1,1,10,44
ANDHRA PRADESH,2013,Bankruptcy or Sudden change in Economic,1,177,441,237,34,890,1,32,63,44,14,154,1044
ANDHRA PRADESH,2013,Suspected/Illicit Relation,0,18,26,11,1,56,0,14,26,1,0,41,97
ANDHRA PRADESH,2013,Cancellation/Non-Settlement of Marriage,0,29,22,5,0,56,0,54,24,0,0,78,134
ANDHRA PRADESH,2013,Not having Children(Barrenness/Impotency,0,10,24,4,0,38,0,32,33,2,0,67,105
ANDHRA PRADESH,2013,Illness (Aids/STD),0,10,40,14,4,68,0,5,13,4,0,22,90
ANDHRA PRADESH,2013,Cancer,0,2,33,22,14,71,0,9,21,15,4,49,120
ANDHRA PRADESH,2013,Paralysis,0,5,15,51,58,129,0,2,22,23,14,61,190
ANDHRA PRADESH,2013,Insanity/Mental Illness,1,116,201,180,75,573,6,145,114,87,57,409,982
ANDHRA PRADESH,2013,Other Prolonged Illness,10,394,488,462,332,1686,18,415,293,225,202,1153,2839
ANDHRA PRADESH,2013,Death of Dear Person,0,13,15,12,10,50,0,8,11,8,10,37,87
ANDHRA PRADESH,2013,Dowry Dispute,0,0,0,1,0,1,0,64,29,4,0,97,98
ANDHRA PRADESH,2013,Divorce,0,5,6,4,0,15,0,10,14,4,1,29,44
ANDHRA PRADESH,2013,Drug Abuse/Addiction,0,54,103,95,16,268,0,0,6,6,2,14,282
ANDHRA PRADESH,2013,Failure in Examination,4,108,31,0,0,143,3,83,6,0,0,92,235
ANDHRA PRADESH,2013,Fall in Social Reputation,0,18,45,8,4,75,0,6,9,6,3,24,99
ANDHRA PRADESH,2013,Family Problems,11,494,682,369,104,1660,7,442,355,111,36,951,2611
ANDHRA PRADESH,2013,Ideological Causes/Hero Worshipping,0,5,3,0,0,8,0,1,0,0,0,1,9
ANDHRA PRADESH,2013,Illegitimate Pregnancy,0,0,0,0,0,0,0,4,0,0,0,4,4
ANDHRA PRADESH,2013,Love Affairs,4,157,33,6,0,200,6,91,13,0,0,110,310
ANDHRA PRADESH,2013,"Physical Abuse (Rape,Incest Etc.)",0,0,0,0,0,0,0,4,2,0,0,6,6
ANDHRA PRADESH,2013,Poverty,0,160,216,211,38,625,0,55,74,38,12,179,804
ANDHRA PRADESH,2013,Professional/Career Problem,1,82,60,38,6,187,0,10,12,9,0,31,218
ANDHRA PRADESH,2013,Property Dispute,0,45,37,22,0,104,0,6,14,5,0,25,129
ANDHRA PRADESH,2013,Unemployment,0,88,37,11,0,136,0,17,20,0,0,37,173
ANDHRA PRADESH,2013,Causes Not known,10,294,336,226,41,907,7,132,105,31,15,290,1197
ANDHRA PRADESH,2013,Other Causes (Please Specity),26,563,754,450,163,1956,33,282,221,151,57,744,2700
ANDHRA PRADESH,2013,Total,68,2847,3648,2439,900,9902,81,1923,1500,774,427,4705,14607
ANDHRA PRADESH,2013,Total Illness,11,527,777,729,483,2527,24,576,463,354,277,1694,4221
ARUNACHAL PRADESH,2013,Bankruptcy or Sudden change in Economic,0,0,0,0,0,0,0,0,0,0,0,0,0
ARUNACHAL PRADESH,2013,Suspected/Illicit Relation,0,1,2,0,0,3,0,2,0,0,0,2,5
ARUNACHAL PRADESH,2013,Cancellation/Non-Settlement of Marriage,0,0,0,0,0,0,0,1,0,0,0,1,1
ARUNACHAL PRADESH,2013,Not having Children(Barrenness/Impotency,0,0,0,0,0,0,0,0,0,0,0,0,0
ARUNACHAL PRADESH,2013,Illness (Aids/STD),0,0,2,1,0,3,0,0,0,0,0,0,3
ARUNACHAL PRADESH,2013,Cancer,0,0,0,0,0,0,0,0,0,0,0,0,0
ARUNACHAL PRADESH,2013,Paralysis,0,0,0,0,0,0,0,0,0,0,0,0,0
ARUNACHAL PRADESH,2013,Insanity/Mental Illness,0,1,0,2,0,3,0,0,0,0,0,0,3
ARUNACHAL PRADESH,2013,Other Prolonged Illness,0,1,9,6,1,17,0,1,3,1,0,5,22
ARUNACHAL PRADESH,2013,Death of Dear Person,2,0,2,1,0,5,0,0,0,1,0,1,6
ARUNACHAL PRADESH,2013,Dowry Dispute,0,0,0,0,0,0,0,0,0,0,0,0,0
ARUNACHAL PRADESH,2013,Divorce,0,0,0,0,0,0,0,0,0,0,0,0,0
ARUNACHAL PRADESH,2013,Drug Abuse/Addiction,0,0,0,0,0,0,0,0,1,0,0,1,1
ARUNACHAL PRADESH,2013,Failure in Examination,0,0,0,0,0,0,0,1,0,0,0,1,1
ARUNACHAL PRADESH,2013,Fall in Social Reputation,0,0,2,0,0,2,0,0,0,0,0,0,2
ARUNACHAL PRADESH,2013,Family Problems,1,5,8,7,2,23,0,8,3,1,0,12,35
ARUNACHAL PRADESH,2013,Ideological Causes/Hero Worshipping,0,0,0,0,0,0,0,0,0,0,0,0,0
ARUNACHAL PRADESH,2013,Illegitimate Pregnancy,0,0,0,0,0,0,0,0,0,0,0,0,0
ARUNACHAL PRADESH,2013,Love Affairs,0,1,0,0,0,1,0,2,0,0,0,2,3
ARUNACHAL PRADESH,2013,"Physical Abuse (Rape,Incest Etc.)",0,0,0,0,0,0,0,0,0,0,0,0,0
ARUNACHAL PRADESH,2013,Poverty,0,0,1,0,0,1,0,0,0,0,0,0,1
ARUNACHAL PRADESH,2013,Professional/Career Problem,0,1,0,0,0,1,0,0,0,0,0,0,1
ARUNACHAL PRADESH,2013,Property Dispute,0,0,0,0,0,0,0,0,0,0,0,0,0
ARUNACHAL PRADESH,2013,Unemployment,0,0,0,0,0,0,0,0,0,0,0,0,0
ARUNACHAL PRADESH,2013,Causes Not known,1,31,14,9,2,57,3,6,8,0,0,17,74
ARUNACHAL PRADESH,2013,Other Causes (Please Specity),3,15,25,7,5,55,1,10,4,0,1,16,71
ARUNACHAL PRADESH,2013,Total,7,56,65,33,10,171,4,31,19,3,1,58,229
ARUNACHAL PRADESH,2013,Total Illness,0,2,11,9,1,23,0,1,3,1,0,5,28
ASSAM,2013,Bankruptcy or Sudden change in Economic,1,8,5,4,0,18,0,5,0,2,0,7,25
ASSAM,2013,Suspected/Illicit Relation,0,5,8,1,0,14,0,6,4,1,0,11,25
ASSAM,2013,Cancellation/Non-Settlement of Marriage,0,1,0,0,0,1,0,2,0,0,0,2,3
ASSAM,2013,Not having Children(Barrenness/Impotency,0,1,0,0,0,1,0,0,1,0,0,1,2
ASSAM,2013,Illness (Aids/STD),0,0,0,0,0,0,0,0,2,4,0,6,6
ASSAM,2013,Cancer,0,5,15,19,0,39,0,0,2,2,0,4,43
ASSAM,2013,Paralysis,0,0,1,1,0,2,0,0,0,0,0,0,2
ASSAM,2013,Insanity/Mental Illness,0,11,8,6,0,25,0,2,1,1,1,5,30
ASSAM,2013,Other Prolonged Illness,1,40,88,67,5,201,0,12,23,16,0,51,252
ASSAM,2013,Death of Dear Person,0,6,14,8,0,28,0,3,0,0,0,3,31
ASSAM,2013,Dowry Dispute,0,0,0,0,0,0,0,0,2,0,0,2,2
ASSAM,2013,Divorce,0,0,0,0,0,0,0,2,3,2,0,7,7
ASSAM,2013,Drug Abuse/Addiction,0,2,2,2,0,6,0,0,0,0,0,0,6
ASSAM,2013,Failure in Examination,0,98,9,6,0,113,1,48,5,0,0,54,167
ASSAM,2013,Fall in Social Reputation,0,15,30,13,1,59,0,4,3,4,0,11,70
ASSAM,2013,Family Problems,0,79,125,73,1,278,0,35,49,19,0,103,381
ASSAM,2013,Ideological Causes/Hero Worshipping,0,2,0,3,0,5,0,0,0,0,0,0,5
ASSAM,2013,Illegitimate Pregnancy,0,0,0,0,0,0,0,5,4,0,0,9,9
ASSAM,2013,Love Affairs,0,230,188,17,0,435,1,157,57,0,0,215,650
ASSAM,2013,"Physical Abuse (Rape,Incest Etc.)",0,0,0,0,0,0,0,0,2,0,0,2,2
ASSAM,2013,Poverty,0,22,84,43,1,150,0,6,24,12,0,42,192
ASSAM,2013,Professional/Career Problem,0,0,0,4,0,4,0,0,0,2,0,2,6
ASSAM,2013,Property Dispute,0,28,58,42,1,129,0,2,20,15,0,37,166
ASSAM,2013,Unemployment,0,0,38,105,3,146,0,0,0,0,0,0,146
ASSAM,2013,Causes Not known,8,242,376,147,15,788,2,72,171,90,12,347,1135
ASSAM,2013,Other Causes (Please Specity),1,28,41,43,3,116,3,38,20,13,0,74,190
ASSAM,2013,Total,11,823,1090,604,30,2558,7,399,393,183,13,995,3553
ASSAM,2013,Total Illness,1,56,112,93,5,267,0,14,28,23,1,66,333
BIHAR,2013,Bankruptcy or Sudden change in Economic,0,1,2,1,0,4,0,0,0,0,1,1,5
BIHAR,2013,Suspected/Illicit Relation,2,5,5,2,1,15,3,8,2,1,0,14,29
BIHAR,2013,Cancellation/Non-Settlement of Marriage,0,1,0,0,0,1,0,2,1,1,0,4,5
BIHAR,2013,Not having Children(Barrenness/Impotency,0,0,0,0,0,0,0,1,1,0,0,2,2
BIHAR,2013,Illness (Aids/STD),0,0,1,0,0,1,0,0,0,0,0,0,1
BIHAR,2013,Cancer,0,0,0,0,0,0,0,0,0,0,0,0,0
BIHAR,2013,Paralysis,0,0,0,0,0,0,0,0,0,0,0,0,0
BIHAR,2013,Insanity/Mental Illness,4,3,5,1,1,14,1,1,2,1,1,6,20
BIHAR,2013,Other Prolonged Illness,0,1,3,6,1,11,0,2,3,1,0,6,17
BIHAR,2013,Death of Dear Person,0,0,0,0,0,0,0,0,0,0,0,0,0
BIHAR,2013,Dowry Dispute,0,1,0,0,0,1,0,10,4,0,0,14,15
BIHAR,2013,Divorce,0,1,1,0,0,2,0,3,3,0,0,6,8
BIHAR,2013,Drug Abuse/Addiction,0,0,15,13,1,29,0,0,0,0,0,0,29
BIHAR,2013,Failure in Examination,0,18,4,0,0,22,0,4,3,0,0,7,29
BIHAR,2013,Fall in Social Reputation,0,1,1,2,0,4,0,1,0,0,0,1,5
BIHAR,2013,Family Problems,0,15,36,10,1,62,2,20,24,5,0,51,113
BIHAR,2013,Ideological Causes/Hero Worshipping,0,0,0,0,0,0,0,1,0,0,0,1,1
BIHAR,2013,Illegitimate Pregnancy,0,0,0,0,0,0,2,6,6,0,0,14,14
BIHAR,2013,Love Affairs,3,17,5,0,0,25,3,16,2,0,0,21,46
BIHAR,2013,"Physical Abuse (Rape,Incest Etc.)",0,0,0,0,0,0,1,2,0,0,0,3,3
BIHAR,2013,Poverty,0,0,1,0,0,1,0,0,0,0,0,0,1
BIHAR,2013,Professional/Career Problem,0,0,2,2,0,4,0,0,0,0,0,0,4
BIHAR,2013,Property Dispute,0,2,0,1,2,5,0,0,0,0,0,0,5
BIHAR,2013,Unemployment,0,1,1,1,1,4,0,0,1,0,0,1,5
BIHAR,2013,Causes Not known,1,10,12,0,4,27,11,13,11,3,0,38,65
BIHAR,2013,Other Causes (Please Specity),16,99,159,87,37,398,24,91,97,20,5,237,635
BIHAR,2013,Total,26,176,253,126,49,630,47,181,160,32,7,427,1057
BIHAR,2013,Total Illness,4,4,9,7,2,26,1,3,5,2,1,12,38
CHANDIGARH,2013,Bankruptcy or Sudden change in Economic,0,0,0,0,0,0,0,0,0,0,0,0,0
CHANDIGARH,2013,Suspected/Illicit Relation,0,0,0,0,0,0,0,0,0,0,0,0,0
CHANDIGARH,2013,Cancellation/Non-Settlement of Marriage,0,0,0,0,0,0,0,0,0,0,0,0,0
CHANDIGARH,2013,Not having Children(Barrenness/Impotency,0,0,0,0,0,0,0,0,0,0,0,0,0
CHANDIGARH,2013,Illness (Aids/STD),0,0,0,0,0,0,0,0,0,0,0,0,0
CHANDIGARH,2013,Cancer,0,0,0,0,0,0,0,0,0,0,0,0,0
CHANDIGARH,2013,Paralysis,0,0,0,0,0,0,0,0,0,0,0,0,0
CHANDIGARH,2013,Insanity/Mental Illness,0,0,0,0,0,0,0,0,0,0,0,0,0
CHANDIGARH,2013,Other Prolonged Illness,0,1,1,1,0,3,0,0,0,0,0,0,3
CHANDIGARH,2013,Death of Dear Person,0,0,0,0,0,0,0,0,0,0,0,0,0
CHANDIGARH,2013,Dowry Dispute,0,0,0,0,0,0,0,0,0,0,0,0,0
CHANDIGARH,2013,Divorce,0,0,0,0,0,0,0,0,0,0,0,0,0
CHANDIGARH,2013,Drug Abuse/Addiction,0,0,0,0,0,0,0,0,0,0,0,0,0
CHANDIGARH,2013,Failure in Examination,0,2,0,0,0,2,0,2,0,0,0,2,4
CHANDIGARH,2013,Fall in Social Reputation,0,0,0,0,0,0,0,0,0,0,0,0,0
CHANDIGARH,2013,Family Problems,0,10,11,6,2,29,0,9,7,2,0,18,47
CHANDIGARH,2013,Ideological Causes/Hero Worshipping,0,0,0,0,0,0,0,0,0,0,0,0,0
CHANDIGARH,2013,Illegitimate Pregnancy,0,0,0,0,0,0,0,0,0,0,0,0,0
CHANDIGARH,2013,Love Affairs,0,10,0,0,0,10,1,9,0,0,0,10,20
CHANDIGARH,2013,"Physical Abuse (Rape,Incest Etc.)",0,0,0,0,0,0,0,0,0,0,0,0,0
CHANDIGARH,2013,Poverty,0,0,0,0,0,0,0,0,0,0,0,0,0
CHANDIGARH,2013,Professional/Career Problem,0,0,0,0,0,0,0,0,0,0,0,0,0
CHANDIGARH,2013,Property Dispute,0,0,0,0,0,0,0,0,0,0,0,0,0
CHANDIGARH,2013,Unemployment,0,2,3,0,0,5,0,0,0,0,0,0,5
CHANDIGARH,2013,Causes Not known,0,3,3,3,0,9,0,5,2,0,0,7,16
CHANDIGARH,2013,Other Causes (Please Specity),0,0,0,1,0,1,0,1,0,0,0,1,2
CHANDIGARH,2013,Total,0,28,18,11,2,59,1,26,9,2,0,38,97
CHANDIGARH,2013,Total Illness,0,1,1,1,0,3,0,0,0,0,0,0,3
CHHATTISGARH,2013,Bankruptcy or Sudden change in Economic,0,0,8,1,0,9,0,0,0,0,0,0,9
CHHATTISGARH,2013,Suspected/Illicit Relation,0,1,1,0,0,2,0,3,2,1,0,6,8
CHHATTISGARH,2013,Cancellation/Non-Settlement of Marriage,0,5,5,2,0,12,1,8,1,0,0,10,22
CHHATTISGARH,2013,Not having Children(Barrenness/Impotency,0,3,0,0,1,4,0,2,5,1,0,8,12
CHHATTISGARH,2013,Illness (Aids/STD),0,0,2,0,1,3,0,0,0,0,0,0,3
CHHATTISGARH,2013,Cancer,0,0,0,1,0,1,0,0,0,0,0,0,1
CHHATTISGARH,2013,Paralysis,0,2,1,5,5,13,0,1,3,1,0,5,18
CHHATTISGARH,2013,Insanity/Mental Illness,2,71,57,33,16,179,0,27,20,10,12,69,248
CHHATTISGARH,2013,Other Prolonged Illness,3,87,105,83,48,326,18,43,41,33,27,162,488
CHHATTISGARH,2013,Death of Dear Person,0,4,2,2,1,9,0,1,4,1,0,6,15
CHHATTISGARH,2013,Dowry Dispute,0,2,0,0,0,2,0,44,1,0,0,45,47
CHHATTISGARH,2013,Divorce,0,3,1,0,0,4,0,1,0,0,0,1,5
CHHATTISGARH,2013,Drug Abuse/Addiction,2,73,80,39,11,205,1,3,4,4,0,12,217
CHHATTISGARH,2013,Failure in Examination,6,17,2,0,0,25,2,29,0,0,0,31,56
CHHATTISGARH,2013,Fall in Social Reputation,0,5,3,6,2,16,0,5,2,2,0,9,25
CHHATTISGARH,2013,Family Problems,3,128,186,81,26,424,9,139,89,51,15,303,727
CHHATTISGARH,2013,Ideological Causes/Hero Worshipping,2,7,11,4,2,26,0,10,1,1,0,12,38
CHHATTISGARH,2013,Illegitimate Pregnancy,0,0,0,0,0,0,0,1,0,0,0,1,1
CHHATTISGARH,2013,Love Affairs,1,44,5,12,0,62,3,30,2,4,0,39,101
CHHATTISGARH,2013,"Physical Abuse (Rape,Incest Etc.)",0,1,2,0,0,3,1,9,4,0,0,14,17
CHHATTISGARH,2013,Poverty,0,1,2,2,0,5,0,1,0,4,1,6,11
CHHATTISGARH,2013,Professional/Career Problem,0,0,5,5,0,10,0,0,0,0,0,0,10
CHHATTISGARH,2013,Property Dispute,0,0,0,1,0,1,0,0,0,1,0,1,2
CHHATTISGARH,2013,Unemployment,0,12,16,1,0,29,0,3,0,0,0,3,32
CHHATTISGARH,2013,Causes Not known,52,505,489,236,101,1383,42,319,179,78,41,659,2042
CHHATTISGARH,2013,Other Causes (Please Specity),11,330,294,183,77,895,15,186,101,58,26,386,1281
CHHATTISGARH,2013,Total,82,1301,1277,697,291,3648,92,865,459,250,122,1788,5436
CHHATTISGARH,2013,Total Illness,5,160,165,122,70,522,18,71,64,44,39,236,758
D & N HAVELI,2013,Bankruptcy or Sudden change in Economic,0,0,0,1,0,1,0,0,0,2,0,2,3
D & N HAVELI,2013,Suspected/Illicit Relation,0,2,0,0,0,2,0,0,0,0,0,0,2
D & N HAVELI,2013,Cancellation/Non-Settlement of Marriage,0,0,0,0,0,0,0,0,0,0,0,0,0
D & N HAVELI,2013,Not having Children(Barrenness/Impotency,0,0,0,0,0,0,0,0,0,0,0,0,0
D & N HAVELI,2013,Illness (Aids/STD),0,0,0,0,0,0,0,0,0,0,0,0,0
D & N HAVELI,2013,Cancer,0,0,0,0,0,0,0,0,0,0,0,0,0
D & N HAVELI,2013,Paralysis,0,0,0,0,0,0,0,0,0,0,0,0,0
D & N HAVELI,2013,Insanity/Mental Illness,0,8,0,0,0,8,0,0,2,0,3,5,13
D & N HAVELI,2013,Other Prolonged Illness,0,3,3,1,0,7,0,1,0,0,3,4,11
D & N HAVELI,2013,Death of Dear Person,0,0,0,0,0,0,0,0,0,0,0,0,0
D & N HAVELI,2013,Dowry Dispute,0,0,0,0,0,0,0,0,0,0,0,0,0
D & N HAVELI,2013,Divorce,0,0,0,0,0,0,0,0,0,0,0,0,0
D & N HAVELI,2013,Drug Abuse/Addiction,0,0,0,0,0,0,0,0,0,0,0,0,0
D & N HAVELI,2013,Failure in Examination,0,0,0,0,0,0,0,0,0,0,0,0,0
D & N HAVELI,2013,Fall in Social Reputation,0,0,1,0,0,1,0,1,0,0,0,1,2
D & N HAVELI,2013,Family Problems,0,1,4,9,2,16,0,3,0,1,0,4,20
D & N HAVELI,2013,Ideological Causes/Hero Worshipping,0,0,0,0,0,0,0,0,0,0,0,0,0
D & N HAVELI,2013,Illegitimate Pregnancy,0,0,0,0,0,0,0,0,0,0,0,0,0
D & N HAVELI,2013,Love Affairs,0,2,1,0,0,3,0,4,0,0,0,4,7
D & N HAVELI,2013,"Physical Abuse (Rape,Incest Etc.)",0,0,0,0,0,0,0,0,0,0,0,0,0
D & N HAVELI,2013,Poverty,0,0,0,0,0,0,0,0,0,0,0,0,0
D & N HAVELI,2013,Professional/Career Problem,0,0,0,0,0,0,0,0,0,0,0,0,0
D & N HAVELI,2013,Property Dispute,0,0,0,0,0,0,0,0,0,0,0,0,0
D & N HAVELI,2013,Unemployment,0,0,0,0,0,0,0,0,0,0,0,0,0
D & N HAVELI,2013,Causes Not known,0,7,2,3,0,12,0,0,0,0,0,0,12
D & N HAVELI,2013,Other Causes (Please Specity),0,1,1,3,0,5,0,4,3,2,0,9,14
D & N HAVELI,2013,Total,0,24,12,17,2,55,0,13,5,5,6,29,84
D & N HAVELI,2013,Total Illness,0,11,3,1,0,15,0,1,2,0,6,9,24
DAMAN & DIU,2013,Bankruptcy or Sudden change in Economic,0,0,0,0,0,0,0,0,0,0,0,0,0
DAMAN & DIU,2013,Suspected/Illicit Relation,0,0,0,0,0,0,0,0,0,0,0,0,0
DAMAN & DIU,2013,Cancellation/Non-Settlement of Marriage,0,0,0,0,0,0,0,0,0,0,0,0,0
DAMAN & DIU,2013,Not having Children(Barrenness/Impotency,0,0,0,0,0,0,0,0,0,0,0,0,0
DAMAN & DIU,2013,Illness (Aids/STD),0,0,0,0,0,0,0,0,0,0,0,0,0
DAMAN & DIU,2013,Cancer,0,0,0,0,0,0,0,0,0,0,0,0,0
DAMAN & DIU,2013,Paralysis,0,0,0,0,0,0,0,0,0,0,0,0,0
DAMAN & DIU,2013,Insanity/Mental Illness,0,0,0,0,0,0,0,0,0,0,0,0,0
DAMAN & DIU,2013,Other Prolonged Illness,0,0,0,0,0,0,0,1,1,0,0,2,2
DAMAN & DIU,2013,Death of Dear Person,0,0,0,0,0,0,0,0,0,0,0,0,0
DAMAN & DIU,2013,Dowry Dispute,0,0,0,0,0,0,0,0,0,0,0,0,0
DAMAN & DIU,2013,Divorce,0,0,0,0,0,0,0,0,0,0,0,0,0
DAMAN & DIU,2013,Drug Abuse/Addiction,0,0,0,0,0,0,0,0,0,0,0,0,0
DAMAN & DIU,2013,Failure in Examination,0,0,0,0,0,0,0,0,0,0,0,0,0
DAMAN & DIU,2013,Fall in Social Reputation,0,0,0,0,0,0,0,0,0,0,0,0,0
DAMAN & DIU,2013,Family Problems,0,1,1,1,0,3,0,1,1,0,0,2,5
DAMAN & DIU,2013,Ideological Causes/Hero Worshipping,0,0,0,0,0,0,0,0,0,0,0,0,0
DAMAN & DIU,2013,Illegitimate Pregnancy,0,0,0,0,0,0,0,0,0,0,0,0,0
DAMAN & DIU,2013,Love Affairs,0,0,0,0,0,0,0,0,0,0,0,0,0
DAMAN & DIU,2013,"Physical Abuse (Rape,Incest Etc.)",0,0,0,0,0,0,0,0,0,0,0,0,0
DAMAN & DIU,2013,Poverty,0,0,0,0,0,0,0,0,0,0,0,0,0
DAMAN & DIU,2013,Professional/Career Problem,0,0,0,0,0,0,0,0,0,0,0,0,0
DAMAN & DIU,2013,Property Dispute,0,0,0,0,0,0,0,0,0,0,0,0,0
DAMAN & DIU,2013,Unemployment,0,0,0,0,0,0,0,0,0,0,0,0,0
DAMAN & DIU,2013,Causes Not known,0,6,1,2,0,9,0,4,3,2,0,9,18
DAMAN & DIU,2013,Other Causes (Please Specity),0,1,0,0,0,1,0,2,0,1,0,3,4
DAMAN & DIU,2013,Total,0,8,2,3,0,13,0,8,5,3,0,16,29
DAMAN & DIU,2013,Total Illness,0,0,0,0,0,0,0,1,1,0,0,2,2
DELHI (UT),2013,Bankruptcy or Sudden change in Economic,0,2,5,1,0,8,0,0,0,0,0,0,8
DELHI (UT),2013,Suspected/Illicit Relation,0,0,2,0,0,2,0,3,0,0,0,3,5
DELHI (UT),2013,Cancellation/Non-Settlement of Marriage,0,4,0,0,0,4,0,5,3,0,0,8,12
DELHI (UT),2013,Not having Children(Barrenness/Impotency,0,0,0,0,0,0,0,1,0,0,0,1,1
DELHI (UT),2013,Illness (Aids/STD),0,0,0,0,0,0,0,1,0,0,0,1,1
DELHI (UT),2013,Cancer,0,1,2,1,1,5,0,0,0,0,0,0,5
DELHI (UT),2013,Paralysis,0,0,0,0,0,0,0,0,0,0,0,0,0
DELHI (UT),2013,Insanity/Mental Illness,0,4,5,0,4,13,0,6,0,1,1,8,21
DELHI (UT),2013,Other Prolonged Illness,0,14,11,8,3,36,0,8,5,3,1,17,53
DELHI (UT),2013,Death of Dear Person,0,2,0,0,0,2,0,1,1,1,0,3,5
DELHI (UT),2013,Dowry Dispute,0,1,0,0,0,1,0,43,5,0,0,48,49
DELHI (UT),2013,Divorce,0,0,0,0,0,0,0,2,1,0,0,3,3
DELHI (UT),2013,Drug Abuse/Addiction,0,9,11,2,0,22,0,0,0,0,0,0,22
DELHI (UT),2013,Failure in Examination,1,26,0,0,0,27,2,27,0,0,0,29,56
DELHI (UT),2013,Fall in Social Reputation,0,5,4,1,0,10,0,4,0,0,0,4,14
DELHI (UT),2013,Family Problems,1,93,133,28,4,259,4,84,53,10,3,154,413
DELHI (UT),2013,Ideological Causes/Hero Worshipping,0,0,0,0,0,0,0,0,0,0,0,0,0
DELHI (UT),2013,Illegitimate Pregnancy,0,0,0,0,0,0,0,1,0,0,0,1,1
DELHI (UT),2013,Love Affairs,1,33,8,0,0,42,1,26,4,0,0,31,73
DELHI (UT),2013,"Physical Abuse (Rape,Incest Etc.)",0,0,0,0,0,0,0,1,0,0,0,1,1
DELHI (UT),2013,Poverty,0,1,3,1,0,5,0,0,0,0,0,0,5
DELHI (UT),2013,Professional/Career Problem,0,2,1,0,0,3,0,2,0,0,0,2,5
DELHI (UT),2013,Property Dispute,0,1,2,1,0,4,0,0,0,0,0,0,4
DELHI (UT),2013,Unemployment,0,36,42,3,0,81,0,2,0,0,0,2,83
DELHI (UT),2013,Causes Not known,8,245,191,114,56,614,13,150,57,11,2,233,847
DELHI (UT),2013,Other Causes (Please Specity),10,109,90,38,32,279,4,53,24,10,2,93,372
DELHI (UT),2013,Total,21,588,510,198,100,1417,24,420,153,36,9,642,2059
DELHI (UT),2013,Total Illness,0,19,18,9,8,54,0,15,5,4,2,26,80
GOA,2013,Bankruptcy or Sudden change in Economic,0,1,4,3,0,8,0,1,0,0,0,1,9
GOA,2013,Suspected/Illicit Relation,0,0,0,0,0,0,0,0,0,0,0,0,0
GOA,2013,Cancellation/Non-Settlement of Marriage,0,2,2,0,0,4,0,0,0,0,0,0,4
GOA,2013,Not having Children(Barrenness/Impotency,0,0,2,0,0,2,0,1,0,1,0,2,4
GOA,2013,Illness (Aids/STD),0,0,1,0,0,1,0,0,0,0,0,0,1
GOA,2013,Cancer,0,0,0,0,1,1,0,0,0,0,0,0,1
GOA,2013,Paralysis,0,0,0,0,0,0,0,0,0,0,0,0,0
GOA,2013,Insanity/Mental Illness,0,8,10,7,2,27,0,1,8,1,3,13,40
GOA,2013,Other Prolonged Illness,0,0,8,7,7,22,0,0,0,1,2,3,25
GOA,2013,Death of Dear Person,0,0,1,0,0,1,0,1,1,0,0,2,3
GOA,2013,Dowry Dispute,0,0,0,0,0,0,0,1,0,0,0,1,1
GOA,2013,Divorce,0,0,0,0,0,0,0,0,0,0,0,0,0
GOA,2013,Drug Abuse/Addiction,0,0,0,0,0,0,0,0,0,0,0,0,0
GOA,2013,Failure in Examination,0,0,0,0,0,0,1,0,0,0,0,1,1
GOA,2013,Fall in Social Reputation,0,0,0,0,0,0,0,0,0,0,0,0,0
GOA,2013,Family Problems,0,9,11,12,5,37,1,8,11,0,1,21,58
GOA,2013,Ideological Causes/Hero Worshipping,0,0,0,0,0,0,0,0,0,0,0,0,0
GOA,2013,Illegitimate Pregnancy,0,0,0,0,0,0,0,0,0,0,0,0,0
GOA,2013,Love Affairs,0,17,2,0,0,19,1,6,1,0,0,8,27
GOA,2013,"Physical Abuse (Rape,Incest Etc.)",0,0,0,0,0,0,0,1,1,0,0,2,2
GOA,2013,Poverty,0,0,0,0,0,0,0,0,0,0,0,0,0
GOA,2013,Professional/Career Problem,0,2,0,1,0,3,0,1,0,0,0,1,4
GOA,2013,Property Dispute,0,1,0,0,0,1,0,0,0,0,0,0,1
GOA,2013,Unemployment,0,8,4,1,0,13,0,0,0,0,0,0,13
GOA,2013,Causes Not known,0,23,23,10,5,61,2,25,10,2,0,39,100
GOA,2013,Other Causes (Please Specity),0,11,12,7,0,30,0,0,0,2,2,4,34
GOA,2013,Total,0,82,80,48,20,230,5,46,32,7,8,98,328
GOA,2013,Total Illness,0,8,19,14,10,51,0,1,8,2,5,16,67
GUJARAT,2013,Bankruptcy or Sudden change in Economic,0,32,69,23,5,129,0,7,11,7,0,25,154
GUJARAT,2013,Suspected/Illicit Relation,0,19,13,4,0,36,2,21,11,3,0,37,73
GUJARAT,2013,Cancellation/Non-Settlement of Marriage,0,51,13,3,0,67,0,34,14,5,0,53,120
GUJARAT,2013,Not having Children(Barrenness/Impotency,0,5,6,4,0,15,0,20,30,7,0,57,72
GUJARAT,2013,Illness (Aids/STD),0,13,33,18,9,73,1,4,7,2,1,15,88
GUJARAT,2013,Cancer,0,8,19,21,11,59,0,1,4,8,5,18,77
GUJARAT,2013,Paralysis,0,1,2,12,5,20,0,0,4,2,2,8,28
GUJARAT,2013,Insanity/Mental Illness,1,123,162,125,42,453,3,80,89,69,45,286,739
GUJARAT,2013,Other Prolonged Illness,3,83,168,161,89,504,5,71,100,67,55,298,802
GUJARAT,2013,Death of Dear Person,2,14,31,13,6,66,0,14,20,11,4,49,115
GUJARAT,2013,Dowry Dispute,0,2,2,0,0,4,1,12,5,0,0,18,22
GUJARAT,2013,Divorce,0,10,6,3,0,19,0,4,2,3,0,9,28
GUJARAT,2013,Drug Abuse/Addiction,1,12,20,18,4,55,0,2,4,0,0,6,61
GUJARAT,2013,Failure in Examination,4,50,2,0,0,56,4,55,2,0,0,61,117
GUJARAT,2013,Fall in Social Reputation,1,7,9,10,0,27,0,16,5,5,1,27,54
GUJARAT,2013,Family Problems,1,223,283,134,35,676,2,304,168,96,27,597,1273
GUJARAT,2013,Ideological Causes/Hero Worshipping,0,13,6,2,1,22,0,7,4,1,0,12,34
GUJARAT,2013,Illegitimate Pregnancy,0,0,0,0,0,0,0,4,0,0,0,4,4
GUJARAT,2013,Love Affairs,0,93,24,7,0,124,1,83,22,2,0,108,232
GUJARAT,2013,"Physical Abuse (Rape,Incest Etc.)",0,1,3,2,1,7,1,3,1,0,0,5,12
GUJARAT,2013,Poverty,0,16,19,8,1,44,0,4,7,1,0,12,56
GUJARAT,2013,Professional/Career Problem,0,36,55,23,4,118,0,4,2,0,0,6,124
GUJARAT,2013,Property Dispute,0,10,18,8,2,38,0,12,6,3,2,23,61
GUJARAT,2013,Unemployment,0,90,94,38,3,225,0,8,4,1,3,16,241
GUJARAT,2013,Causes Not known,13,410,452,278,72,1225,6,325,155,59,32,577,1802
GUJARAT,2013,Other Causes (Please Specity),19,173,154,92,32,470,14,162,79,37,15,307,777
GUJARAT,2013,Total,45,1495,1663,1007,322,4532,40,1257,756,389,192,2634,7166
GUJARAT,2013,Total Illness,4,228,384,337,156,1109,9,156,204,148,108,625,1734
HARYANA,2013,Bankruptcy or Sudden change in Economic,0,3,8,2,0,13,0,2,2,0,0,4,17
HARYANA,2013,Suspected/Illicit Relation,0,3,0,1,0,4,0,1,1,0,0,2,6
HARYANA,2013,Cancellation/Non-Settlement of Marriage,0,3,1,1,0,5,0,4,0,0,0,4,9
HARYANA,2013,Not having Children(Barrenness/Impotency,0,2,1,0,0,3,0,1,4,0,0,5,8
HARYANA,2013,Illness (Aids/STD),0,0,1,0,0,1,0,0,0,0,0,0,1
HARYANA,2013,Cancer,0,0,1,6,1,8,0,0,3,1,0,4,12
HARYANA,2013,Paralysis,0,1,2,0,1,4,0,0,0,0,0,0,4
HARYANA,2013,Insanity/Mental Illness,0,37,32,29,7,105,1,26,14,5,2,48,153
HARYANA,2013,Other Prolonged Illness,2,29,65,60,22,178,2,13,17,9,5,46,224
HARYANA,2013,Death of Dear Person,0,0,0,0,0,0,0,4,0,0,0,4,4
HARYANA,2013,Dowry Dispute,0,1,0,0,0,1,0,3,1,0,0,4,5
HARYANA,2013,Divorce,0,0,1,1,0,2,0,1,0,0,0,1,3
HARYANA,2013,Drug Abuse/Addiction,0,26,44,25,4,99,0,0,1,0,0,1,100
HARYANA,2013,Failure in Examination,1,24,1,0,0,26,0,20,0,0,0,20,46
HARYANA,2013,Fall in Social Reputation,0,0,0,0,0,0,1,1,0,0,0,2,2
HARYANA,2013,Family Problems,2,93,97,41,3,236,2,62,47,9,1,121,357
HARYANA,2013,Ideological Causes/Hero Worshipping,1,28,11,6,2,48,1,13,10,3,2,29,77
HARYANA,2013,Illegitimate Pregnancy,0,0,0,0,0,0,0,1,0,0,0,1,1
HARYANA,2013,Love Affairs,0,13,3,0,0,16,0,10,1,1,0,12,28
HARYANA,2013,"Physical Abuse (Rape,Incest Etc.)",0,0,0,0,0,0,0,0,0,0,0,0,0
HARYANA,2013,Poverty,1,3,7,5,1,17,0,1,1,1,0,3,20
HARYANA,2013,Professional/Career Problem,0,6,13,2,1,22,0,9,1,0,0,10,32
HARYANA,2013,Property Dispute,0,19,17,6,1,43,0,14,5,1,1,21,64
HARYANA,2013,Unemployment,0,33,19,1,0,53,0,9,0,0,0,9,62
HARYANA,2013,Causes Not known,13,168,244,224,85,734,18,66,32,22,19,157,891
HARYANA,2013,Other Causes (Please Specity),38,279,303,217,47,884,18,150,78,49,11,306,1190
HARYANA,2013,Total,58,771,871,627,175,2502,43,411,218,101,41,814,3316
HARYANA,2013,Total Illness,2,67,101,95,31,296,3,39,34,15,7,98,394
HIMACHAL PRADESH,2013,Bankruptcy or Sudden change in Economic,0,1,1,0,0,2,0,0,0,0,0,0,2
HIMACHAL PRADESH,2013,Suspected/Illicit Relation,0,4,7,2,0,13,0,8,3,2,0,13,26
HIMACHAL PRADESH,2013,Cancellation/Non-Settlement of Marriage,0,2,2,1,0,5,0,5,2,1,0,8,13
HIMACHAL PRADESH,2013,Not having Children(Barrenness/Impotency,0,0,0,0,0,0,0,1,2,0,0,3,3
HIMACHAL PRADESH,2013,Illness (Aids/STD),0,0,0,0,0,0,0,0,0,0,0,0,0
HIMACHAL PRADESH,2013,Cancer,0,1,2,1,1,5,0,1,1,2,0,4,9
HIMACHAL PRADESH,2013,Paralysis,0,0,0,1,1,2,0,0,0,0,1,1,3
HIMACHAL PRADESH,2013,Insanity/Mental Illness,1,14,9,4,1,29,0,7,5,2,0,14,43
HIMACHAL PRADESH,2013,Other Prolonged Illness,0,4,4,3,3,14,0,1,1,1,2,5,19
HIMACHAL PRADESH,2013,Death of Dear Person,0,1,0,0,0,1,0,1,0,0,0,1,2
HIMACHAL PRADESH,2013,Dowry Dispute,0,0,0,0,0,0,0,1,1,0,0,2,2
HIMACHAL PRADESH,2013,Divorce,0,0,0,0,0,0,0,0,0,0,0,0,0
HIMACHAL PRADESH,2013,Drug Abuse/Addiction,0,2,3,2,1,8,0,0,0,0,0,0,8
HIMACHAL PRADESH,2013,Failure in Examination,0,1,0,0,0,1,0,0,0,0,0,0,1
HIMACHAL PRADESH,2013,Fall in Social Reputation,0,1,0,1,1,3,0,0,0,0,0,0,3
HIMACHAL PRADESH,2013,Family Problems,1,19,19,13,3,55,3,26,10,5,1,45,100
HIMACHAL PRADESH,2013,Ideological Causes/Hero Worshipping,0,0,0,0,0,0,0,0,0,0,0,0,0
HIMACHAL PRADESH,2013,Illegitimate Pregnancy,0,0,0,0,0,0,0,0,0,0,0,0,0
HIMACHAL PRADESH,2013,Love Affairs,1,9,2,1,0,13,0,15,1,0,0,16,29
HIMACHAL PRADESH,2013,"Physical Abuse (Rape,Incest Etc.)",0,0,0,0,0,0,0,0,0,0,0,0,0
HIMACHAL PRADESH,2013,Poverty,0,0,0,0,0,0,0,0,0,0,0,0,0
HIMACHAL PRADESH,2013,Professional/Career Problem,0,1,0,0,0,1,0,0,0,0,0,0,1
HIMACHAL PRADESH,2013,Property Dispute,0,9,2,2,1,14,0,1,0,1,0,2,16
HIMACHAL PRADESH,2013,Unemployment,0,0,0,0,0,0,0,0,0,0,0,0,0
HIMACHAL PRADESH,2013,Causes Not known,1,28,20,9,3,61,3,6,4,1,0,14,75
HIMACHAL PRADESH,2013,Other Causes (Please Specity),1,45,51,31,9,137,0,17,23,16,6,62,199
HIMACHAL PRADESH,2013,Total,5,142,122,71,24,364,6,90,53,31,10,190,554
HIMACHAL PRADESH,2013,Total Illness,1,19,15,9,6,50,0,9,7,5,3,24,74
JAMMU & KASHMIR,2013,Bankruptcy or Sudden change in Economic,0,0,0,0,0,0,0,0,0,0,0,0,0
JAMMU & KASHMIR,2013,Suspected/Illicit Relation,0,0,0,0,0,0,0,0,0,0,0,0,0
JAMMU & KASHMIR,2013,Cancellation/Non-Settlement of Marriage,0,0,1,0,0,1,0,2,1,0,0,3,4
JAMMU & KASHMIR,2013,Not having Children(Barrenness/Impotency,0,0,0,0,0,0,0,0,0,0,0,0,0
JAMMU & KASHMIR,2013,Illness (Aids/STD),0,0,0,0,0,0,0,0,0,0,0,0,0
JAMMU & KASHMIR,2013,Cancer,0,0,0,0,0,0,0,0,0,0,0,0,0
JAMMU & KASHMIR,2013,Paralysis,0,0,0,0,0,0,0,0,0,0,0,0,0
JAMMU & KASHMIR,2013,Insanity/Mental Illness,0,0,1,3,0,4,0,0,0,0,2,2,6
JAMMU & KASHMIR,2013,Other Prolonged Illness,0,1,15,15,6,37,0,0,5,1,2,8,45
JAMMU & KASHMIR,2013,Death of Dear Person,0,0,0,0,0,0,0,0,0,0,0,0,0
JAMMU & KASHMIR,2013,Dowry Dispute,0,0,0,0,0,0,0,0,2,0,0,2,2
JAMMU & KASHMIR,2013,Divorce,0,0,0,1,0,1,0,0,1,0,0,1,2
JAMMU & KASHMIR,2013,Drug Abuse/Addiction,0,0,5,7,2,14,0,0,0,0,0,0,14
JAMMU & KASHMIR,2013,Failure in Examination,0,6,1,0,0,7,0,6,0,0,0,6,13
JAMMU & KASHMIR,2013,Fall in Social Reputation,0,0,1,0,0,1,0,0,0,0,0,0,1
JAMMU & KASHMIR,2013,Family Problems,0,6,8,2,0,16,0,8,10,1,0,19,35
JAMMU & KASHMIR,2013,Ideological Causes/Hero Worshipping,0,0,0,0,0,0,0,0,0,0,0,0,0
JAMMU & KASHMIR,2013,Illegitimate Pregnancy,0,0,0,0,0,0,0,0,0,0,0,0,0
JAMMU & KASHMIR,2013,Love Affairs,0,3,0,0,0,3,0,3,0,0,0,3,6
JAMMU & KASHMIR,2013,"Physical Abuse (Rape,Incest Etc.)",0,0,0,0,0,0,0,1,0,0,0,1,1
JAMMU & KASHMIR,2013,Poverty,0,0,6,5,3,14,0,0,0,2,0,2,16
JAMMU & KASHMIR,2013,Professional/Career Problem,0,1,0,0,0,1,0,0,0,0,0,0,1
JAMMU & KASHMIR,2013,Property Dispute,0,0,0,0,0,0,0,0,0,0,0,0,0
JAMMU & KASHMIR,2013,Unemployment,0,0,0,0,0,0,0,0,0,0,0,0,0
JAMMU & KASHMIR,2013,Causes Not known,1,11,15,10,4,41,3,31,15,2,1,52,93
JAMMU & KASHMIR,2013,Other Causes (Please Specity),0,10,16,1,1,28,0,14,18,3,0,35,63
JAMMU & KASHMIR,2013,Total,1,38,69,44,16,168,3,65,52,9,5,134,302
JAMMU & KASHMIR,2013,Total Illness,0,1,16,18,6,41,0,0,5,1,4,10,51
JHARKHAND,2013,Bankruptcy or Sudden change in Economic,0,3,4,2,1,10,0,2,2,0,0,4,14
JHARKHAND,2013,Suspected/Illicit Relation,0,25,9,4,0,38,0,14,6,2,0,22,60
JHARKHAND,2013,Cancellation/Non-Settlement of Marriage,0,2,0,0,0,2,0,8,2,0,0,10,12
JHARKHAND,2013,Not having Children(Barrenness/Impotency,0,0,0,0,0,0,0,1,2,0,0,3,3
JHARKHAND,2013,Illness (Aids/STD),0,0,0,0,0,0,0,0,0,0,0,0,0
JHARKHAND,2013,Cancer,0,0,0,0,0,0,0,0,0,0,0,0,0
JHARKHAND,2013,Paralysis,0,0,3,4,2,9,0,2,3,2,0,7,16
JHARKHAND,2013,Insanity/Mental Illness,1,14,17,10,4,46,2,6,6,3,1,18,64
JHARKHAND,2013,Other Prolonged Illness,2,9,11,20,11,53,0,5,8,7,3,23,76
JHARKHAND,2013,Death of Dear Person,0,1,0,1,1,3,0,1,1,0,0,2,5
JHARKHAND,2013,Dowry Dispute,0,0,0,0,0,0,0,12,10,0,0,22,22
JHARKHAND,2013,Divorce,0,0,1,0,0,1,0,3,5,0,0,8,9
JHARKHAND,2013,Drug Abuse/Addiction,0,22,21,21,3,67,0,0,6,5,0,11,78
JHARKHAND,2013,Failure in Examination,3,24,2,0,2,31,0,13,7,0,0,20,51
JHARKHAND,2013,Fall in Social Reputation,0,8,6,4,0,18,0,3,1,0,1,5,23
JHARKHAND,2013,Family Problems,0,30,46,30,8,114,1,28,20,15,2,66,180
JHARKHAND,2013,Ideological Causes/Hero Worshipping,0,0,0,0,0,0,0,3,0,0,0,3,3
JHARKHAND,2013,Illegitimate Pregnancy,0,0,0,0,0,0,0,4,0,0,0,4,4
JHARKHAND,2013,Love Affairs,0,41,16,0,0,57,4,33,4,0,0,41,98
JHARKHAND,2013,"Physical Abuse (Rape,Incest Etc.)",0,0,7,23,0,30,0,3,8,0,0,11,41
JHARKHAND,2013,Poverty,0,0,4,1,3,8,0,2,2,0,0,4,12
JHARKHAND,2013,Professional/Career Problem,0,0,7,6,0,13,0,0,0,0,0,0,13
JHARKHAND,2013,Property Dispute,0,4,8,6,0,18,0,0,0,0,0,0,18
JHARKHAND,2013,Unemployment,0,11,15,4,2,32,0,3,2,0,0,5,37
JHARKHAND,2013,Causes Not known,1,48,36,35,7,127,1,22,15,8,1,47,174
JHARKHAND,2013,Other Causes (Please Specity),43,76,82,78,28,307,14,38,41,38,9,140,447
JHARKHAND,2013,Total,50,318,295,249,72,984,22,206,151,80,17,476,1460
JHARKHAND,2013,Total Illness,3,23,31,34,17,108,2,13,17,12,4,48,156
KARNATAKA,2013,Bankruptcy or Sudden change in Economic,0,19,56,37,8,120,1,4,3,1,1,10,130
KARNATAKA,2013,Suspected/Illicit Relation,0,2,3,1,0,6,0,2,3,0,0,5,11
KARNATAKA,2013,Cancellation/Non-Settlement of Marriage,0,22,16,0,1,39,0,22,4,1,0,27,66
KARNATAKA,2013,Not having Children(Barrenness/Impotency,0,6,19,3,0,28,0,26,15,6,0,47,75
KARNATAKA,2013,Illness (Aids/STD),0,3,10,0,0,13,0,1,5,2,0,8,21
KARNATAKA,2013,Cancer,0,3,8,11,13,35,0,3,1,1,3,8,43
KARNATAKA,2013,Paralysis,0,4,6,26,12,48,0,2,3,4,2,11,59
KARNATAKA,2013,Insanity/Mental Illness,6,102,119,95,26,348,5,86,62,28,18,199,547
KARNATAKA,2013,Other Prolonged Illness,8,343,568,457,185,1561,14,317,243,172,80,826,2387
KARNATAKA,2013,Death of Dear Person,0,11,12,5,3,31,0,9,15,2,0,26,57
KARNATAKA,2013,Dowry Dispute,0,0,0,0,0,0,0,25,7,0,0,32,32
KARNATAKA,2013,Divorce,0,1,0,4,0,5,0,3,3,0,0,6,11
KARNATAKA,2013,Drug Abuse/Addiction,1,14,21,17,6,59,0,7,1,0,0,8,67
KARNATAKA,2013,Failure in Examination,13,80,3,0,0,96,3,75,4,0,0,82,178
KARNATAKA,2013,Fall in Social Reputation,0,16,21,23,2,62,1,12,5,2,0,20,82
KARNATAKA,2013,Family Problems,7,324,457,251,102,1141,9,251,200,66,20,546,1687
KARNATAKA,2013,Ideological Causes/Hero Worshipping,0,1,2,1,0,4,0,1,1,0,0,2,6
KARNATAKA,2013,Illegitimate Pregnancy,0,0,0,0,0,0,0,2,0,0,0,2,2
KARNATAKA,2013,Love Affairs,0,93,18,1,0,112,0,66,4,1,0,71,183
KARNATAKA,2013,"Physical Abuse (Rape,Incest Etc.)",0,1,2,0,1,4,0,0,0,0,0,0,4
KARNATAKA,2013,Poverty,0,35,102,69,12,218,0,18,23,56,43,140,358
KARNATAKA,2013,Professional/Career Problem,0,14,34,17,2,67,0,8,0,0,0,8,75
KARNATAKA,2013,Property Dispute,0,4,20,19,0,43,0,0,2,1,0,3,46
KARNATAKA,2013,Unemployment,0,43,22,6,2,73,0,3,5,0,0,8,81
KARNATAKA,2013,Causes Not known,33,522,590,317,95,1557,54,238,127,85,19,523,2080
KARNATAKA,2013,Other Causes (Please Specity),44,536,706,547,230,2063,26,290,357,147,95,915,2978
KARNATAKA,2013,Total,112,2199,2815,1907,700,7733,113,1471,1093,575,281,3533,11266
KARNATAKA,2013,Total Illness,14,455,711,589,236,2005,19,409,314,207,103,1052,3057
KERALA,2013,Bankruptcy or Sudden change in Economic,1,30,95,131,48,305,0,4,8,5,6,23,328
KERALA,2013,Suspected/Illicit Relation,0,3,2,2,0,7,0,4,4,0,0,8,15
KERALA,2013,Cancellation/Non-Settlement of Marriage,0,5,3,0,0,8,0,11,4,0,0,15,23
KERALA,2013,Not having Children(Barrenness/Impotency,0,3,13,9,0,25,0,2,5,4,0,11,36
KERALA,2013,Illness (Aids/STD),0,0,0,0,1,1,0,0,0,0,0,0,1
KERALA,2013,Cancer,0,1,31,59,30,121,0,2,11,14,7,34,155
KERALA,2013,Paralysis,0,0,2,36,17,55,0,0,2,2,4,8,63
KERALA,2013,Insanity/Mental Illness,2,67,131,138,102,440,2,37,51,49,35,174,614
KERALA,2013,Other Prolonged Illness,0,51,150,237,238,676,1,20,40,47,109,217,893
KERALA,2013,Death of Dear Person,1,9,14,23,22,69,0,13,11,18,16,58,127
KERALA,2013,Dowry Dispute,0,0,0,0,0,0,0,20,5,0,0,25,25
KERALA,2013,Divorce,0,1,9,9,4,23,0,4,8,3,2,17,40
KERALA,2013,Drug Abuse/Addiction,0,40,151,155,54,400,0,0,0,0,0,0,400
KERALA,2013,Failure in Examination,6,13,0,0,0,19,7,13,0,0,0,20,39
KERALA,2013,Fall in Social Reputation,0,3,13,20,6,42,0,1,8,4,0,13,55
KERALA,2013,Family Problems,21,649,1157,1089,615,3531,26,269,246,255,194,990,4521
KERALA,2013,Ideological Causes/Hero Worshipping,0,0,0,0,0,0,0,0,0,0,0,0,0
KERALA,2013,Illegitimate Pregnancy,0,0,0,0,0,0,0,4,2,0,0,6,6
KERALA,2013,Love Affairs,0,61,9,0,0,70,1,46,4,0,0,51,121
KERALA,2013,"Physical Abuse (Rape,Incest Etc.)",0,0,0,0,0,0,0,4,2,0,0,6,6
KERALA,2013,Poverty,0,0,0,0,0,0,0,0,0,0,0,0,0
KERALA,2013,Professional/Career Problem,0,32,34,24,7,97,0,5,7,5,1,18,115
KERALA,2013,Property Dispute,0,5,35,39,8,87,0,0,6,4,3,13,100
KERALA,2013,Unemployment,0,12,12,2,1,27,0,0,2,0,0,2,29
KERALA,2013,Causes Not known,4,93,162,168,90,517,4,36,43,42,34,159,676
KERALA,2013,Other Causes (Please Specity),3,46,50,51,31,181,2,29,22,11,13,77,258
KERALA,2013,Total,38,1124,2073,2192,1274,6701,43,524,491,463,424,1945,8646
KERALA,2013,Total Illness,2,119,314,470,388,1293,3,59,104,112,155,433,1726
LAKSHADWEEP,2013,Bankruptcy or Sudden change in Economic,0,0,0,0,0,0,0,0,0,0,0,0,0
LAKSHADWEEP,2013,Suspected/Illicit Relation,0,0,0,0,0,0,0,0,0,0,0,0,0
LAKSHADWEEP,2013,Cancellation/Non-Settlement of Marriage,0,0,0,0,0,0,0,0,0,0,0,0,0
LAKSHADWEEP,2013,Not having Children(Barrenness/Impotency,0,0,0,0,0,0,0,0,0,0,0,0,0
LAKSHADWEEP,2013,Illness (Aids/STD),0,0,0,0,0,0,0,0,0,0,0,0,0
LAKSHADWEEP,2013,Cancer,0,0,0,0,0,0,0,0,0,0,0,0,0
LAKSHADWEEP,2013,Paralysis,0,0,0,0,0,0,0,0,0,0,0,0,0
LAKSHADWEEP,2013,Insanity/Mental Illness,0,0,0,0,0,0,0,0,1,0,0,1,1
LAKSHADWEEP,2013,Other Prolonged Illness,0,0,0,0,0,0,0,0,0,0,0,0,0
LAKSHADWEEP,2013,Death of Dear Person,0,0,0,0,0,0,0,0,0,0,0,0,0
LAKSHADWEEP,2013,Dowry Dispute,0,0,0,0,0,0,0,0,0,0,0,0,0
LAKSHADWEEP,2013,Divorce,0,0,0,0,0,0,0,0,0,0,0,0,0
LAKSHADWEEP,2013,Drug Abuse/Addiction,0,0,0,0,0,0,0,0,0,0,0,0,0
LAKSHADWEEP,2013,Failure in Examination,0,0,0,0,0,0,0,0,0,0,0,0,0
LAKSHADWEEP,2013,Fall in Social Reputation,0,0,0,0,0,0,0,0,0,0,0,0,0
LAKSHADWEEP,2013,Family Problems,0,0,0,0,0,0,0,0,0,0,0,0,0
LAKSHADWEEP,2013,Ideological Causes/Hero Worshipping,0,0,0,0,0,0,0,0,0,0,0,0,0
LAKSHADWEEP,2013,Illegitimate Pregnancy,0,0,0,0,0,0,0,0,0,0,0,0,0
LAKSHADWEEP,2013,Love Affairs,0,0,0,0,0,0,0,0,0,0,0,0,0
LAKSHADWEEP,2013,"Physical Abuse (Rape,Incest Etc.)",0,0,0,0,0,0,0,0,0,0,0,0,0
LAKSHADWEEP,2013,Poverty,0,0,0,0,0,0,0,0,0,0,0,0,0
LAKSHADWEEP,2013,Professional/Career Problem,0,0,0,0,0,0,0,0,0,0,0,0,0
LAKSHADWEEP,2013,Property Dispute,0,0,0,0,0,0,0,0,0,0,0,0,0
LAKSHADWEEP,2013,Unemployment,0,0,0,0,0,0,0,0,0,0,0,0,0
LAKSHADWEEP,2013,Causes Not known,0,0,0,0,0,0,0,0,0,0,0,0,0
LAKSHADWEEP,2013,Other Causes (Please Specity),0,0,0,0,1,1,0,1,0,0,0,1,2
LAKSHADWEEP,2013,Total,0,0,0,0,1,1,0,1,1,0,0,2,3
LAKSHADWEEP,2013,Total Illness,0,0,0,0,0,0,0,0,1,0,0,1,1
MADHYA PRADESH,2013,Bankruptcy or Sudden change in Economic,0,15,25,12,1,53,0,0,0,0,1,1,54
MADHYA PRADESH,2013,Suspected/Illicit Relation,0,41,13,15,7,76,1,29,21,2,0,53,129
MADHYA PRADESH,2013,Cancellation/Non-Settlement of Marriage,0,46,10,1,1,58,0,34,5,1,0,40,98
MADHYA PRADESH,2013,Not having Children(Barrenness/Impotency,0,12,8,4,0,24,0,20,17,0,0,37,61
MADHYA PRADESH,2013,Illness (Aids/STD),0,7,11,9,4,31,3,4,8,5,1,21,52
MADHYA PRADESH,2013,Cancer,0,1,6,2,5,14,0,0,3,1,0,4,18
MADHYA PRADESH,2013,Paralysis,0,0,1,2,4,7,0,2,1,1,2,6,13
MADHYA PRADESH,2013,Insanity/Mental Illness,12,163,181,100,51,507,11,76,78,36,16,217,724
MADHYA PRADESH,2013,Other Prolonged Illness,4,149,208,169,138,668,10,102,99,53,42,306,974
MADHYA PRADESH,2013,Death of Dear Person,0,24,16,9,9,58,1,58,33,10,2,104,162
MADHYA PRADESH,2013,Dowry Dispute,0,1,1,0,0,2,0,440,74,2,0,516,518
MADHYA PRADESH,2013,Divorce,0,2,7,1,0,10,0,7,2,0,0,9,19
MADHYA PRADESH,2013,Drug Abuse/Addiction,1,161,251,135,52,600,0,8,10,5,5,28,628
MADHYA PRADESH,2013,Failure in Examination,17,84,25,0,1,127,16,71,4,0,0,91,218
MADHYA PRADESH,2013,Fall in Social Reputation,1,17,18,15,6,57,1,22,17,2,1,43,100
MADHYA PRADESH,2013,Family Problems,13,478,425,250,87,1253,10,405,246,111,39,811,2064
MADHYA PRADESH,2013,Ideological Causes/Hero Worshipping,0,0,0,0,0,0,0,2,0,0,0,2,2
MADHYA PRADESH,2013,Illegitimate Pregnancy,0,0,0,0,0,0,1,11,2,0,0,14,14
MADHYA PRADESH,2013,Love Affairs,3,82,29,9,0,123,9,118,19,6,0,152,275
MADHYA PRADESH,2013,"Physical Abuse (Rape,Incest Etc.)",0,15,9,5,1,30,2,48,39,9,1,99,129
MADHYA PRADESH,2013,Poverty,0,5,3,1,1,10,0,3,1,1,0,5,15
MADHYA PRADESH,2013,Professional/Career Problem,0,53,30,11,3,97,0,4,3,2,0,9,106
MADHYA PRADESH,2013,Property Dispute,0,12,14,16,6,48,0,6,7,5,1,19,67
MADHYA PRADESH,2013,Unemployment,7,37,32,7,1,84,5,22,11,2,0,40,124
MADHYA PRADESH,2013,Causes Not known,74,440,317,194,62,1087,27,299,174,57,41,598,1685
MADHYA PRADESH,2013,Other Causes (Please Specity),59,218,194,115,60,646,61,257,137,70,26,551,1197
MADHYA PRADESH,2013,Total,191,2063,1834,1082,500,5670,158,2048,1011,381,178,3776,9446
MADHYA PRADESH,2013,Total Illness,16,320,407,282,202,1227,24,184,189,96,61,554,1781
MAHARASHTRA,2013,Bankruptcy or Sudden change in Economic,0,90,269,178,46,583,0,7,9,15,5,36,619
MAHARASHTRA,2013,Suspected/Illicit Relation,0,11,16,9,4,40,0,20,10,1,1,32,72
MAHARASHTRA,2013,Cancellation/Non-Settlement of Marriage,0,68,31,4,1,104,0,57,7,3,0,67,171
MAHARASHTRA,2013,Not having Children(Barrenness/Impotency,0,12,15,5,4,36,0,32,31,4,0,67,103
MAHARASHTRA,2013,Illness (Aids/STD),0,17,33,20,9,79,1,7,10,4,3,25,104
MAHARASHTRA,2013,Cancer,0,8,18,25,11,62,0,2,8,7,3,20,82
MAHARASHTRA,2013,Paralysis,0,0,10,31,25,66,0,3,4,3,6,16,82
MAHARASHTRA,2013,Insanity/Mental Illness,7,224,290,147,64,732,5,125,134,73,36,373,1105
MAHARASHTRA,2013,Other Prolonged Illness,7,320,560,523,495,1905,14,245,206,154,180,799,2704
MAHARASHTRA,2013,Death of Dear Person,0,26,33,22,12,93,2,14,18,10,5,49,142
MAHARASHTRA,2013,Dowry Dispute,0,0,0,0,0,0,0,150,41,0,0,191,191
MAHARASHTRA,2013,Divorce,0,5,8,4,1,18,0,12,5,0,0,17,35
MAHARASHTRA,2013,Drug Abuse/Addiction,2,427,800,452,100,1781,0,3,3,6,1,13,1794
MAHARASHTRA,2013,Failure in Examination,21,160,3,1,0,185,18,145,1,0,0,164,349
MAHARASHTRA,2013,Fall in Social Reputation,0,17,24,12,9,62,0,12,6,1,0,19,81
MAHARASHTRA,2013,Family Problems,28,1344,1543,902,277,4094,39,1163,758,227,72,2259,6353
MAHARASHTRA,2013,Ideological Causes/Hero Worshipping,1,7,3,0,1,12,1,11,1,0,0,13,25
MAHARASHTRA,2013,Illegitimate Pregnancy,0,0,0,0,0,0,0,5,0,0,0,5,5
MAHARASHTRA,2013,Love Affairs,0,138,17,1,0,156,1,91,8,1,0,101,257
MAHARASHTRA,2013,"Physical Abuse (Rape,Incest Etc.)",0,0,0,0,0,0,1,17,3,3,0,24,24
MAHARASHTRA,2013,Poverty,0,49,87,65,12,213,0,10,13,5,1,29,242
MAHARASHTRA,2013,Professional/Career Problem,0,63,86,59,15,223,0,12,3,2,0,17,240
MAHARASHTRA,2013,Property Dispute,0,7,18,12,5,42,0,2,8,4,3,17,59
MAHARASHTRA,2013,Unemployment,0,162,114,22,0,298,0,13,1,0,0,14,312
MAHARASHTRA,2013,Causes Not known,13,228,215,117,42,615,13,127,46,12,9,207,822
MAHARASHTRA,2013,Other Causes (Please Specity),12,178,174,99,30,493,11,100,29,9,7,156,649
MAHARASHTRA,2013,Total,91,3561,4367,2710,1163,11892,106,2385,1363,544,332,4730,16622
MAHARASHTRA,2013,Total Illness,14,569,911,746,604,2844,20,382,362,241,228,1233,4077
MANIPUR,2013,Bankruptcy or Sudden change in Economic,0,0,0,0,0,0,0,0,0,0,0,0,0
MANIPUR,2013,Suspected/Illicit Relation,0,0,0,0,0,0,0,0,0,0,0,0,0
MANIPUR,2013,Cancellation/Non-Settlement of Marriage,0,0,0,0,0,0,0,0,0,0,0,0,0
MANIPUR,2013,Not having Children(Barrenness/Impotency,0,0,0,0,0,0,0,0,0,0,0,0,0
MANIPUR,2013,Illness (Aids/STD),0,0,0,0,0,0,0,0,0,0,0,0,0
MANIPUR,2013,Cancer,0,0,0,0,0,0,0,0,0,0,0,0,0
MANIPUR,2013,Paralysis,0,0,0,0,0,0,0,0,0,0,0,0,0
MANIPUR,2013,Insanity/Mental Illness,0,0,0,0,0,0,0,0,0,0,0,0,0
MANIPUR,2013,Other Prolonged Illness,0,0,0,0,0,0,0,0,0,0,0,0,0
MANIPUR,2013,Death of Dear Person,0,0,0,0,0,0,0,0,0,0,0,0,0
MANIPUR,2013,Dowry Dispute,0,0,0,0,0,0,0,0,0,0,0,0,0
MANIPUR,2013,Divorce,0,0,0,0,0,0,0,0,0,0,0,0,0
MANIPUR,2013,Drug Abuse/Addiction,0,0,0,0,0,0,0,0,0,0,0,0,0
MANIPUR,2013,Failure in Examination,0,0,0,0,0,0,0,0,0,0,0,0,0
MANIPUR,2013,Fall in Social Reputation,0,0,0,0,0,0,0,0,0,0,0,0,0
MANIPUR,2013,Family Problems,0,0,0,0,0,0,0,0,0,0,0,0,0
MANIPUR,2013,Ideological Causes/Hero Worshipping,0,0,0,0,0,0,0,0,0,0,0,0,0
MANIPUR,2013,Illegitimate Pregnancy,0,0,0,0,0,0,0,0,0,0,0,0,0
MANIPUR,2013,Love Affairs,0,0,0,0,0,0,0,0,0,0,0,0,0
MANIPUR,2013,"Physical Abuse (Rape,Incest Etc.)",0,0,0,0,0,0,0,0,0,0,0,0,0
MANIPUR,2013,Poverty,0,0,0,0,0,0,0,0,0,0,0,0,0
MANIPUR,2013,Professional/Career Problem,0,0,0,0,0,0,0,0,0,0,0,0,0
MANIPUR,2013,Property Dispute,0,0,0,0,0,0,0,0,0,0,0,0,0
MANIPUR,2013,Unemployment,0,0,0,0,0,0,0,0,0,0,0,0,0
MANIPUR,2013,Causes Not known,0,6,8,2,1,17,2,4,2,0,0,8,25
MANIPUR,2013,Other Causes (Please Specity),1,1,2,1,0,5,0,6,0,1,0,7,12
MANIPUR,2013,Total,1,7,10,3,1,22,2,10,2,1,0,15,37
MANIPUR,2013,Total Illness,0,0,0,0,0,0,0,0,0,0,0,0,0
MEGHALAYA,2013,Bankruptcy or Sudden change in Economic,0,1,0,0,0,1,0,0,0,0,0,0,1
MEGHALAYA,2013,Suspected/Illicit Relation,0,0,0,0,0,0,0,0,0,0,0,0,0
MEGHALAYA,2013,Cancellation/Non-Settlement of Marriage,0,0,0,0,0,0,0,0,0,0,0,0,0
MEGHALAYA,2013,Not having Children(Barrenness/Impotency,0,0,0,0,0,0,0,0,0,0,0,0,0
MEGHALAYA,2013,Illness (Aids/STD),0,0,0,0,0,0,0,0,0,0,0,0,0
MEGHALAYA,2013,Cancer,0,0,0,0,1,1,0,0,0,0,0,0,1
MEGHALAYA,2013,Paralysis,0,0,0,0,0,0,0,0,0,0,0,0,0
MEGHALAYA,2013,Insanity/Mental Illness,0,1,3,1,0,5,0,2,0,0,0,2,7
MEGHALAYA,2013,Other Prolonged Illness,0,0,0,0,1,1,0,0,0,0,0,0,1
MEGHALAYA,2013,Death of Dear Person,0,0,0,0,0,0,0,0,0,0,0,0,0
MEGHALAYA,2013,Dowry Dispute,0,0,0,0,0,0,0,0,0,0,0,0,0
MEGHALAYA,2013,Divorce,0,0,0,0,0,0,0,0,0,0,0,0,0
MEGHALAYA,2013,Drug Abuse/Addiction,0,1,0,0,0,1,0,0,0,0,0,0,1
MEGHALAYA,2013,Failure in Examination,0,1,0,0,0,1,0,0,0,0,0,0,1
MEGHALAYA,2013,Fall in Social Reputation,0,0,4,0,0,4,0,0,0,0,0,0,4
MEGHALAYA,2013,Family Problems,0,10,4,4,0,18,0,6,4,0,0,10,28
MEGHALAYA,2013,Ideological Causes/Hero Worshipping,0,0,0,0,0,0,0,0,0,0,0,0,0
MEGHALAYA,2013,Illegitimate Pregnancy,0,0,0,0,0,0,0,4,0,0,0,4,4
MEGHALAYA,2013,Love Affairs,0,6,0,0,0,6,2,2,0,0,0,4,10
MEGHALAYA,2013,"Physical Abuse (Rape,Incest Etc.)",0,0,0,0,0,0,0,0,0,0,0,0,0
MEGHALAYA,2013,Poverty,0,0,0,0,0,0,0,1,0,0,0,1,1
MEGHALAYA,2013,Professional/Career Problem,0,0,0,0,0,0,0,0,0,0,0,0,0
MEGHALAYA,2013,Property Dispute,0,0,0,0,0,0,0,0,0,0,0,0,0
MEGHALAYA,2013,Unemployment,0,0,0,0,0,0,0,0,0,0,0,0,0
MEGHALAYA,2013,Causes Not known,3,26,13,5,1,48,4,9,5,2,0,20,68
MEGHALAYA,2013,Other Causes (Please Specity),0,5,4,1,0,10,0,0,0,0,0,0,10
MEGHALAYA,2013,Total,3,51,28,11,3,96,6,24,9,2,0,41,137
MEGHALAYA,2013,Total Illness,0,1,3,1,2,7,0,2,0,0,0,2,9
MIZORAM,2013,Bankruptcy or Sudden change in Economic,0,0,0,0,0,0,0,0,0,0,0,0,0
MIZORAM,2013,Suspected/Illicit Relation,0,0,0,0,0,0,0,0,0,0,0,0,0
MIZORAM,2013,Cancellation/Non-Settlement of Marriage,0,0,0,0,0,0,0,0,0,0,0,0,0
MIZORAM,2013,Not having Children(Barrenness/Impotency,0,0,0,0,0,0,0,0,0,0,0,0,0
MIZORAM,2013,Illness (Aids/STD),0,0,0,0,0,0,0,0,0,0,0,0,0
MIZORAM,2013,Cancer,0,0,0,0,0,0,0,0,0,0,0,0,0
MIZORAM,2013,Paralysis,0,0,0,0,0,0,0,0,0,0,0,0,0
MIZORAM,2013,Insanity/Mental Illness,0,0,0,0,0,0,0,0,0,0,0,0,0
MIZORAM,2013,Other Prolonged Illness,0,0,0,0,0,0,0,0,0,0,0,0,0
MIZORAM,2013,Death of Dear Person,0,24,12,4,1,41,0,3,0,1,0,4,45
MIZORAM,2013,Dowry Dispute,0,0,0,0,0,0,0,0,0,0,0,0,0
MIZORAM,2013,Divorce,0,0,0,0,0,0,0,0,0,0,0,0,0
MIZORAM,2013,Drug Abuse/Addiction,0,6,1,0,0,7,0,1,0,0,0,1,8
MIZORAM,2013,Failure in Examination,0,0,0,0,0,0,0,0,0,0,0,0,0
MIZORAM,2013,Fall in Social Reputation,0,0,0,0,0,0,0,0,0,0,0,0,0
MIZORAM,2013,Family Problems,0,1,0,0,0,1,0,0,0,0,0,0,1
MIZORAM,2013,Ideological Causes/Hero Worshipping,0,0,0,0,0,0,0,0,0,0,0,0,0
MIZORAM,2013,Illegitimate Pregnancy,0,0,0,0,0,0,0,0,0,0,0,0,0
MIZORAM,2013,Love Affairs,0,0,0,0,0,0,0,0,0,0,0,0,0
MIZORAM,2013,"Physical Abuse (Rape,Incest Etc.)",0,0,0,0,0,0,0,0,0,0,0,0,0
MIZORAM,2013,Poverty,0,0,0,0,0,0,0,0,0,0,0,0,0
MIZORAM,2013,Professional/Career Problem,0,0,0,0,0,0,0,0,0,0,0,0,0
MIZORAM,2013,Property Dispute,0,0,0,0,0,0,0,0,0,0,0,0,0
MIZORAM,2013,Unemployment,0,0,0,0,0,0,0,0,0,0,0,0,0
MIZORAM,2013,Causes Not known,2,10,6,6,0,24,2,2,3,1,0,8,32
MIZORAM,2013,Other Causes (Please Specity),1,3,1,1,0,6,0,1,1,1,0,3,9
MIZORAM,2013,Total,3,44,20,11,1,79,2,7,4,3,0,16,95
MIZORAM,2013,Total Illness,0,0,0,0,0,0,0,0,0,0,0,0,0
NAGALAND,2013,Bankruptcy or Sudden change in Economic,0,0,0,0,0,0,0,0,0,0,0,0,0
NAGALAND,2013,Suspected/Illicit Relation,0,0,0,0,0,0,0,0,0,0,0,0,0
NAGALAND,2013,Cancellation/Non-Settlement of Marriage,0,0,0,0,0,0,0,0,0,0,0,0,0
NAGALAND,2013,Not having Children(Barrenness/Impotency,0,0,0,0,0,0,0,0,0,0,0,0,0
NAGALAND,2013,Illness (Aids/STD),0,0,0,0,0,0,0,0,0,0,0,0,0
NAGALAND,2013,Cancer,0,0,0,0,0,0,0,0,0,0,0,0,0
NAGALAND,2013,Paralysis,0,0,0,0,0,0,0,0,0,0,0,0,0
NAGALAND,2013,Insanity/Mental Illness,0,0,0,0,0,0,0,0,0,0,0,0,0
NAGALAND,2013,Other Prolonged Illness,0,0,0,0,0,0,0,0,0,0,0,0,0
NAGALAND,2013,Death of Dear Person,0,0,0,0,0,0,0,0,0,0,0,0,0
NAGALAND,2013,Dowry Dispute,0,0,0,0,0,0,0,0,0,0,0,0,0
NAGALAND,2013,Divorce,0,0,0,0,0,0,0,0,0,0,0,0,0
NAGALAND,2013,Drug Abuse/Addiction,0,0,0,0,0,0,0,0,0,0,0,0,0
NAGALAND,2013,Failure in Examination,0,0,0,0,0,0,0,0,0,0,0,0,0
NAGALAND,2013,Fall in Social Reputation,0,0,0,0,0,0,0,0,0,0,0,0,0
NAGALAND,2013,Family Problems,0,0,0,0,0,0,0,0,0,0,0,0,0
NAGALAND,2013,Ideological Causes/Hero Worshipping,0,0,0,0,0,0,0,0,0,0,0,0,0
NAGALAND,2013,Illegitimate Pregnancy,0,0,0,0,0,0,0,0,0,0,0,0,0
NAGALAND,2013,Love Affairs,0,0,0,0,0,0,0,0,0,0,0,0,0
NAGALAND,2013,"Physical Abuse (Rape,Incest Etc.)",0,0,0,0,0,0,0,0,0,0,0,0,0
NAGALAND,2013,Poverty,0,0,0,0,0,0,0,0,0,0,0,0,0
NAGALAND,2013,Professional/Career Problem,0,0,0,0,0,0,0,0,0,0,0,0,0
NAGALAND,2013,Property Dispute,0,0,0,0,0,0,0,0,0,0,0,0,0
NAGALAND,2013,Unemployment,0,0,0,0,0,0,0,0,0,0,0,0,0
NAGALAND,2013,Causes Not known,1,7,15,1,1,25,0,7,2,1,2,12,37
NAGALAND,2013,Other Causes (Please Specity),0,0,0,0,0,0,0,0,0,0,0,0,0
NAGALAND,2013,Total,1,7,15,1,1,25,0,7,2,1,2,12,37
NAGALAND,2013,Total Illness,0,0,0,0,0,0,0,0,0,0,0,0,0
ODISHA,2013,Bankruptcy or Sudden change in Economic,0,0,5,11,0,16,0,0,1,0,0,1,17
ODISHA,2013,Suspected/Illicit Relation,0,34,33,12,0,79,4,33,20,7,0,64,143
ODISHA,2013,Cancellation/Non-Settlement of Marriage,0,11,6,2,0,19,0,9,13,5,0,27,46
ODISHA,2013,Not having Children(Barrenness/Impotency,0,0,0,0,0,0,0,1,2,0,0,3,3
ODISHA,2013,Illness (Aids/STD),0,0,0,0,0,0,0,0,0,0,0,0,0
ODISHA,2013,Cancer,0,0,7,7,3,17,1,0,1,2,2,6,23
ODISHA,2013,Paralysis,0,0,0,0,0,0,0,0,0,0,0,0,0
ODISHA,2013,Insanity/Mental Illness,0,21,23,19,2,65,0,16,8,6,2,32,97
ODISHA,2013,Other Prolonged Illness,0,8,34,23,7,72,1,4,10,17,7,39,111
ODISHA,2013,Death of Dear Person,0,7,0,3,2,12,0,0,1,0,0,1,13
ODISHA,2013,Dowry Dispute,0,0,0,0,0,0,0,57,33,0,0,90,90
ODISHA,2013,Divorce,0,0,0,0,0,0,0,1,1,0,0,2,2
ODISHA,2013,Drug Abuse/Addiction,2,6,9,5,0,22,0,1,1,0,0,2,24
ODISHA,2013,Failure in Examination,6,43,0,0,0,49,6,32,0,0,0,38,87
ODISHA,2013,Fall in Social Reputation,0,8,36,34,2,80,0,3,8,1,0,12,92
ODISHA,2013,Family Problems,1,114,218,169,45,547,6,95,136,97,13,347,894
ODISHA,2013,Ideological Causes/Hero Worshipping,0,0,1,0,1,2,0,0,0,0,0,0,2
ODISHA,2013,Illegitimate Pregnancy,0,0,0,0,0,0,3,18,8,0,0,29,29
ODISHA,2013,Love Affairs,0,89,29,0,0,118,10,91,41,0,0,142,260
ODISHA,2013,"Physical Abuse (Rape,Incest Etc.)",0,0,0,0,0,0,0,0,0,0,0,0,0
ODISHA,2013,Poverty,0,1,2,2,0,5,0,0,1,0,1,2,7
ODISHA,2013,Professional/Career Problem,0,2,5,5,0,12,0,1,2,0,0,3,15
ODISHA,2013,Property Dispute,0,8,10,2,4,24,0,4,3,1,1,9,33
ODISHA,2013,Unemployment,0,23,18,6,0,47,0,11,6,5,0,22,69
ODISHA,2013,Causes Not known,44,209,241,195,165,854,39,143,134,86,28,430,1284
ODISHA,2013,Other Causes (Please Specity),100,354,363,275,140,1232,69,212,202,121,75,679,1911
ODISHA,2013,Total,153,938,1040,770,371,3272,139,732,632,348,129,1980,5252
ODISHA,2013,Total Illness,0,29,64,49,12,154,2,20,19,25,11,77,231
PUDUCHERRY,2013,Bankruptcy or Sudden change in Economic,0,1,3,2,0,6,0,0,1,0,0,1,7
PUDUCHERRY,2013,Suspected/Illicit Relation,0,0,0,0,0,0,0,0,0,0,0,0,0
PUDUCHERRY,2013,Cancellation/Non-Settlement of Marriage,0,5,3,1,0,9,0,2,0,0,0,2,11
PUDUCHERRY,2013,Not having Children(Barrenness/Impotency,0,1,0,0,0,1,0,1,0,0,0,1,2
PUDUCHERRY,2013,Illness (Aids/STD),0,9,11,31,20,71,0,3,8,3,4,18,89
PUDUCHERRY,2013,Cancer,0,1,0,4,3,8,0,0,0,3,1,4,12
PUDUCHERRY,2013,Paralysis,0,0,0,0,0,0,0,0,0,0,0,0,0
PUDUCHERRY,2013,Insanity/Mental Illness,0,5,5,7,2,19,0,0,4,1,4,9,28
PUDUCHERRY,2013,Other Prolonged Illness,0,1,6,9,2,18,1,1,1,1,1,5,23
PUDUCHERRY,2013,Death of Dear Person,0,3,0,2,1,6,0,1,1,1,1,4,10
PUDUCHERRY,2013,Dowry Dispute,0,0,0,0,0,0,0,0,0,0,0,0,0
PUDUCHERRY,2013,Divorce,0,0,0,0,0,0,0,0,0,0,0,0,0
PUDUCHERRY,2013,Drug Abuse/Addiction,0,0,0,0,0,0,0,0,0,0,0,0,0
PUDUCHERRY,2013,Failure in Examination,0,2,0,0,0,2,1,3,0,0,0,4,6
PUDUCHERRY,2013,Fall in Social Reputation,0,2,4,5,1,12,0,2,1,0,0,3,15
PUDUCHERRY,2013,Family Problems,2,45,93,85,8,233,0,47,24,3,7,81,314
PUDUCHERRY,2013,Ideological Causes/Hero Worshipping,0,0,0,0,0,0,0,0,0,0,0,0,0
PUDUCHERRY,2013,Illegitimate Pregnancy,0,0,0,0,0,0,0,0,0,0,0,0,0
PUDUCHERRY,2013,Love Affairs,0,3,2,0,0,5,0,3,0,0,0,3,8
PUDUCHERRY,2013,"Physical Abuse (Rape,Incest Etc.)",0,0,0,0,0,0,0,0,0,0,0,0,0
PUDUCHERRY,2013,Poverty,0,0,0,0,0,0,0,0,0,0,0,0,0
PUDUCHERRY,2013,Professional/Career Problem,0,0,0,0,0,0,0,0,0,0,0,0,0
PUDUCHERRY,2013,Property Dispute,0,0,0,0,0,0,0,0,0,0,0,0,0
PUDUCHERRY,2013,Unemployment,0,0,1,0,0,1,0,0,0,0,0,0,1
PUDUCHERRY,2013,Causes Not known,1,6,3,4,2,16,0,3,0,0,0,3,19
PUDUCHERRY,2013,Other Causes (Please Specity),0,0,1,0,0,1,0,0,0,0,0,0,1
PUDUCHERRY,2013,Total,3,84,132,150,39,408,2,66,40,12,18,138,546
PUDUCHERRY,2013,Total Illness,0,16,22,51,27,116,1,4,13,8,10,36,152
PUNJAB,2013,Bankruptcy or Sudden change in Economic,0,0,0,3,0,3,0,0,0,0,0,0,3
PUNJAB,2013,Suspected/Illicit Relation,0,4,4,1,0,9,0,3,2,0,0,5,14
PUNJAB,2013,Cancellation/Non-Settlement of Marriage,0,0,0,0,0,0,0,2,0,0,0,2,2
PUNJAB,2013,Not having Children(Barrenness/Impotency,0,0,0,0,0,0,0,1,1,0,0,2,2
PUNJAB,2013,Illness (Aids/STD),0,0,0,1,0,1,0,0,0,0,0,0,1
PUNJAB,2013,Cancer,0,0,1,0,0,1,0,0,0,1,0,1,2
PUNJAB,2013,Paralysis,0,2,0,0,0,2,0,0,1,1,0,2,4
PUNJAB,2013,Insanity/Mental Illness,2,92,60,42,22,218,0,28,20,11,2,61,279
PUNJAB,2013,Other Prolonged Illness,0,14,15,12,8,49,1,8,2,1,1,13,62
PUNJAB,2013,Death of Dear Person,0,3,2,2,2,9,0,0,1,0,0,1,10
PUNJAB,2013,Dowry Dispute,0,0,0,0,0,0,0,10,3,0,0,13,13
PUNJAB,2013,Divorce,0,0,2,0,0,2,0,0,2,0,0,2,4
PUNJAB,2013,Drug Abuse/Addiction,0,31,22,8,4,65,0,1,0,0,0,1,66
PUNJAB,2013,Failure in Examination,1,18,0,0,0,19,1,10,0,0,0,11,30
PUNJAB,2013,Fall in Social Reputation,0,1,1,0,0,2,0,3,0,0,0,3,5
PUNJAB,2013,Family Problems,1,55,48,19,5,128,1,47,22,8,1,79,207
PUNJAB,2013,Ideological Causes/Hero Worshipping,0,0,0,0,0,0,0,0,0,0,0,0,0
PUNJAB,2013,Illegitimate Pregnancy,0,0,0,0,0,0,0,1,0,0,0,1,1
PUNJAB,2013,Love Affairs,0,4,2,0,0,6,0,13,1,0,0,14,20
PUNJAB,2013,"Physical Abuse (Rape,Incest Etc.)",0,0,0,0,0,0,1,1,0,0,0,2,2
PUNJAB,2013,Poverty,2,5,3,3,0,13,0,3,0,0,0,3,16
PUNJAB,2013,Professional/Career Problem,0,1,0,1,0,2,0,0,0,0,0,0,2
PUNJAB,2013,Property Dispute,0,3,2,2,0,7,0,0,0,0,0,0,7
PUNJAB,2013,Unemployment,0,1,0,0,0,1,0,0,0,0,0,0,1
PUNJAB,2013,Causes Not known,0,44,41,21,11,117,2,16,7,2,6,33,150
PUNJAB,2013,Other Causes (Please Specity),0,14,21,16,8,59,0,4,1,3,2,10,69
PUNJAB,2013,Total,6,292,224,131,60,713,6,151,63,27,12,259,972
PUNJAB,2013,Total Illness,2,108,76,55,30,271,1,36,23,14,3,77,348
RAJASTHAN,2013,Bankruptcy or Sudden change in Economic,0,2,17,5,1,25,0,2,4,0,0,6,31
RAJASTHAN,2013,Suspected/Illicit Relation,0,15,10,1,0,26,0,14,5,0,0,19,45
RAJASTHAN,2013,Cancellation/Non-Settlement of Marriage,0,8,5,1,0,14,0,8,1,0,0,9,23
RAJASTHAN,2013,Not having Children(Barrenness/Impotency,0,0,1,3,0,4,0,4,2,0,0,6,10
RAJASTHAN,2013,Illness (Aids/STD),0,2,1,0,0,3,0,0,0,0,0,0,3
RAJASTHAN,2013,Cancer,0,0,3,2,0,5,0,1,1,1,0,3,8
RAJASTHAN,2013,Paralysis,0,1,1,0,2,4,0,0,0,0,0,0,4
RAJASTHAN,2013,Insanity/Mental Illness,5,107,118,71,26,327,3,56,46,28,14,147,474
RAJASTHAN,2013,Other Prolonged Illness,1,12,36,38,9,96,1,14,11,8,4,38,134
RAJASTHAN,2013,Death of Dear Person,0,1,1,2,0,4,1,0,0,2,1,4,8
RAJASTHAN,2013,Dowry Dispute,0,0,0,0,0,0,0,25,11,0,0,36,36
RAJASTHAN,2013,Divorce,0,1,1,0,0,2,0,1,0,0,0,1,3
RAJASTHAN,2013,Drug Abuse/Addiction,0,40,57,39,8,144,0,0,0,0,0,0,144
RAJASTHAN,2013,Failure in Examination,1,39,0,0,0,40,1,27,0,0,0,28,68
RAJASTHAN,2013,Fall in Social Reputation,0,16,29,12,0,57,0,9,11,6,0,26,83
RAJASTHAN,2013,Family Problems,5,246,325,157,29,762,2,180,175,66,17,440,1202
RAJASTHAN,2013,Ideological Causes/Hero Worshipping,0,0,0,0,0,0,0,1,0,0,0,1,1
RAJASTHAN,2013,Illegitimate Pregnancy,0,0,0,0,0,0,0,0,0,0,0,0,0
RAJASTHAN,2013,Love Affairs,0,65,20,3,0,88,1,55,18,15,1,90,178
RAJASTHAN,2013,"Physical Abuse (Rape,Incest Etc.)",0,0,0,0,0,0,0,1,0,0,0,1,1
RAJASTHAN,2013,Poverty,0,4,4,0,0,8,0,0,1,0,0,1,9
RAJASTHAN,2013,Professional/Career Problem,0,6,32,11,2,51,0,0,2,0,0,2,53
RAJASTHAN,2013,Property Dispute,0,2,31,22,0,55,0,10,5,3,0,18,73
RAJASTHAN,2013,Unemployment,0,7,8,0,0,15,0,0,0,0,0,0,15
RAJASTHAN,2013,Causes Not known,12,243,198,86,24,563,7,110,55,17,12,201,764
RAJASTHAN,2013,Other Causes (Please Specity),23,297,393,321,50,1084,11,94,166,122,13,406,1490
RAJASTHAN,2013,Total,47,1114,1291,774,151,3377,27,612,514,268,62,1483,4860
RAJASTHAN,2013,Total Illness,6,122,159,111,37,435,4,71,58,37,18,188,623
SIKKIM,2013,Bankruptcy or Sudden change in Economic,0,3,2,0,0,5,0,0,0,0,0,0,5
SIKKIM,2013,Suspected/Illicit Relation,0,0,0,0,0,0,0,0,0,0,0,0,0
SIKKIM,2013,Cancellation/Non-Settlement of Marriage,0,4,4,0,0,8,0,4,0,0,0,4,12
SIKKIM,2013,Not having Children(Barrenness/Impotency,0,0,0,0,0,0,0,0,0,0,0,0,0
SIKKIM,2013,Illness (Aids/STD),0,0,0,0,0,0,0,0,0,0,0,0,0
SIKKIM,2013,Cancer,0,0,0,0,0,0,0,0,0,0,0,0,0
SIKKIM,2013,Paralysis,0,0,0,0,0,0,0,0,0,0,0,0,0
SIKKIM,2013,Insanity/Mental Illness,0,0,0,2,0,2,0,0,2,0,0,2,4
SIKKIM,2013,Other Prolonged Illness,0,2,3,0,1,6,0,0,0,0,0,0,6
SIKKIM,2013,Death of Dear Person,0,0,0,0,0,0,0,2,0,0,0,2,2
SIKKIM,2013,Dowry Dispute,0,0,0,0,0,0,0,0,0,0,0,0,0
SIKKIM,2013,Divorce,0,12,9,2,0,23,0,7,0,0,0,7,30
SIKKIM,2013,Drug Abuse/Addiction,0,9,6,3,0,18,0,0,0,0,0,0,18
SIKKIM,2013,Failure in Examination,2,9,0,0,0,11,0,4,0,0,0,4,15
SIKKIM,2013,Fall in Social Reputation,0,0,0,0,0,0,1,0,0,0,0,1,1
SIKKIM,2013,Family Problems,1,2,3,2,2,10,1,2,1,0,0,4,14
SIKKIM,2013,Ideological Causes/Hero Worshipping,0,0,0,0,0,0,0,0,0,0,0,0,0
SIKKIM,2013,Illegitimate Pregnancy,0,0,0,0,0,0,0,0,0,0,0,0,0
SIKKIM,2013,Love Affairs,1,0,2,0,0,3,1,5,0,0,0,6,9
SIKKIM,2013,"Physical Abuse (Rape,Incest Etc.)",0,0,0,0,0,0,0,0,0,0,0,0,0
SIKKIM,2013,Poverty,0,0,0,0,0,0,0,0,0,0,0,0,0
SIKKIM,2013,Professional/Career Problem,0,3,4,0,0,7,0,2,1,0,0,3,10
SIKKIM,2013,Property Dispute,0,0,0,0,0,0,0,0,0,0,0,0,0
SIKKIM,2013,Unemployment,0,0,0,0,0,0,0,0,0,0,0,0,0
SIKKIM,2013,Causes Not known,0,5,5,2,4,16,0,5,4,2,2,13,29
SIKKIM,2013,Other Causes (Please Specity),1,0,10,5,0,16,0,6,3,3,1,13,29
SIKKIM,2013,Total,5,49,48,16,7,125,3,37,11,5,3,59,184
SIKKIM,2013,Total Illness,0,2,3,2,1,8,0,0,2,0,0,2,10
TAMIL NADU,2013,Bankruptcy or Sudden change in Economic,0,19,36,43,15,113,0,3,11,15,8,37,150
TAMIL NADU,2013,Suspected/Illicit Relation,0,3,42,21,1,67,0,26,21,7,0,54,121
TAMIL NADU,2013,Cancellation/Non-Settlement of Marriage,0,30,23,7,2,62,0,26,6,4,1,37,99
TAMIL NADU,2013,Not having Children(Barrenness/Impotency,0,7,18,8,2,35,0,18,9,5,1,33,68
TAMIL NADU,2013,Illness (Aids/STD),0,2,11,12,1,26,0,1,2,13,1,17,43
TAMIL NADU,2013,Cancer,0,1,12,22,12,47,0,1,4,4,9,18,65
TAMIL NADU,2013,Paralysis,0,22,35,40,17,114,0,11,17,18,6,52,166
TAMIL NADU,2013,Insanity/Mental Illness,1,110,161,112,64,448,0,62,96,64,33,255,703
TAMIL NADU,2013,Other Prolonged Illness,24,429,650,662,430,2195,27,504,329,196,134,1190,3385
TAMIL NADU,2013,Death of Dear Person,0,20,21,8,9,58,0,14,5,10,0,29,87
TAMIL NADU,2013,Dowry Dispute,0,0,4,5,2,11,0,26,12,7,1,46,57
TAMIL NADU,2013,Divorce,0,2,5,4,0,11,0,3,5,3,0,11,22
TAMIL NADU,2013,Drug Abuse/Addiction,1,83,153,162,27,426,0,2,3,4,2,11,437
TAMIL NADU,2013,Failure in Examination,47,115,0,0,0,162,18,97,0,0,0,115,277
TAMIL NADU,2013,Fall in Social Reputation,0,117,104,82,23,326,0,51,74,19,15,159,485
TAMIL NADU,2013,Family Problems,16,830,1330,901,288,3365,20,770,618,262,106,1776,5141
TAMIL NADU,2013,Ideological Causes/Hero Worshipping,1,7,1,0,0,9,0,4,1,0,0,5,14
TAMIL NADU,2013,Illegitimate Pregnancy,0,0,0,0,0,0,0,12,4,0,0,16,16
TAMIL NADU,2013,Love Affairs,4,209,57,3,0,273,12,181,35,0,0,228,501
TAMIL NADU,2013,"Physical Abuse (Rape,Incest Etc.)",0,0,0,0,0,0,0,0,0,0,0,0,0
TAMIL NADU,2013,Poverty,0,17,14,7,8,46,0,4,5,2,1,12,58
TAMIL NADU,2013,Professional/Career Problem,0,26,48,75,13,162,0,5,3,3,3,14,176
TAMIL NADU,2013,Property Dispute,0,19,15,12,2,48,0,6,2,7,1,16,64
TAMIL NADU,2013,Unemployment,0,101,62,23,18,204,0,11,10,1,0,22,226
TAMIL NADU,2013,Causes Not known,4,90,154,113,62,423,7,49,43,32,22,153,576
TAMIL NADU,2013,Other Causes (Please Specity),92,557,860,724,318,2551,71,399,318,214,111,1113,3664
TAMIL NADU,2013,Total,190,2816,3816,3046,1314,11182,155,2286,1633,890,455,5419,16601
TAMIL NADU,2013,Total Illness,25,564,869,848,524,2830,27,579,448,295,183,1532,4362
TRIPURA,2013,Bankruptcy or Sudden change in Economic,0,0,0,0,0,0,0,0,0,0,0,0,0
TRIPURA,2013,Suspected/Illicit Relation,0,0,0,0,0,0,0,0,0,0,0,0,0
TRIPURA,2013,Cancellation/Non-Settlement of Marriage,0,0,0,0,0,0,0,0,0,0,0,0,0
TRIPURA,2013,Not having Children(Barrenness/Impotency,0,0,0,0,0,0,0,0,0,0,0,0,0
TRIPURA,2013,Illness (Aids/STD),0,0,0,0,0,0,0,0,0,0,0,0,0
TRIPURA,2013,Cancer,0,0,1,1,1,3,0,1,0,0,0,1,4
TRIPURA,2013,Paralysis,0,0,0,0,0,0,0,0,0,0,0,0,0
TRIPURA,2013,Insanity/Mental Illness,0,4,4,3,0,11,0,4,0,4,1,9,20
TRIPURA,2013,Other Prolonged Illness,0,4,0,4,7,15,0,0,1,1,3,5,20
TRIPURA,2013,Death of Dear Person,0,0,0,0,0,0,0,0,0,0,0,0,0
TRIPURA,2013,Dowry Dispute,0,0,0,0,0,0,0,5,4,2,0,11,11
TRIPURA,2013,Divorce,0,0,0,0,0,0,0,0,0,0,0,0,0
TRIPURA,2013,Drug Abuse/Addiction,0,0,0,0,0,0,0,0,0,0,0,0,0
TRIPURA,2013,Failure in Examination,3,1,0,0,0,4,2,4,0,0,0,6,10
TRIPURA,2013,Fall in Social Reputation,0,1,0,0,0,1,0,1,0,0,0,1,2
TRIPURA,2013,Family Problems,1,49,31,25,2,108,1,41,16,14,9,81,189
TRIPURA,2013,Ideological Causes/Hero Worshipping,0,0,0,0,0,0,0,0,0,0,0,0,0
TRIPURA,2013,Illegitimate Pregnancy,0,0,0,0,0,0,0,0,0,0,0,0,0
TRIPURA,2013,Love Affairs,1,12,7,0,0,20,0,15,5,0,0,20,40
TRIPURA,2013,"Physical Abuse (Rape,Incest Etc.)",0,0,0,0,0,0,0,0,0,0,0,0,0
TRIPURA,2013,Poverty,0,0,1,0,0,1,0,0,0,0,0,0,1
TRIPURA,2013,Professional/Career Problem,0,0,0,0,0,0,0,0,0,0,0,0,0
TRIPURA,2013,Property Dispute,0,0,0,0,0,0,0,0,0,0,0,0,0
TRIPURA,2013,Unemployment,0,0,3,4,0,7,0,0,2,0,0,2,9
TRIPURA,2013,Causes Not known,4,34,37,34,11,120,6,18,13,3,3,43,163
TRIPURA,2013,Other Causes (Please Specity),15,109,133,64,25,346,14,59,28,28,17,146,492
TRIPURA,2013,Total,24,214,217,135,46,636,23,148,69,52,33,325,961
TRIPURA,2013,Total Illness,0,8,5,8,8,29,0,5,1,5,4,15,44
UTTAR PRADESH,2013,Bankruptcy or Sudden change in Economic,0,4,13,10,0,27,0,0,1,1,0,2,29
UTTAR PRADESH,2013,Suspected/Illicit Relation,0,33,37,7,0,77,2,40,19,7,0,68,145
UTTAR PRADESH,2013,Cancellation/Non-Settlement of Marriage,0,14,5,0,0,19,0,31,6,1,0,38,57
UTTAR PRADESH,2013,Not having Children(Barrenness/Impotency,0,0,1,0,0,1,0,17,25,10,0,52,53
UTTAR PRADESH,2013,Illness (Aids/STD),0,8,14,7,4,33,2,8,15,6,2,33,66
UTTAR PRADESH,2013,Cancer,2,7,12,8,3,32,0,0,2,4,2,8,40
UTTAR PRADESH,2013,Paralysis,0,0,9,5,3,17,0,0,0,5,1,6,23
UTTAR PRADESH,2013,Insanity/Mental Illness,6,32,40,33,12,123,1,11,26,10,1,49,172
UTTAR PRADESH,2013,Other Prolonged Illness,3,25,67,82,40,217,4,22,26,39,26,117,334
UTTAR PRADESH,2013,Death of Dear Person,0,5,4,2,3,14,0,20,5,2,0,27,41
UTTAR PRADESH,2013,Dowry Dispute,0,17,8,13,0,38,9,359,60,6,0,434,472
UTTAR PRADESH,2013,Divorce,0,3,3,2,0,8,0,3,5,0,0,8,16
UTTAR PRADESH,2013,Drug Abuse/Addiction,0,19,51,38,7,115,0,0,3,0,0,3,118
UTTAR PRADESH,2013,Failure in Examination,8,66,1,0,0,75,5,61,11,0,0,77,152
UTTAR PRADESH,2013,Fall in Social Reputation,1,16,38,9,5,69,3,14,14,16,1,48,117
UTTAR PRADESH,2013,Family Problems,7,137,178,96,13,431,8,121,128,39,6,302,733
UTTAR PRADESH,2013,Ideological Causes/Hero Worshipping,0,2,0,1,0,3,0,0,1,0,0,1,4
UTTAR PRADESH,2013,Illegitimate Pregnancy,0,0,0,0,0,0,1,22,2,0,0,25,25
UTTAR PRADESH,2013,Love Affairs,2,119,52,13,0,186,3,103,39,6,0,151,337
UTTAR PRADESH,2013,"Physical Abuse (Rape,Incest Etc.)",0,0,0,0,0,0,0,5,4,4,0,13,13
UTTAR PRADESH,2013,Poverty,0,2,11,11,4,28,0,1,1,2,1,5,33
UTTAR PRADESH,2013,Professional/Career Problem,0,8,19,8,1,36,0,0,1,0,0,1,37
UTTAR PRADESH,2013,Property Dispute,0,10,20,14,2,46,0,1,4,2,0,7,53
UTTAR PRADESH,2013,Unemployment,1,23,16,5,0,45,0,2,7,1,0,10,55
UTTAR PRADESH,2013,Causes Not known,28,185,253,192,41,699,11,120,109,74,12,326,1025
UTTAR PRADESH,2013,Other Causes (Please Specity),54,302,274,133,61,824,13,146,111,37,5,312,1136
UTTAR PRADESH,2013,Total,112,1037,1126,689,199,3163,62,1107,625,272,57,2123,5286
UTTAR PRADESH,2013,Total Illness,11,72,142,135,62,422,7,41,69,64,32,213,635
UTTARAKHAND,2013,Bankruptcy or Sudden change in Economic,0,0,1,0,0,1,0,0,0,0,0,0,1
UTTARAKHAND,2013,Suspected/Illicit Relation,0,0,0,0,0,0,0,0,1,0,0,1,1
UTTARAKHAND,2013,Cancellation/Non-Settlement of Marriage,0,0,0,0,0,0,0,2,0,0,0,2,2
UTTARAKHAND,2013,Not having Children(Barrenness/Impotency,0,0,0,0,0,0,0,0,2,0,0,2,2
UTTARAKHAND,2013,Illness (Aids/STD),0,0,0,0,0,0,0,0,0,0,0,0,0
UTTARAKHAND,2013,Cancer,0,0,0,0,0,0,0,0,0,0,0,0,0
UTTARAKHAND,2013,Paralysis,0,0,0,0,0,0,0,0,0,0,0,0,0
UTTARAKHAND,2013,Insanity/Mental Illness,0,0,4,1,0,5,0,3,0,0,0,3,8
UTTARAKHAND,2013,Other Prolonged Illness,0,9,11,2,3,25,0,0,0,0,0,0,25
UTTARAKHAND,2013,Death of Dear Person,0,0,0,0,0,0,0,0,0,0,0,0,0
UTTARAKHAND,2013,Dowry Dispute,0,1,0,0,0,1,0,5,4,0,0,9,10
UTTARAKHAND,2013,Divorce,0,0,0,0,0,0,0,4,2,0,0,6,6
UTTARAKHAND,2013,Drug Abuse/Addiction,0,9,3,2,0,14,0,0,0,0,0,0,14
UTTARAKHAND,2013,Failure in Examination,2,9,12,2,0,25,0,7,5,1,0,13,38
UTTARAKHAND,2013,Fall in Social Reputation,0,0,0,0,0,0,0,0,0,0,0,0,0
UTTARAKHAND,2013,Family Problems,2,20,24,11,3,60,3,18,4,10,1,36,96
UTTARAKHAND,2013,Ideological Causes/Hero Worshipping,0,0,0,0,0,0,0,0,0,0,0,0,0
UTTARAKHAND,2013,Illegitimate Pregnancy,0,0,0,0,0,0,0,0,0,0,0,0,0
UTTARAKHAND,2013,Love Affairs,0,7,1,0,0,8,0,6,0,0,0,6,14
UTTARAKHAND,2013,"Physical Abuse (Rape,Incest Etc.)",0,0,0,0,0,0,0,0,1,0,0,1,1
UTTARAKHAND,2013,Poverty,0,4,1,3,0,8,0,0,0,0,0,0,8
UTTARAKHAND,2013,Professional/Career Problem,0,1,1,5,0,7,0,0,0,0,0,0,7
UTTARAKHAND,2013,Property Dispute,0,0,0,0,0,0,0,0,0,0,0,0,0
UTTARAKHAND,2013,Unemployment,0,8,5,1,0,14,0,0,0,0,0,0,14
UTTARAKHAND,2013,Causes Not known,0,16,19,8,4,47,3,9,18,1,1,32,79
UTTARAKHAND,2013,Other Causes (Please Specity),0,10,10,8,1,29,1,5,2,1,1,10,39
UTTARAKHAND,2013,Total,4,94,92,43,11,244,7,59,39,13,3,121,365
UTTARAKHAND,2013,Total Illness,0,9,15,3,3,30,0,3,0,0,0,3,33
WEST BENGAL,2013,Bankruptcy or Sudden change in Economic,0,0,7,4,0,11,0,0,1,1,0,2,13
WEST BENGAL,2013,Suspected/Illicit Relation,0,26,32,15,8,81,0,22,16,3,0,41,122
WEST BENGAL,2013,Cancellation/Non-Settlement of Marriage,0,55,25,0,0,80,0,24,15,7,6,52,132
WEST BENGAL,2013,Not having Children(Barrenness/Impotency,0,4,6,3,0,13,0,6,4,2,1,13,26
WEST BENGAL,2013,Illness (Aids/STD),0,3,0,5,4,12,0,1,2,0,1,4,16
WEST BENGAL,2013,Cancer,0,2,11,8,13,34,0,3,9,7,6,25,59
WEST BENGAL,2013,Paralysis,0,1,1,8,9,19,0,10,10,7,3,30,49
WEST BENGAL,2013,Insanity/Mental Illness,1,111,135,172,41,460,9,106,125,119,19,378,838
WEST BENGAL,2013,Other Prolonged Illness,1,20,83,61,43,208,3,32,51,43,31,160,368
WEST BENGAL,2013,Death of Dear Person,0,3,2,5,2,12,0,3,1,1,1,6,18
WEST BENGAL,2013,Dowry Dispute,0,0,0,3,0,3,0,318,192,32,2,544,547
WEST BENGAL,2013,Divorce,0,5,5,6,0,16,0,16,24,12,0,52,68
WEST BENGAL,2013,Drug Abuse/Addiction,0,12,13,17,12,54,0,0,0,0,0,0,54
WEST BENGAL,2013,Failure in Examination,13,108,3,0,0,124,9,89,4,0,0,102,226
WEST BENGAL,2013,Fall in Social Reputation,0,4,8,5,4,21,0,10,7,4,2,23,44
WEST BENGAL,2013,Family Problems,14,294,685,423,108,1524,15,325,416,192,52,1000,2524
WEST BENGAL,2013,Ideological Causes/Hero Worshipping,0,0,0,0,0,0,0,0,0,0,0,0,0
WEST BENGAL,2013,Illegitimate Pregnancy,0,0,0,0,0,0,0,10,2,1,0,13,13
WEST BENGAL,2013,Love Affairs,22,197,132,18,0,369,15,180,62,9,0,266,635
WEST BENGAL,2013,"Physical Abuse (Rape,Incest Etc.)",0,0,0,0,0,0,0,3,2,0,0,5,5
WEST BENGAL,2013,Poverty,0,0,0,0,0,0,0,0,0,0,0,0,0
WEST BENGAL,2013,Professional/Career Problem,0,14,13,8,0,35,0,12,9,0,0,21,56
WEST BENGAL,2013,Property Dispute,0,17,47,59,9,132,0,5,7,4,0,16,148
WEST BENGAL,2013,Unemployment,0,90,133,34,4,261,0,43,38,14,0,95,356
WEST BENGAL,2013,Causes Not known,72,553,683,498,80,1886,25,332,368,228,46,999,2885
WEST BENGAL,2013,Other Causes (Please Specity),61,771,923,600,150,2505,38,464,564,208,74,1348,3853
WEST BENGAL,2013,Total,184,2290,2947,1952,487,7860,114,2014,1929,894,244,5195,13055
