0,1,2,3,4,5,6,7,8,9,10,11,12,13,14,15
TOTAL (ALL INDIA),2013,By Over Alcoholism,1,272,619,456,205,1553,0,26,10,17,3,56,1609
TOTAL (ALL INDIA),2013,By Drowning,244,1490,1737,1028,442,4941,160,1073,763,434,275,2705,7646
TOTAL (ALL INDIA),2013,By Fire/Self Immolation,60,1081,1466,770,295,3672,143,2882,1981,811,475,6292,9964
TOTAL (ALL INDIA),2013,By Fire-Arms,4,112,150,71,13,350,2,81,52,17,8,160,510
TOTAL (ALL INDIA),2013,By Hanging,415,12172,13862,8489,3031,37969,391,7847,4528,2111,790,15667,53636
TOTAL (ALL INDIA),2013,By Consuming Insecticides,81,3806,4434,3283,1358,12962,122,2919,1926,990,539,6496,19458
TOTAL (ALL INDIA),2013,By Consuming Other Poison,129,3226,4359,3145,1238,12097,164,2539,2014,951,402,6070,18167
TOTAL (ALL INDIA),2013,By Self Infliction of injury,5,99,131,107,36,378,4,81,54,24,14,177,555
TOTAL (ALL INDIA),2013,By Jumping from (Building),16,120,175,132,55,498,8,56,39,29,16,148,646
TOTAL (ALL INDIA),2013,By Jumping from (Other sites),20,143,166,130,27,486,17,87,57,12,14,187,673
TOTAL (ALL INDIA),2013,By Jumping off Moving Vehicles/Trains,2,186,193,100,26,507,0,66,46,15,3,130,637
TOTAL (ALL INDIA),2013,By Machine,1,23,37,17,3,81,1,9,6,4,1,21,102
TOTAL (ALL INDIA),2013,By Overdose of sleeping pills,3,82,109,85,31,310,0,95,69,31,21,216,526
TOTAL (ALL INDIA),2013,By touching electric wires,31,242,284,176,37,770,16,60,62,33,11,182,952
TOTAL (ALL INDIA),2013,By coming under running vehicles/trains,42,1122,1240,1017,441,3862,30,323,244,175,104,876,4738
TOTAL (ALL INDIA),2013,By Other means (please specify),492,2540,3137,2819,1119,10107,287,1508,1656,1006,416,4873,14980
TOTAL (ALL INDIA),2013,Total,1546,26716,32099,21825,8357,90543,1345,19652,13507,6660,3092,44256,134799
TOTAL (ALL INDIA),2013,Total (Poison),215,7131,8924,6535,2632,25437,290,5539,3994,1965,955,12743,38180
TOTAL (ALL INDIA),2013,Total (Jumping),36,263,341,262,82,984,25,143,96,41,30,335,1319
TOTAL (STATES),2013,By Over Alcoholism,1,267,614,455,205,1542,0,25,9,17,3,54,1596
TOTAL (STATES),2013,By Drowning,244,1476,1715,1014,440,4889,160,1065,761,433,275,2694,7583
TOTAL (STATES),2013,By Fire/Self Immolation,58,1075,1454,762,290,3639,142,2853,1966,806,473,6240,9879
TOTAL (STATES),2013,By Fire-Arms,4,109,142,66,13,334,2,80,51,17,8,158,492
TOTAL (STATES),2013,By Hanging,396,11560,13322,8194,2935,36407,369,7442,4363,2076,762,15012,51419
TOTAL (STATES),2013,By Consuming Insecticides,81,3780,4405,3263,1355,12884,122,2899,1917,986,539,6463,19347
TOTAL (STATES),2013,By Consuming Other Poison,128,3168,4311,3112,1220,11939,158,2482,1992,941,400,5973,17912
TOTAL (STATES),2013,By Self Infliction of injury,5,96,131,106,35,373,4,81,54,24,14,177,550
TOTAL (STATES),2013,By Jumping from (Building),15,113,170,127,53,478,8,53,38,29,15,143,621
TOTAL (STATES),2013,By Jumping from (Other sites),20,140,166,128,27,481,17,87,56,12,14,186,667
TOTAL (STATES),2013,By Jumping off Moving Vehicles/Trains,2,186,193,100,26,507,0,66,46,15,3,130,637
TOTAL (STATES),2013,By Machine,1,22,36,16,3,78,1,5,6,3,0,15,93
TOTAL (STATES),2013,By Overdose of sleeping pills,3,82,109,82,29,305,0,92,68,31,21,212,517
TOTAL (STATES),2013,By touching electric wires,30,241,283,175,37,766,16,60,62,33,11,182,948
TOTAL (STATES),2013,By coming under running vehicles/trains,42,1119,1234,1013,439,3847,30,321,244,174,104,873,4720
TOTAL (STATES),2013,By Other means (please specify),488,2515,3111,2805,1091,10010,287,1485,1650,1001,416,4839,14849
TOTAL (STATES),2013,Total,1518,25949,31396,21418,8198,88479,1316,19096,13283,6598,3058,43351,131830
TOTAL (STATES),2013,Total (Poison),214,7044,8847,6481,2610,25196,284,5462,3963,1951,953,12613,37809
TOTAL (STATES),2013,Total (Jumping),35,253,336,255,80,959,25,140,94,41,29,329,1288
TOTAL (UTs),2013,By Over Alcoholism,0,5,5,1,0,11,0,1,1,0,0,2,13
TOTAL (UTs),2013,By Drowning,0,14,22,14,2,52,0,8,2,1,0,11,63
TOTAL (UTs),2013,By Fire/Self Immolation,2,6,12,8,5,33,1,29,15,5,2,52,85
TOTAL (UTs),2013,By Fire-Arms,0,3,8,5,0,16,0,1,1,0,0,2,18
TOTAL (UTs),2013,By Hanging,19,612,540,295,96,1562,22,405,165,35,28,655,2217
TOTAL (UTs),2013,By Consuming Insecticides,0,26,29,20,3,78,0,20,9,4,0,33,111
TOTAL (UTs),2013,By Consuming Other Poison,1,58,48,33,18,158,6,57,22,10,2,97,255
TOTAL (UTs),2013,By Self Infliction of injury,0,3,0,1,1,5,0,0,0,0,0,0,5
TOTAL (UTs),2013,By Jumping from (Building),1,7,5,5,2,20,0,3,1,0,1,5,25
TOTAL (UTs),2013,By Jumping from (Other sites),0,3,0,2,0,5,0,0,1,0,0,1,6
TOTAL (UTs),2013,By Jumping off Moving Vehicles/Trains,0,0,0,0,0,0,0,0,0,0,0,0,0
TOTAL (UTs),2013,By Machine,0,1,1,1,0,3,0,4,0,1,1,6,9
TOTAL (UTs),2013,By Overdose of sleeping pills,0,0,0,3,2,5,0,3,1,0,0,4,9
TOTAL (UTs),2013,By touching electric wires,1,1,1,1,0,4,0,0,0,0,0,0,4
TOTAL (UTs),2013,By coming under running vehicles/trains,0,3,6,4,2,15,0,2,0,1,0,3,18
TOTAL (UTs),2013,By Other means (please specify),4,25,26,14,28,97,0,23,6,5,0,34,131
TOTAL (UTs),2013,Total,28,767,703,407,159,2064,29,556,224,62,34,905,2969
TOTAL (UTs),2013,Total (Poison),1,87,77,54,22,241,6,77,31,14,2,130,371
TOTAL (UTs),2013,Total (Jumping),1,10,5,7,2,25,0,3,2,0,1,6,31
ANDHRA PRADESH,2013,By Over Alcoholism,0,38,86,31,21,176,0,3,1,1,0,5,181
ANDHRA PRADESH,2013,By Drowning,12,162,189,91,63,517,15,171,123,68,34,411,928
ANDHRA PRADESH,2013,By Fire/Self Immolation,4,171,182,91,32,480,6,284,232,78,45,645,1125
ANDHRA PRADESH,2013,By Fire-Arms,0,7,15,6,2,30,0,20,11,10,5,46,76
ANDHRA PRADESH,2013,By Hanging,12,814,1052,511,168,2557,20,530,336,161,45,1092,3649
ANDHRA PRADESH,2013,By Consuming Insecticides,9,806,970,785,265,2835,11,487,334,216,171,1219,4054
ANDHRA PRADESH,2013,By Consuming Other Poison,9,331,459,301,157,1257,16,217,197,103,61,594,1851
ANDHRA PRADESH,2013,By Self Infliction of injury,0,34,46,26,7,113,0,27,27,14,4,72,185
ANDHRA PRADESH,2013,By Jumping from (Building),0,19,32,15,1,67,0,7,3,3,1,14,81
ANDHRA PRADESH,2013,By Jumping from (Other sites),0,4,12,6,1,23,0,0,1,0,1,2,25
ANDHRA PRADESH,2013,By Jumping off Moving Vehicles/Trains,0,4,4,8,0,16,0,4,2,0,0,6,22
ANDHRA PRADESH,2013,By Machine,0,2,4,1,0,7,0,0,1,0,0,1,8
ANDHRA PRADESH,2013,By Overdose of sleeping pills,2,20,15,11,5,53,0,24,15,5,7,51,104
ANDHRA PRADESH,2013,By touching electric wires,1,18,14,10,2,45,0,2,6,3,1,12,57
ANDHRA PRADESH,2013,By coming under running vehicles/trains,9,250,347,302,107,1015,1,51,28,25,17,122,1137
ANDHRA PRADESH,2013,By Other means (please specify),10,167,221,244,69,711,12,96,183,87,35,413,1124
ANDHRA PRADESH,2013,Total,68,2847,3648,2439,900,9902,81,1923,1500,774,427,4705,14607
ANDHRA PRADESH,2013,Total (Poison),18,1171,1475,1112,429,4205,27,731,558,333,236,1885,6090
ANDHRA PRADESH,2013,Total (Jumping),0,23,44,21,2,90,0,7,4,3,2,16,106
ARUNACHAL PRADESH,2013,By Over Alcoholism,0,0,5,4,1,10,0,0,0,0,0,0,10
ARUNACHAL PRADESH,2013,By Drowning,0,4,3,1,1,9,0,2,1,0,1,4,13
ARUNACHAL PRADESH,2013,By Fire/Self Immolation,0,0,0,0,0,0,0,1,0,0,0,1,1
ARUNACHAL PRADESH,2013,By Fire-Arms,0,1,0,0,0,1,0,0,0,0,0,0,1
ARUNACHAL PRADESH,2013,By Hanging,3,35,34,18,4,94,3,24,16,2,0,45,139
ARUNACHAL PRADESH,2013,By Consuming Insecticides,0,0,0,0,0,0,0,0,0,0,0,0,0
ARUNACHAL PRADESH,2013,By Consuming Other Poison,0,2,4,0,0,6,0,0,1,0,0,1,7
ARUNACHAL PRADESH,2013,By Self Infliction of injury,0,0,1,0,0,1,0,0,0,0,0,0,1
ARUNACHAL PRADESH,2013,By Jumping from (Building),0,1,0,0,0,1,0,0,0,0,0,0,1
ARUNACHAL PRADESH,2013,By Jumping from (Other sites),0,0,1,0,0,1,0,0,0,0,0,0,1
ARUNACHAL PRADESH,2013,By Jumping off Moving Vehicles/Trains,0,0,0,0,0,0,0,0,0,0,0,0,0
ARUNACHAL PRADESH,2013,By Machine,0,0,0,0,0,0,0,0,0,0,0,0,0
ARUNACHAL PRADESH,2013,By Overdose of sleeping pills,0,0,0,0,0,0,0,0,0,0,0,0,0
ARUNACHAL PRADESH,2013,By touching electric wires,0,1,0,0,0,1,0,0,0,0,0,0,1
ARUNACHAL PRADESH,2013,By coming under running vehicles/trains,0,0,0,1,0,1,0,0,0,0,0,0,1
ARUNACHAL PRADESH,2013,By Other means (please specify),4,12,17,9,4,46,1,4,1,1,0,7,53
ARUNACHAL PRADESH,2013,Total,7,56,65,33,10,171,4,31,19,3,1,58,229
ARUNACHAL PRADESH,2013,Total (Poison),0,2,5,0,0,7,0,0,1,0,0,1,8
ARUNACHAL PRADESH,2013,Total (Jumping),0,1,1,0,0,2,0,0,0,0,0,0,2
ASSAM,2013,By Over Alcoholism,0,0,2,0,0,2,0,0,0,0,0,0,2
ASSAM,2013,By Drowning,0,124,144,65,3,336,3,49,35,15,0,102,438
ASSAM,2013,By Fire/Self Immolation,0,2,2,1,1,6,0,15,30,5,0,50,56
ASSAM,2013,By Fire-Arms,0,0,1,1,0,2,0,0,0,0,0,0,2
ASSAM,2013,By Hanging,8,505,686,394,16,1609,3,268,247,126,6,650,2259
ASSAM,2013,By Consuming Insecticides,0,0,0,0,0,0,0,0,2,1,0,3,3
ASSAM,2013,By Consuming Other Poison,1,67,88,39,2,197,0,41,40,20,1,102,299
ASSAM,2013,By Self Infliction of injury,0,3,2,3,0,8,0,0,0,0,0,0,8
ASSAM,2013,By Jumping from (Building),0,3,1,1,0,5,0,1,0,1,0,2,7
ASSAM,2013,By Jumping from (Other sites),0,7,2,3,0,12,0,1,2,0,0,3,15
ASSAM,2013,By Jumping off Moving Vehicles/Trains,0,16,22,9,0,47,0,2,2,0,0,4,51
ASSAM,2013,By Machine,0,0,3,0,0,3,0,0,0,0,0,0,3
ASSAM,2013,By Overdose of sleeping pills,0,0,3,0,0,3,0,0,0,0,0,0,3
ASSAM,2013,By touching electric wires,0,12,27,13,0,52,0,0,1,0,0,1,53
ASSAM,2013,By coming under running vehicles/trains,0,22,22,9,2,55,0,7,3,0,2,12,67
ASSAM,2013,By Other means (please specify),2,62,85,66,6,221,1,15,31,15,4,66,287
ASSAM,2013,Total,11,823,1090,604,30,2558,7,399,393,183,13,995,3553
ASSAM,2013,Total (Poison),1,70,90,42,2,205,0,41,42,21,1,105,310
ASSAM,2013,Total (Jumping),0,10,3,4,0,17,0,2,2,1,0,5,22
BIHAR,2013,By Over Alcoholism,0,2,14,8,2,26,0,0,0,0,0,0,26
BIHAR,2013,By Drowning,8,37,38,12,4,99,20,15,6,4,0,45,144
BIHAR,2013,By Fire/Self Immolation,2,10,13,7,1,33,3,40,20,6,0,69,102
BIHAR,2013,By Fire-Arms,0,4,6,2,0,12,0,4,2,1,0,7,19
BIHAR,2013,By Hanging,2,38,39,13,2,94,2,39,21,4,0,66,160
BIHAR,2013,By Consuming Insecticides,2,23,17,17,4,63,3,35,16,1,0,55,118
BIHAR,2013,By Consuming Other Poison,0,11,22,16,1,50,7,10,10,0,1,28,78
BIHAR,2013,By Self Infliction of injury,0,0,0,1,1,2,0,0,0,0,0,0,2
BIHAR,2013,By Jumping from (Building),0,0,0,0,0,0,2,3,1,0,0,6,6
BIHAR,2013,By Jumping from (Other sites),0,3,3,6,0,12,2,5,3,1,0,11,23
BIHAR,2013,By Jumping off Moving Vehicles/Trains,0,0,2,0,0,2,0,0,0,0,0,0,2
BIHAR,2013,By Machine,0,2,1,0,0,3,0,0,0,0,0,0,3
BIHAR,2013,By Overdose of sleeping pills,0,2,3,1,2,8,0,2,2,0,0,4,12
BIHAR,2013,By touching electric wires,0,12,12,7,0,31,4,4,3,1,0,12,43
BIHAR,2013,By coming under running vehicles/trains,0,1,0,0,0,1,0,0,0,0,0,0,1
BIHAR,2013,By Other means (please specify),12,31,83,36,32,194,4,24,76,14,6,124,318
BIHAR,2013,Total,26,176,253,126,49,630,47,181,160,32,7,427,1057
BIHAR,2013,Total (Poison),2,34,39,34,6,115,10,45,26,1,1,83,198
BIHAR,2013,Total (Jumping),0,3,3,6,0,12,4,8,4,1,0,17,29
CHHATTISGARH,2013,By Over Alcoholism,0,9,13,9,2,33,0,3,1,5,0,9,42
CHHATTISGARH,2013,By Drowning,7,23,29,9,3,71,12,6,4,2,3,27,98
CHHATTISGARH,2013,By Fire/Self Immolation,4,43,49,18,9,123,10,168,88,23,22,311,434
CHHATTISGARH,2013,By Fire-Arms,0,0,4,0,0,4,0,0,0,0,0,0,4
CHHATTISGARH,2013,By Hanging,36,714,659,399,158,1966,29,346,162,81,31,649,2615
CHHATTISGARH,2013,By Consuming Insecticides,5,169,162,94,34,464,16,139,61,50,27,293,757
CHHATTISGARH,2013,By Consuming Other Poison,2,152,139,58,39,390,10,94,67,27,9,207,597
CHHATTISGARH,2013,By Self Infliction of injury,0,1,0,0,0,1,0,0,0,0,0,0,1
CHHATTISGARH,2013,By Jumping from (Building),0,2,2,2,1,7,0,0,1,0,0,1,8
CHHATTISGARH,2013,By Jumping from (Other sites),0,1,1,1,1,4,0,1,0,0,0,1,5
CHHATTISGARH,2013,By Jumping off Moving Vehicles/Trains,0,2,0,0,0,2,0,0,0,0,0,0,2
CHHATTISGARH,2013,By Machine,0,1,0,0,0,1,0,1,0,1,0,2,3
CHHATTISGARH,2013,By Overdose of sleeping pills,0,0,0,0,1,1,0,0,0,0,0,0,1
CHHATTISGARH,2013,By touching electric wires,1,3,4,0,0,8,0,0,1,1,0,2,10
CHHATTISGARH,2013,By coming under running vehicles/trains,2,50,46,23,1,122,3,13,8,5,1,30,152
CHHATTISGARH,2013,By Other means (please specify),25,131,169,84,42,451,12,94,66,55,29,256,707
CHHATTISGARH,2013,Total,82,1301,1277,697,291,3648,92,865,459,250,122,1788,5436
CHHATTISGARH,2013,Total (Poison),7,322,301,152,73,855,26,233,128,77,36,500,1355
CHHATTISGARH,2013,Total (Jumping),0,3,3,3,2,11,0,1,1,0,0,2,13
GOA,2013,By Over Alcoholism,0,0,0,0,0,0,0,0,0,0,0,0,0
GOA,2013,By Drowning,0,9,10,8,4,31,2,3,7,1,3,16,47
GOA,2013,By Fire/Self Immolation,0,0,1,1,2,4,0,2,2,2,1,7,11
GOA,2013,By Fire-Arms,0,0,0,0,0,0,0,0,1,0,0,1,1
GOA,2013,By Hanging,0,57,53,27,7,144,2,33,18,3,3,59,203
GOA,2013,By Consuming Insecticides,0,5,3,2,1,11,0,4,1,0,0,5,16
GOA,2013,By Consuming Other Poison,0,5,7,6,2,20,0,1,1,1,0,3,23
GOA,2013,By Self Infliction of injury,0,0,0,0,0,0,0,0,0,0,0,0,0
GOA,2013,By Jumping from (Building),0,0,1,1,0,2,0,0,0,0,0,0,2
GOA,2013,By Jumping from (Other sites),0,2,1,0,0,3,1,3,0,0,0,4,7
GOA,2013,By Jumping off Moving Vehicles/Trains,0,0,0,0,0,0,0,0,0,0,0,0,0
GOA,2013,By Machine,0,0,0,0,0,0,0,0,0,0,0,0,0
GOA,2013,By Overdose of sleeping pills,0,0,0,0,1,1,0,0,0,0,0,0,1
GOA,2013,By touching electric wires,0,0,0,0,0,0,0,0,0,0,0,0,0
GOA,2013,By coming under running vehicles/trains,0,3,2,0,0,5,0,0,0,0,0,0,5
GOA,2013,By Other means (please specify),0,1,2,3,3,9,0,0,2,0,1,3,12
GOA,2013,Total,0,82,80,48,20,230,5,46,32,7,8,98,328
GOA,2013,Total (Poison),0,10,10,8,3,31,0,5,2,1,0,8,39
GOA,2013,Total (Jumping),0,2,2,1,0,5,1,3,0,0,0,4,9
GUJARAT,2013,By Over Alcoholism,0,0,6,0,0,6,0,1,0,0,0,1,7
GUJARAT,2013,By Drowning,14,109,127,68,18,336,1,55,49,15,11,131,467
GUJARAT,2013,By Fire/Self Immolation,4,89,134,72,30,329,7,213,171,88,69,548,877
GUJARAT,2013,By Fire-Arms,0,1,4,3,0,8,0,2,0,0,0,2,10
GUJARAT,2013,By Hanging,10,619,552,305,96,1582,12,444,187,99,38,780,2362
GUJARAT,2013,By Consuming Insecticides,3,394,454,273,106,1230,10,334,208,116,41,709,1939
GUJARAT,2013,By Consuming Other Poison,1,132,145,103,24,405,4,113,75,39,19,250,655
GUJARAT,2013,By Self Infliction of injury,0,5,8,8,2,23,1,5,2,0,1,9,32
GUJARAT,2013,By Jumping from (Building),1,11,14,11,4,41,0,2,5,1,2,10,51
GUJARAT,2013,By Jumping from (Other sites),1,12,39,15,4,71,0,13,13,0,3,29,100
GUJARAT,2013,By Jumping off Moving Vehicles/Trains,0,9,7,8,0,24,0,5,2,1,1,9,33
GUJARAT,2013,By Machine,0,0,1,1,0,2,0,0,0,0,0,0,2
GUJARAT,2013,By Overdose of sleeping pills,0,5,6,4,1,16,0,3,2,0,0,5,21
GUJARAT,2013,By touching electric wires,0,2,7,2,0,11,1,3,2,0,0,6,17
GUJARAT,2013,By coming under running vehicles/trains,6,76,108,75,23,288,3,24,13,15,0,55,343
GUJARAT,2013,By Other means (please specify),5,31,51,59,14,160,1,40,27,15,7,90,250
GUJARAT,2013,Total,45,1495,1663,1007,322,4532,40,1257,756,389,192,2634,7166
GUJARAT,2013,Total (Poison),4,531,607,384,132,1658,15,452,285,155,61,968,2626
GUJARAT,2013,Total (Jumping),2,23,53,26,8,112,0,15,18,1,5,39,151
HARYANA,2013,By Over Alcoholism,0,16,29,20,3,68,0,0,0,0,0,0,68
HARYANA,2013,By Drowning,16,64,71,43,11,205,6,18,11,2,3,40,245
HARYANA,2013,By Fire/Self Immolation,3,29,20,16,2,70,3,48,37,12,3,103,173
HARYANA,2013,By Fire-Arms,0,2,1,3,0,6,0,0,0,0,0,0,6
HARYANA,2013,By Hanging,6,239,187,84,8,524,4,127,52,21,8,212,736
HARYANA,2013,By Consuming Insecticides,4,90,147,89,16,346,1,84,45,20,1,151,497
HARYANA,2013,By Consuming Other Poison,1,109,94,35,12,251,2,61,32,15,3,113,364
HARYANA,2013,By Self Infliction of injury,0,2,1,0,0,3,0,0,0,0,0,0,3
HARYANA,2013,By Jumping from (Building),0,4,8,3,0,15,1,1,1,0,0,3,18
HARYANA,2013,By Jumping from (Other sites),0,7,11,8,1,27,0,2,1,0,1,4,31
HARYANA,2013,By Jumping off Moving Vehicles/Trains,0,0,0,0,0,0,0,0,0,0,0,0,0
HARYANA,2013,By Machine,0,2,4,2,1,9,0,0,1,0,0,1,10
HARYANA,2013,By Overdose of sleeping pills,0,1,1,0,0,2,0,0,0,0,0,0,2
HARYANA,2013,By touching electric wires,2,41,31,19,2,95,1,2,2,1,0,6,101
HARYANA,2013,By coming under running vehicles/trains,10,60,137,145,63,415,8,25,17,13,10,73,488
HARYANA,2013,By Other means (please specify),16,105,129,160,56,466,17,43,19,17,12,108,574
HARYANA,2013,Total,58,771,871,627,175,2502,43,411,218,101,41,814,3316
HARYANA,2013,Total (Poison),5,201,242,124,28,600,3,145,77,35,4,264,864
HARYANA,2013,Total (Jumping),0,11,19,11,1,42,1,3,2,0,1,7,49
HIMACHAL PRADESH,2013,By Over Alcoholism,0,1,4,6,2,13,0,0,1,0,0,1,14
HIMACHAL PRADESH,2013,By Drowning,0,6,4,1,0,11,0,5,4,1,1,11,22
HIMACHAL PRADESH,2013,By Fire/Self Immolation,0,0,2,1,0,3,0,4,4,2,0,10,13
HIMACHAL PRADESH,2013,By Fire-Arms,0,1,0,0,0,1,0,0,0,0,0,0,1
HIMACHAL PRADESH,2013,By Hanging,2,56,52,18,5,133,0,27,14,5,0,46,179
HIMACHAL PRADESH,2013,By Consuming Insecticides,0,24,26,25,6,81,3,16,15,11,6,51,132
HIMACHAL PRADESH,2013,By Consuming Other Poison,1,46,25,14,8,94,1,33,11,10,3,58,152
HIMACHAL PRADESH,2013,By Self Infliction of injury,0,0,0,0,0,0,0,0,0,0,0,0,0
HIMACHAL PRADESH,2013,By Jumping from (Building),0,0,0,0,0,0,0,0,0,0,0,0,0
HIMACHAL PRADESH,2013,By Jumping from (Other sites),1,1,1,1,0,4,0,0,1,0,0,1,5
HIMACHAL PRADESH,2013,By Jumping off Moving Vehicles/Trains,0,2,0,0,0,2,0,0,0,0,0,0,2
HIMACHAL PRADESH,2013,By Machine,0,0,2,0,0,2,0,2,0,0,0,2,4
HIMACHAL PRADESH,2013,By Overdose of sleeping pills,0,0,0,0,0,0,0,0,0,0,0,0,0
HIMACHAL PRADESH,2013,By touching electric wires,0,1,2,0,0,3,0,0,0,0,0,0,3
HIMACHAL PRADESH,2013,By coming under running vehicles/trains,0,0,0,0,0,0,0,0,0,0,0,0,0
HIMACHAL PRADESH,2013,By Other means (please specify),1,4,4,5,3,17,2,3,3,2,0,10,27
HIMACHAL PRADESH,2013,Total,5,142,122,71,24,364,6,90,53,31,10,190,554
HIMACHAL PRADESH,2013,Total (Poison),1,70,51,39,14,175,4,49,26,21,9,109,284
HIMACHAL PRADESH,2013,Total (Jumping),1,1,1,1,0,4,0,0,1,0,0,1,5
JAMMU & KASHMIR,2013,By Over Alcoholism,0,1,2,2,2,7,0,0,0,0,0,0,7
JAMMU & KASHMIR,2013,By Drowning,0,2,0,0,1,3,0,0,5,0,1,6,9
JAMMU & KASHMIR,2013,By Fire/Self Immolation,0,2,4,0,0,6,0,6,4,1,0,11,17
JAMMU & KASHMIR,2013,By Fire-Arms,0,3,3,0,0,6,0,0,0,0,0,0,6
JAMMU & KASHMIR,2013,By Hanging,0,11,23,12,5,51,0,8,9,1,0,18,69
JAMMU & KASHMIR,2013,By Consuming Insecticides,0,9,6,5,0,20,0,11,15,1,2,29,49
JAMMU & KASHMIR,2013,By Consuming Other Poison,1,5,20,15,5,46,2,32,18,5,2,59,105
JAMMU & KASHMIR,2013,By Self Infliction of injury,0,0,0,0,0,0,0,0,0,0,0,0,0
JAMMU & KASHMIR,2013,By Jumping from (Building),0,0,1,2,3,6,0,0,0,0,0,0,6
JAMMU & KASHMIR,2013,By Jumping from (Other sites),0,1,1,3,0,5,0,0,1,0,0,1,6
JAMMU & KASHMIR,2013,By Jumping off Moving Vehicles/Trains,0,0,0,0,0,0,0,0,0,0,0,0,0
JAMMU & KASHMIR,2013,By Machine,0,0,0,0,0,0,0,0,0,0,0,0,0
JAMMU & KASHMIR,2013,By Overdose of sleeping pills,0,0,0,0,0,0,0,0,0,0,0,0,0
JAMMU & KASHMIR,2013,By touching electric wires,0,0,0,1,0,1,0,0,0,1,0,1,2
JAMMU & KASHMIR,2013,By coming under running vehicles/trains,0,1,0,3,0,4,0,0,0,0,0,0,4
JAMMU & KASHMIR,2013,By Other means (please specify),0,3,9,1,0,13,1,8,0,0,0,9,22
JAMMU & KASHMIR,2013,Total,1,38,69,44,16,168,3,65,52,9,5,134,302
JAMMU & KASHMIR,2013,Total (Poison),1,14,26,20,5,66,2,43,33,6,4,88,154
JAMMU & KASHMIR,2013,Total (Jumping),0,1,2,5,3,11,0,0,1,0,0,1,12
JHARKHAND,2013,By Over Alcoholism,0,7,13,19,10,49,0,3,0,3,0,6,55
JHARKHAND,2013,By Drowning,3,18,17,6,2,46,1,10,3,1,0,15,61
JHARKHAND,2013,By Fire/Self Immolation,2,7,9,9,0,27,0,17,17,6,1,41,68
JHARKHAND,2013,By Fire-Arms,0,1,1,0,1,3,0,0,1,0,1,2,5
JHARKHAND,2013,By Hanging,0,84,100,41,2,227,3,62,40,16,3,124,351
JHARKHAND,2013,By Consuming Insecticides,1,46,26,21,5,99,2,33,22,21,3,81,180
JHARKHAND,2013,By Consuming Other Poison,0,25,12,5,3,45,0,12,8,1,0,21,66
JHARKHAND,2013,By Self Infliction of injury,0,1,0,0,0,1,0,2,2,0,0,4,5
JHARKHAND,2013,By Jumping from (Building),0,5,0,0,0,5,0,3,3,0,0,6,11
JHARKHAND,2013,By Jumping from (Other sites),0,15,7,5,2,29,0,5,1,1,0,7,36
JHARKHAND,2013,By Jumping off Moving Vehicles/Trains,1,5,3,2,0,11,0,3,3,0,0,6,17
JHARKHAND,2013,By Machine,0,1,1,2,2,6,1,1,0,0,0,2,8
JHARKHAND,2013,By Overdose of sleeping pills,0,6,7,9,1,23,0,5,3,3,1,12,35
JHARKHAND,2013,By touching electric wires,2,10,7,2,4,25,0,3,1,2,0,6,31
JHARKHAND,2013,By coming under running vehicles/trains,0,8,2,1,2,13,0,2,0,1,1,4,17
JHARKHAND,2013,By Other means (please specify),41,79,90,127,38,375,15,45,47,25,7,139,514
JHARKHAND,2013,Total,50,318,295,249,72,984,22,206,151,80,17,476,1460
JHARKHAND,2013,Total (Poison),1,72,38,26,8,145,2,47,32,22,3,106,251
JHARKHAND,2013,Total (Jumping),0,20,7,5,2,34,0,8,4,1,0,13,47
KARNATAKA,2013,By Over Alcoholism,0,15,53,20,10,98,0,2,2,0,0,4,102
KARNATAKA,2013,By Drowning,9,134,170,150,27,490,11,101,67,52,33,264,754
KARNATAKA,2013,By Fire/Self Immolation,10,57,67,48,11,193,7,144,103,50,17,321,514
KARNATAKA,2013,By Fire-Arms,0,2,4,1,0,7,0,3,0,0,1,4,11
KARNATAKA,2013,By Hanging,35,907,1250,678,220,3090,33,630,379,218,68,1328,4418
KARNATAKA,2013,By Consuming Insecticides,1,89,194,118,55,457,0,78,84,20,21,203,660
KARNATAKA,2013,By Consuming Other Poison,16,462,715,446,174,1813,29,333,258,87,48,755,2568
KARNATAKA,2013,By Self Infliction of injury,0,0,1,0,0,1,0,2,0,1,1,4,5
KARNATAKA,2013,By Jumping from (Building),0,1,3,0,1,5,0,1,0,1,0,2,7
KARNATAKA,2013,By Jumping from (Other sites),0,4,5,0,0,9,0,2,2,0,0,4,13
KARNATAKA,2013,By Jumping off Moving Vehicles/Trains,0,6,10,3,0,19,0,0,0,0,0,0,19
KARNATAKA,2013,By Machine,0,0,1,0,0,1,0,0,0,0,0,0,1
KARNATAKA,2013,By Overdose of sleeping pills,0,0,3,1,0,4,0,4,2,2,0,8,12
KARNATAKA,2013,By touching electric wires,0,4,15,0,0,19,0,0,0,3,0,3,22
KARNATAKA,2013,By coming under running vehicles/trains,0,107,90,90,89,376,0,54,49,36,41,180,556
KARNATAKA,2013,By Other means (please specify),41,411,234,352,113,1151,33,117,147,105,51,453,1604
KARNATAKA,2013,Total,112,2199,2815,1907,700,7733,113,1471,1093,575,281,3533,11266
KARNATAKA,2013,Total (Poison),17,551,910,564,229,2271,29,413,342,108,70,962,3233
KARNATAKA,2013,Total (Jumping),0,5,8,0,1,14,0,3,2,1,0,6,20
KERALA,2013,By Over Alcoholism,0,9,19,32,28,88,0,0,0,0,0,0,88
KERALA,2013,By Drowning,2,48,64,68,75,257,3,30,39,53,66,191,448
KERALA,2013,By Fire/Self Immolation,0,13,27,27,12,79,2,69,54,50,56,231,310
KERALA,2013,By Fire-Arms,0,1,2,1,1,5,0,3,1,3,1,8,13
KERALA,2013,By Hanging,28,823,1519,1571,848,4789,28,333,263,220,202,1046,5835
KERALA,2013,By Consuming Insecticides,0,55,119,167,99,440,7,34,38,39,30,148,588
KERALA,2013,By Consuming Other Poison,7,115,235,241,169,767,3,35,72,76,52,238,1005
KERALA,2013,By Self Infliction of injury,0,5,6,4,6,21,0,1,0,1,4,6,27
KERALA,2013,By Jumping from (Building),0,2,5,4,2,13,0,2,0,2,1,5,18
KERALA,2013,By Jumping from (Other sites),1,2,1,2,1,7,0,0,3,1,1,5,12
KERALA,2013,By Jumping off Moving Vehicles/Trains,0,8,15,3,5,31,0,0,2,1,0,3,34
KERALA,2013,By Machine,0,0,0,1,0,1,0,0,0,0,0,0,1
KERALA,2013,By Overdose of sleeping pills,0,5,16,13,1,35,0,7,8,7,4,26,61
KERALA,2013,By touching electric wires,0,0,1,4,1,6,0,0,0,0,2,2,8
KERALA,2013,By coming under running vehicles/trains,0,38,42,52,24,156,0,8,10,8,3,29,185
KERALA,2013,By Other means (please specify),0,0,2,2,2,6,0,2,1,2,2,7,13
KERALA,2013,Total,38,1124,2073,2192,1274,6701,43,524,491,463,424,1945,8646
KERALA,2013,Total (Poison),7,175,360,412,274,1228,10,70,110,116,86,392,1620
KERALA,2013,Total (Jumping),1,4,6,6,3,20,0,2,3,3,2,10,30
MADHYA PRADESH,2013,By Over Alcoholism,0,21,69,51,17,158,0,1,1,2,3,7,165
MADHYA PRADESH,2013,By Drowning,59,99,103,51,22,334,26,121,58,18,11,234,568
MADHYA PRADESH,2013,By Fire/Self Immolation,5,88,126,38,22,279,33,444,229,63,28,797,1076
MADHYA PRADESH,2013,By Fire-Arms,2,15,22,9,3,51,2,9,1,0,0,12,63
MADHYA PRADESH,2013,By Hanging,56,1131,905,528,225,2845,47,811,349,136,50,1393,4238
MADHYA PRADESH,2013,By Consuming Insecticides,14,417,310,176,100,1017,22,416,240,92,45,815,1832
MADHYA PRADESH,2013,By Consuming Other Poison,9,150,173,94,50,476,5,167,93,38,21,324,800
MADHYA PRADESH,2013,By Self Infliction of injury,0,4,6,3,4,17,1,5,1,2,1,10,27
MADHYA PRADESH,2013,By Jumping from (Building),3,4,8,4,6,25,0,3,1,0,0,4,29
MADHYA PRADESH,2013,By Jumping from (Other sites),7,9,3,20,2,41,8,15,1,0,0,24,65
MADHYA PRADESH,2013,By Jumping off Moving Vehicles/Trains,0,15,12,6,0,33,0,3,1,3,0,7,40
MADHYA PRADESH,2013,By Machine,1,0,0,0,0,1,0,0,0,0,0,0,1
MADHYA PRADESH,2013,By Overdose of sleeping pills,0,5,7,9,3,24,0,4,3,3,0,10,34
MADHYA PRADESH,2013,By touching electric wires,13,17,18,13,10,71,4,2,5,3,2,16,87
MADHYA PRADESH,2013,By coming under running vehicles/trains,4,47,24,24,8,107,3,18,5,6,1,33,140
MADHYA PRADESH,2013,By Other means (please specify),18,41,48,56,28,191,7,29,23,15,16,90,281
MADHYA PRADESH,2013,Total,191,2063,1834,1082,500,5670,158,2048,1011,381,178,3776,9446
MADHYA PRADESH,2013,Total (Poison),23,571,489,273,154,1510,28,588,334,132,67,1149,2659
MADHYA PRADESH,2013,Total (Jumping),10,13,11,24,8,66,8,18,2,0,0,28,94
MAHARASHTRA,2013,By Over Alcoholism,0,48,87,52,16,203,0,0,0,1,0,1,204
MAHARASHTRA,2013,By Drowning,9,190,270,152,88,709,8,216,133,82,71,510,1219
MAHARASHTRA,2013,By Fire/Self Immolation,1,150,267,155,69,642,7,437,304,115,81,944,1586
MAHARASHTRA,2013,By Fire-Arms,0,7,9,5,0,21,0,1,0,0,0,1,22
MAHARASHTRA,2013,By Hanging,60,2074,2288,1313,523,6258,58,1043,492,173,77,1843,8101
MAHARASHTRA,2013,By Consuming Insecticides,12,759,994,697,355,2817,13,465,250,107,74,909,3726
MAHARASHTRA,2013,By Consuming Other Poison,7,210,335,255,71,878,19,177,132,40,18,386,1264
MAHARASHTRA,2013,By Self Infliction of injury,0,9,7,4,1,21,0,3,1,2,0,6,27
MAHARASHTRA,2013,By Jumping from (Building),1,18,21,20,11,71,0,12,9,5,6,32,103
MAHARASHTRA,2013,By Jumping from (Other sites),0,2,6,3,3,14,0,2,1,0,1,4,18
MAHARASHTRA,2013,By Jumping off Moving Vehicles/Trains,0,18,16,13,9,56,0,3,6,0,1,10,66
MAHARASHTRA,2013,By Machine,0,0,0,0,0,0,0,0,0,0,0,0,0
MAHARASHTRA,2013,By Overdose of sleeping pills,0,2,3,1,4,10,0,8,9,2,0,19,29
MAHARASHTRA,2013,By touching electric wires,0,3,2,13,0,18,0,1,0,3,0,4,22
MAHARASHTRA,2013,By coming under running vehicles/trains,0,68,58,26,13,165,1,15,12,6,2,36,201
MAHARASHTRA,2013,By Other means (please specify),1,3,4,1,0,9,0,2,14,8,1,25,34
MAHARASHTRA,2013,Total,91,3561,4367,2710,1163,11892,106,2385,1363,544,332,4730,16622
MAHARASHTRA,2013,Total (Poison),19,978,1336,956,427,3716,32,645,383,149,92,1301,5017
MAHARASHTRA,2013,Total (Jumping),1,20,27,23,14,85,0,14,10,5,7,36,121
MANIPUR,2013,By Over Alcoholism,0,0,0,0,0,0,0,0,0,0,0,0,0
MANIPUR,2013,By Drowning,0,0,0,0,0,0,0,0,0,0,0,0,0
MANIPUR,2013,By Fire/Self Immolation,0,0,0,0,0,0,0,0,0,0,0,0,0
MANIPUR,2013,By Fire-Arms,0,1,3,1,0,5,0,1,0,0,0,1,6
MANIPUR,2013,By Hanging,0,6,7,1,1,15,2,5,1,1,0,9,24
MANIPUR,2013,By Consuming Insecticides,0,0,0,0,0,0,0,2,0,0,0,2,2
MANIPUR,2013,By Consuming Other Poison,1,0,0,0,0,1,0,2,1,0,0,3,4
MANIPUR,2013,By Self Infliction of injury,0,0,0,1,0,1,0,0,0,0,0,0,1
MANIPUR,2013,By Jumping from (Building),0,0,0,0,0,0,0,0,0,0,0,0,0
MANIPUR,2013,By Jumping from (Other sites),0,0,0,0,0,0,0,0,0,0,0,0,0
MANIPUR,2013,By Jumping off Moving Vehicles/Trains,0,0,0,0,0,0,0,0,0,0,0,0,0
MANIPUR,2013,By Machine,0,0,0,0,0,0,0,0,0,0,0,0,0
MANIPUR,2013,By Overdose of sleeping pills,0,0,0,0,0,0,0,0,0,0,0,0,0
MANIPUR,2013,By touching electric wires,0,0,0,0,0,0,0,0,0,0,0,0,0
MANIPUR,2013,By coming under running vehicles/trains,0,0,0,0,0,0,0,0,0,0,0,0,0
MANIPUR,2013,By Other means (please specify),0,0,0,0,0,0,0,0,0,0,0,0,0
MANIPUR,2013,Total,1,7,10,3,1,22,2,10,2,1,0,15,37
MANIPUR,2013,Total (Poison),1,0,0,1,0,2,0,4,1,0,0,5,7
MANIPUR,2013,Total (Jumping),0,0,0,0,0,0,0,0,0,0,0,0,0
MEGHALAYA,2013,By Over Alcoholism,0,0,0,0,0,0,0,0,0,0,0,0,0
MEGHALAYA,2013,By Drowning,0,0,2,0,1,3,0,2,0,0,0,2,5
MEGHALAYA,2013,By Fire/Self Immolation,0,4,2,0,0,6,0,2,3,1,0,6,12
MEGHALAYA,2013,By Fire-Arms,0,0,0,0,0,0,0,0,0,0,0,0,0
MEGHALAYA,2013,By Hanging,3,45,21,10,2,81,6,19,6,1,0,32,113
MEGHALAYA,2013,By Consuming Insecticides,0,0,0,0,0,0,0,0,0,0,0,0,0
MEGHALAYA,2013,By Consuming Other Poison,0,2,1,0,0,3,0,1,0,0,0,1,4
MEGHALAYA,2013,By Self Infliction of injury,0,0,1,0,0,1,0,0,0,0,0,0,1
MEGHALAYA,2013,By Jumping from (Building),0,0,1,0,0,1,0,0,0,0,0,0,1
MEGHALAYA,2013,By Jumping from (Other sites),0,0,0,0,0,0,0,0,0,0,0,0,0
MEGHALAYA,2013,By Jumping off Moving Vehicles/Trains,0,0,0,0,0,0,0,0,0,0,0,0,0
MEGHALAYA,2013,By Machine,0,0,0,0,0,0,0,0,0,0,0,0,0
MEGHALAYA,2013,By Overdose of sleeping pills,0,0,0,0,0,0,0,0,0,0,0,0,0
MEGHALAYA,2013,By touching electric wires,0,0,0,0,0,0,0,0,0,0,0,0,0
MEGHALAYA,2013,By coming under running vehicles/trains,0,0,0,0,0,0,0,0,0,0,0,0,0
MEGHALAYA,2013,By Other means (please specify),0,0,0,1,0,1,0,0,0,0,0,0,1
MEGHALAYA,2013,Total,3,51,28,11,3,96,6,24,9,2,0,41,137
MEGHALAYA,2013,Total (Poison),0,2,2,0,0,4,0,1,0,0,0,1,5
MEGHALAYA,2013,Total (Jumping),0,0,1,0,0,1,0,0,0,0,0,0,1
MIZORAM,2013,By Over Alcoholism,0,1,0,0,0,1,0,0,0,1,0,1,2
MIZORAM,2013,By Drowning,1,5,0,0,0,6,0,0,1,1,0,2,8
MIZORAM,2013,By Fire/Self Immolation,0,0,1,0,0,1,0,0,0,0,0,0,1
MIZORAM,2013,By Fire-Arms,0,1,1,1,0,3,0,0,0,0,0,0,3
MIZORAM,2013,By Hanging,1,29,16,10,1,57,2,6,3,1,0,12,69
MIZORAM,2013,By Consuming Insecticides,0,0,1,0,0,1,0,0,0,0,0,0,1
MIZORAM,2013,By Consuming Other Poison,0,0,0,0,0,0,0,0,0,0,0,0,0
MIZORAM,2013,By Self Infliction of injury,0,0,0,0,0,0,0,0,0,0,0,0,0
MIZORAM,2013,By Jumping from (Building),0,0,0,0,0,0,0,0,0,0,0,0,0
MIZORAM,2013,By Jumping from (Other sites),0,0,0,0,0,0,0,0,0,0,0,0,0
MIZORAM,2013,By Jumping off Moving Vehicles/Trains,0,0,0,0,0,0,0,0,0,0,0,0,0
MIZORAM,2013,By Machine,0,0,0,0,0,0,0,0,0,0,0,0,0
MIZORAM,2013,By Overdose of sleeping pills,0,0,0,0,0,0,0,0,0,0,0,0,0
MIZORAM,2013,By touching electric wires,0,0,0,0,0,0,0,0,0,0,0,0,0
MIZORAM,2013,By coming under running vehicles/trains,0,0,0,0,0,0,0,0,0,0,0,0,0
MIZORAM,2013,By Other means (please specify),1,8,1,0,0,10,0,1,0,0,0,1,11
MIZORAM,2013,Total,3,44,20,11,1,79,2,7,4,3,0,16,95
MIZORAM,2013,Total (Poison),0,0,1,0,0,1,0,0,0,0,0,0,1
MIZORAM,2013,Total (Jumping),0,0,0,0,0,0,0,0,0,0,0,0,0
NAGALAND,2013,By Over Alcoholism,0,0,0,0,0,0,0,0,0,0,0,0,0
NAGALAND,2013,By Drowning,1,0,1,0,0,2,0,0,0,0,0,0,2
NAGALAND,2013,By Fire/Self Immolation,0,0,0,0,0,0,0,0,0,0,0,0,0
NAGALAND,2013,By Fire-Arms,0,1,0,0,0,1,0,0,0,0,0,0,1
NAGALAND,2013,By Hanging,0,5,13,1,1,20,0,7,2,1,2,12,32
NAGALAND,2013,By Consuming Insecticides,0,0,0,0,0,0,0,0,0,0,0,0,0
NAGALAND,2013,By Consuming Other Poison,0,0,0,0,0,0,0,0,0,0,0,0,0
NAGALAND,2013,By Self Infliction of injury,0,0,0,0,0,0,0,0,0,0,0,0,0
NAGALAND,2013,By Jumping from (Building),0,1,1,0,0,2,0,0,0,0,0,0,2
NAGALAND,2013,By Jumping from (Other sites),0,0,0,0,0,0,0,0,0,0,0,0,0
NAGALAND,2013,By Jumping off Moving Vehicles/Trains,0,0,0,0,0,0,0,0,0,0,0,0,0
NAGALAND,2013,By Machine,0,0,0,0,0,0,0,0,0,0,0,0,0
NAGALAND,2013,By Overdose of sleeping pills,0,0,0,0,0,0,0,0,0,0,0,0,0
NAGALAND,2013,By touching electric wires,0,0,0,0,0,0,0,0,0,0,0,0,0
NAGALAND,2013,By coming under running vehicles/trains,0,0,0,0,0,0,0,0,0,0,0,0,0
NAGALAND,2013,By Other means (please specify),0,0,0,0,0,0,0,0,0,0,0,0,0
NAGALAND,2013,Total,1,7,15,1,1,25,0,7,2,1,2,12,37
NAGALAND,2013,Total (Poison),0,0,0,0,0,0,0,0,0,0,0,0,0
NAGALAND,2013,Total (Jumping),0,1,1,0,0,2,0,0,0,0,0,0,2
ODISHA,2013,By Over Alcoholism,0,0,0,0,0,0,0,0,0,0,0,0,0
ODISHA,2013,By Drowning,0,29,35,12,9,85,0,18,16,5,3,42,127
ODISHA,2013,By Fire/Self Immolation,0,40,33,13,0,86,0,19,32,13,3,67,153
ODISHA,2013,By Fire-Arms,0,2,0,0,0,2,0,0,0,0,0,0,2
ODISHA,2013,By Hanging,0,286,333,210,64,893,0,253,189,123,22,587,1480
ODISHA,2013,By Consuming Insecticides,5,217,201,128,26,577,4,150,128,58,16,356,933
ODISHA,2013,By Consuming Other Poison,5,141,192,191,59,588,13,141,147,72,15,388,976
ODISHA,2013,By Self Infliction of injury,0,0,0,0,0,0,0,0,0,0,0,0,0
ODISHA,2013,By Jumping from (Building),0,5,2,9,1,17,0,0,1,0,0,1,18
ODISHA,2013,By Jumping from (Other sites),0,6,0,2,0,8,0,2,0,0,0,2,10
ODISHA,2013,By Jumping off Moving Vehicles/Trains,0,1,5,2,0,8,0,2,0,4,0,6,14
ODISHA,2013,By Machine,0,0,0,0,0,0,0,0,0,0,0,0,0
ODISHA,2013,By Overdose of sleeping pills,0,1,0,2,0,3,0,0,3,1,0,4,7
ODISHA,2013,By touching electric wires,0,4,5,1,2,12,0,6,1,1,2,10,22
ODISHA,2013,By coming under running vehicles/trains,0,41,37,47,9,134,0,6,23,8,2,39,173
ODISHA,2013,By Other means (please specify),143,165,197,153,201,859,122,135,92,63,66,478,1337
ODISHA,2013,Total,153,938,1040,770,371,3272,139,732,632,348,129,1980,5252
ODISHA,2013,Total (Poison),10,358,393,319,85,1165,17,291,275,130,31,744,1909
ODISHA,2013,Total (Jumping),0,11,2,11,1,25,0,2,1,0,0,3,28
PUNJAB,2013,By Over Alcoholism,0,0,2,1,0,3,0,0,0,0,0,0,3
PUNJAB,2013,By Drowning,0,7,3,0,0,10,0,3,1,1,0,5,15
PUNJAB,2013,By Fire/Self Immolation,0,0,1,3,2,6,1,13,1,0,1,16,22
PUNJAB,2013,By Fire-Arms,1,4,3,3,0,11,0,0,1,0,0,1,12
PUNJAB,2013,By Hanging,3,96,83,35,10,227,1,63,28,12,3,107,334
PUNJAB,2013,By Consuming Insecticides,0,31,17,8,0,56,1,14,7,1,0,23,79
PUNJAB,2013,By Consuming Other Poison,0,24,13,12,2,51,0,21,11,2,0,34,85
PUNJAB,2013,By Self Infliction of injury,0,3,3,3,1,10,0,5,2,0,0,7,17
PUNJAB,2013,By Jumping from (Building),0,0,1,0,0,1,0,1,0,0,0,1,2
PUNJAB,2013,By Jumping from (Other sites),0,0,0,0,0,0,0,0,0,0,0,0,0
PUNJAB,2013,By Jumping off Moving Vehicles/Trains,1,0,0,0,0,1,0,0,0,0,0,0,1
PUNJAB,2013,By Machine,0,0,0,0,0,0,0,0,0,0,0,0,0
PUNJAB,2013,By Overdose of sleeping pills,0,0,1,0,0,1,0,0,0,0,0,0,1
PUNJAB,2013,By touching electric wires,0,0,0,0,0,0,0,0,0,0,0,0,0
PUNJAB,2013,By coming under running vehicles/trains,1,108,87,56,40,292,0,14,8,11,7,40,332
PUNJAB,2013,By Other means (please specify),0,19,10,10,5,44,3,17,4,0,1,25,69
PUNJAB,2013,Total,6,292,224,131,60,713,6,151,63,27,12,259,972
PUNJAB,2013,Total (Poison),0,58,33,23,3,117,1,40,20,3,0,64,181
PUNJAB,2013,Total (Jumping),0,0,1,0,0,1,0,1,0,0,0,1,2
RAJASTHAN,2013,By Over Alcoholism,0,14,21,18,5,58,0,0,0,0,0,0,58
RAJASTHAN,2013,By Drowning,12,85,64,36,13,210,6,48,37,16,7,114,324
RAJASTHAN,2013,By Fire/Self Immolation,0,32,53,25,6,116,4,65,45,20,9,143,259
RAJASTHAN,2013,By Fire-Arms,0,3,2,3,0,8,0,0,5,0,0,5,13
RAJASTHAN,2013,By Hanging,7,484,466,174,40,1171,11,240,112,47,11,421,1592
RAJASTHAN,2013,By Consuming Insecticides,3,110,119,66,14,312,1,83,65,32,10,191,503
RAJASTHAN,2013,By Consuming Other Poison,6,86,56,40,8,196,2,64,36,14,7,123,319
RAJASTHAN,2013,By Self Infliction of injury,0,1,2,4,1,8,0,0,1,0,0,1,9
RAJASTHAN,2013,By Jumping from (Building),1,6,8,6,1,22,0,2,3,0,0,5,27
RAJASTHAN,2013,By Jumping from (Other sites),3,24,35,20,4,86,0,12,9,3,3,27,113
RAJASTHAN,2013,By Jumping off Moving Vehicles/Trains,0,11,14,11,0,36,0,4,4,2,0,10,46
RAJASTHAN,2013,By Machine,0,3,6,2,0,11,0,0,1,0,0,1,12
RAJASTHAN,2013,By Overdose of sleeping pills,0,11,6,4,1,22,0,3,3,1,0,7,29
RAJASTHAN,2013,By touching electric wires,1,15,32,11,3,62,0,3,4,1,0,8,70
RAJASTHAN,2013,By coming under running vehicles/trains,0,46,51,27,5,129,0,7,3,3,1,14,143
RAJASTHAN,2013,By Other means (please specify),14,183,356,327,50,930,3,81,186,129,14,413,1343
RAJASTHAN,2013,Total,47,1114,1291,774,151,3377,27,612,514,268,62,1483,4860
RAJASTHAN,2013,Total (Poison),9,197,177,110,23,516,3,147,102,46,17,315,831
RAJASTHAN,2013,Total (Jumping),4,30,43,26,5,108,0,14,12,3,3,32,140
SIKKIM,2013,By Over Alcoholism,0,0,0,0,0,0,0,0,0,0,0,0,0
SIKKIM,2013,By Drowning,0,0,0,0,0,0,0,0,0,0,0,0,0
SIKKIM,2013,By Fire/Self Immolation,0,0,0,0,0,0,0,0,0,0,0,0,0
SIKKIM,2013,By Fire-Arms,0,0,0,0,0,0,0,0,0,0,0,0,0
SIKKIM,2013,By Hanging,5,49,48,16,7,125,3,37,11,5,3,59,184
SIKKIM,2013,By Consuming Insecticides,0,0,0,0,0,0,0,0,0,0,0,0,0
SIKKIM,2013,By Consuming Other Poison,0,0,0,0,0,0,0,0,0,0,0,0,0
SIKKIM,2013,By Self Infliction of injury,0,0,0,0,0,0,0,0,0,0,0,0,0
SIKKIM,2013,By Jumping from (Building),0,0,0,0,0,0,0,0,0,0,0,0,0
SIKKIM,2013,By Jumping from (Other sites),0,0,0,0,0,0,0,0,0,0,0,0,0
SIKKIM,2013,By Jumping off Moving Vehicles/Trains,0,0,0,0,0,0,0,0,0,0,0,0,0
SIKKIM,2013,By Machine,0,0,0,0,0,0,0,0,0,0,0,0,0
SIKKIM,2013,By Overdose of sleeping pills,0,0,0,0,0,0,0,0,0,0,0,0,0
SIKKIM,2013,By touching electric wires,0,0,0,0,0,0,0,0,0,0,0,0,0
SIKKIM,2013,By coming under running vehicles/trains,0,0,0,0,0,0,0,0,0,0,0,0,0
SIKKIM,2013,By Other means (please specify),0,0,0,0,0,0,0,0,0,0,0,0,0
SIKKIM,2013,Total,5,49,48,16,7,125,3,37,11,5,3,59,184
SIKKIM,2013,Total (Poison),0,0,0,0,0,0,0,0,0,0,0,0,0
SIKKIM,2013,Total (Jumping),0,0,0,0,0,0,0,0,0,0,0,0,0
TAMIL NADU,2013,By Over Alcoholism,0,29,95,111,24,259,0,0,0,3,0,3,262
TAMIL NADU,2013,By Drowning,47,156,171,124,63,561,24,76,71,56,18,245,806
TAMIL NADU,2013,By Fire/Self Immolation,14,219,340,192,72,837,48,537,373,194,109,1261,2098
TAMIL NADU,2013,By Fire-Arms,0,1,1,1,0,3,0,2,1,2,0,5,8
TAMIL NADU,2013,By Hanging,38,1094,1333,832,276,3573,31,761,486,211,71,1560,5133
TAMIL NADU,2013,By Consuming Insecticides,16,359,478,471,247,1571,13,302,241,125,74,755,2326
TAMIL NADU,2013,By Consuming Other Poison,26,563,809,809,362,2569,17,369,316,166,107,975,3544
TAMIL NADU,2013,By Self Infliction of injury,1,4,5,7,1,18,2,2,2,3,1,10,28
TAMIL NADU,2013,By Jumping from (Building),8,17,37,31,14,107,5,4,5,14,4,32,139
TAMIL NADU,2013,By Jumping from (Other sites),3,19,22,28,7,79,6,3,7,2,3,21,100
TAMIL NADU,2013,By Jumping off Moving Vehicles/Trains,0,0,0,1,0,1,0,0,1,0,0,1,2
TAMIL NADU,2013,By Machine,0,4,5,4,0,13,0,0,0,0,0,0,13
TAMIL NADU,2013,By Overdose of sleeping pills,0,5,12,1,1,19,0,3,2,0,1,6,25
TAMIL NADU,2013,By touching electric wires,4,39,43,51,10,147,1,10,11,5,1,28,175
TAMIL NADU,2013,By coming under running vehicles/trains,6,91,71,44,31,243,4,25,12,5,9,55,298
TAMIL NADU,2013,By Other means (please specify),27,216,394,339,206,1182,4,192,105,104,57,462,1644
TAMIL NADU,2013,Total,190,2816,3816,3046,1314,11182,155,2286,1633,890,455,5419,16601
TAMIL NADU,2013,Total (Poison),43,926,1292,1287,610,4158,32,673,559,294,182,1740,5898
TAMIL NADU,2013,Total (Jumping),11,36,59,59,21,186,11,7,12,16,7,53,239
TRIPURA,2013,By Over Alcoholism,0,0,0,1,0,1,0,0,0,0,0,0,1
TRIPURA,2013,By Drowning,1,2,5,3,1,12,0,2,1,3,1,7,19
TRIPURA,2013,By Fire/Self Immolation,0,2,2,0,0,4,1,3,5,3,1,13,17
TRIPURA,2013,By Fire-Arms,0,1,2,0,0,3,0,4,4,0,0,8,11
TRIPURA,2013,By Hanging,10,108,110,81,35,344,10,88,30,25,7,160,504
TRIPURA,2013,By Consuming Insecticides,0,0,0,4,0,4,0,0,0,0,0,0,4
TRIPURA,2013,By Consuming Other Poison,3,30,25,16,6,80,4,26,11,9,2,52,132
TRIPURA,2013,By Self Infliction of injury,0,0,0,0,0,0,0,0,0,0,0,0,0
TRIPURA,2013,By Jumping from (Building),0,0,0,0,0,0,0,0,0,0,0,0,0
TRIPURA,2013,By Jumping from (Other sites),0,2,3,1,1,7,0,0,0,0,0,0,7
TRIPURA,2013,By Jumping off Moving Vehicles/Trains,0,0,0,0,0,0,0,0,0,0,0,0,0
TRIPURA,2013,By Machine,0,0,0,0,0,0,0,0,0,0,0,0,0
TRIPURA,2013,By Overdose of sleeping pills,0,0,0,0,0,0,0,0,0,0,0,0,0
TRIPURA,2013,By touching electric wires,0,0,0,0,0,0,0,0,0,0,0,0,0
TRIPURA,2013,By coming under running vehicles/trains,0,0,0,0,0,0,0,0,0,0,0,0,0
TRIPURA,2013,By Other means (please specify),10,69,70,29,3,181,8,25,18,12,22,85,266
TRIPURA,2013,Total,24,214,217,135,46,636,23,148,69,52,33,325,961
TRIPURA,2013,Total (Poison),3,30,25,20,6,84,4,26,11,9,2,52,136
TRIPURA,2013,Total (Jumping),0,2,3,1,1,7,0,0,0,0,0,0,7
UTTAR PRADESH,2013,By Over Alcoholism,1,39,58,49,34,181,0,12,3,0,0,15,196
UTTAR PRADESH,2013,By Drowning,9,66,77,45,16,213,4,51,30,10,3,98,311
UTTAR PRADESH,2013,By Fire/Self Immolation,5,54,67,24,7,157,7,213,114,42,8,384,541
UTTAR PRADESH,2013,By Fire-Arms,1,45,52,23,5,126,0,31,23,1,0,55,181
UTTAR PRADESH,2013,By Hanging,15,339,355,208,25,942,12,422,236,73,19,762,1704
UTTAR PRADESH,2013,By Consuming Insecticides,6,103,91,37,7,244,6,102,67,30,3,208,452
UTTAR PRADESH,2013,By Consuming Other Poison,6,78,84,44,5,217,5,84,34,17,6,146,363
UTTAR PRADESH,2013,By Self Infliction of injury,4,12,25,31,8,80,0,22,10,0,0,32,112
UTTAR PRADESH,2013,By Jumping from (Building),0,6,12,10,6,34,0,7,2,1,0,10,44
UTTAR PRADESH,2013,By Jumping from (Other sites),4,6,1,0,0,11,0,5,3,0,1,9,20
UTTAR PRADESH,2013,By Jumping off Moving Vehicles/Trains,0,44,56,33,12,145,0,17,11,3,0,31,176
UTTAR PRADESH,2013,By Machine,0,3,3,2,0,8,0,1,3,2,0,6,14
UTTAR PRADESH,2013,By Overdose of sleeping pills,0,17,19,17,5,58,0,27,13,7,1,48,106
UTTAR PRADESH,2013,By touching electric wires,2,36,44,13,0,95,2,11,11,7,0,31,126
UTTAR PRADESH,2013,By coming under running vehicles/trains,1,22,37,27,10,97,0,18,17,7,5,47,144
UTTAR PRADESH,2013,By Other means (please specify),58,167,145,126,59,555,26,84,48,72,11,241,796
UTTAR PRADESH,2013,Total,112,1037,1126,689,199,3163,62,1107,625,272,57,2123,5286
UTTAR PRADESH,2013,Total (Poison),16,193,200,112,20,541,11,208,111,47,9,386,927
UTTAR PRADESH,2013,Total (Jumping),4,12,13,10,6,45,0,12,5,1,1,19,64
UTTARAKHAND,2013,By Over Alcoholism,0,2,0,1,0,3,0,0,0,0,0,0,3
UTTARAKHAND,2013,By Drowning,2,12,7,2,1,24,1,1,0,0,0,2,26
UTTARAKHAND,2013,By Fire/Self Immolation,0,0,1,0,0,1,0,2,1,0,0,3,4
UTTARAKHAND,2013,By Fire-Arms,0,3,3,1,1,8,0,0,0,0,0,0,8
UTTARAKHAND,2013,By Hanging,0,37,28,18,5,88,3,24,17,2,0,46,134
UTTARAKHAND,2013,By Consuming Insecticides,0,16,8,4,0,28,0,8,2,1,0,11,39
UTTARAKHAND,2013,By Consuming Other Poison,0,11,13,4,2,30,2,13,1,6,2,24,54
UTTARAKHAND,2013,By Self Infliction of injury,0,1,0,0,0,1,0,0,0,0,0,0,1
UTTARAKHAND,2013,By Jumping from (Building),0,0,0,0,0,0,0,0,0,0,0,0,0
UTTARAKHAND,2013,By Jumping from (Other sites),0,0,1,0,0,1,0,0,0,0,0,0,1
UTTARAKHAND,2013,By Jumping off Moving Vehicles/Trains,0,4,3,1,0,8,0,0,3,0,1,4,12
UTTARAKHAND,2013,By Machine,0,0,2,0,0,2,0,0,0,0,0,0,2
UTTARAKHAND,2013,By Overdose of sleeping pills,0,0,0,0,0,0,0,0,0,0,0,0,0
UTTARAKHAND,2013,By touching electric wires,0,0,5,1,0,6,0,0,0,0,0,0,6
UTTARAKHAND,2013,By coming under running vehicles/trains,0,1,0,0,0,1,0,0,0,0,0,0,1
UTTARAKHAND,2013,By Other means (please specify),2,7,21,11,2,43,1,11,15,4,0,31,74
UTTARAKHAND,2013,Total,4,94,92,43,11,244,7,59,39,13,3,121,365
UTTARAKHAND,2013,Total (Poison),0,28,21,8,2,59,2,21,3,7,2,35,94
UTTARAKHAND,2013,Total (Jumping),0,0,1,0,0,1,0,0,0,0,0,0,1
WEST BENGAL,2013,By Over Alcoholism,0,15,36,20,28,99,0,0,0,1,0,1,100
WEST BENGAL,2013,By Drowning,32,85,111,67,14,309,17,62,59,27,5,170,479
WEST BENGAL,2013,By Fire/Self Immolation,4,63,51,21,12,151,3,107,97,32,19,258,409
WEST BENGAL,2013,By Fire-Arms,0,2,3,2,0,7,0,0,0,0,0,0,7
WEST BENGAL,2013,By Hanging,56,875,1110,686,181,2908,44,792,657,308,93,1894,4802
WEST BENGAL,2013,By Consuming Insecticides,0,58,62,76,15,211,9,102,76,44,15,246,457
WEST BENGAL,2013,By Consuming Other Poison,26,411,645,368,59,1509,17,435,420,193,23,1088,2597
WEST BENGAL,2013,By Self Infliction of injury,0,11,17,11,3,42,0,7,6,1,2,16,58
WEST BENGAL,2013,By Jumping from (Building),1,8,12,8,2,31,0,4,3,1,1,9,40
WEST BENGAL,2013,By Jumping from (Other sites),0,13,10,4,0,27,0,16,7,4,0,27,54
WEST BENGAL,2013,By Jumping off Moving Vehicles/Trains,0,41,24,0,0,65,0,23,9,1,0,33,98
WEST BENGAL,2013,By Machine,0,4,3,1,0,8,0,0,0,0,0,0,8
WEST BENGAL,2013,By Overdose of sleeping pills,1,2,7,9,3,22,0,2,3,0,7,12,34
WEST BENGAL,2013,By touching electric wires,4,23,14,14,3,58,3,13,14,1,3,34,92
WEST BENGAL,2013,By coming under running vehicles/trains,3,79,73,61,12,228,7,34,36,25,2,104,332
WEST BENGAL,2013,By Other means (please specify),57,600,769,604,155,2185,14,417,542,256,74,1303,3488
WEST BENGAL,2013,Total,184,2290,2947,1952,487,7860,114,2014,1929,894,244,5195,13055
WEST BENGAL,2013,Total (Poison),26,480,724,455,77,1762,26,544,502,238,40,1350,3112
WEST BENGAL,2013,Total (Jumping),1,21,22,12,2,58,0,20,10,5,1,36,94
A & N ISLANDS,2013,By Over Alcoholism,0,0,0,0,0,0,0,0,0,0,0,0,0
A & N ISLANDS,2013,By Drowning,0,0,2,1,0,3,0,2,0,0,0,2,5
A & N ISLANDS,2013,By Fire/Self Immolation,0,0,0,0,0,0,0,2,1,0,0,3,3
A & N ISLANDS,2013,By Fire-Arms,0,1,0,0,0,1,0,0,0,0,0,0,1
A & N ISLANDS,2013,By Hanging,4,33,25,27,15,104,2,14,9,4,1,30,134
A & N ISLANDS,2013,By Consuming Insecticides,0,1,2,0,0,3,0,3,1,0,0,4,7
A & N ISLANDS,2013,By Consuming Other Poison,0,0,0,0,0,0,0,0,0,0,0,0,0
A & N ISLANDS,2013,By Self Infliction of injury,0,0,0,0,0,0,0,0,0,0,0,0,0
A & N ISLANDS,2013,By Jumping from (Building),0,0,0,0,0,0,0,0,0,0,0,0,0
A & N ISLANDS,2013,By Jumping from (Other sites),0,0,0,0,0,0,0,0,0,0,0,0,0
A & N ISLANDS,2013,By Jumping off Moving Vehicles/Trains,0,0,0,0,0,0,0,0,0,0,0,0,0
A & N ISLANDS,2013,By Machine,0,0,0,0,0,0,0,0,0,0,0,0,0
A & N ISLANDS,2013,By Overdose of sleeping pills,0,0,0,0,0,0,0,1,0,0,0,1,1
A & N ISLANDS,2013,By touching electric wires,0,0,0,0,0,0,0,0,0,0,0,0,0
A & N ISLANDS,2013,By coming under running vehicles/trains,0,0,0,0,0,0,0,0,0,0,0,0,0
A & N ISLANDS,2013,By Other means (please specify),0,0,0,0,0,0,0,0,0,0,0,0,0
A & N ISLANDS,2013,Total,4,35,29,28,15,111,2,22,11,4,1,40,151
A & N ISLANDS,2013,Total (Poison),0,1,2,0,0,3,0,3,1,0,0,4,7
A & N ISLANDS,2013,Total (Jumping),0,0,0,0,0,0,0,0,0,0,0,0,0
CHANDIGARH,2013,By Over Alcoholism,0,0,0,0,0,0,0,0,0,0,0,0,0
CHANDIGARH,2013,By Drowning,0,0,1,1,0,2,0,0,0,0,0,0,2
CHANDIGARH,2013,By Fire/Self Immolation,0,1,1,0,0,2,0,2,1,0,0,3,5
CHANDIGARH,2013,By Fire-Arms,0,0,0,1,0,1,0,1,0,0,0,1,2
CHANDIGARH,2013,By Hanging,0,20,10,6,0,36,1,20,7,1,0,29,65
CHANDIGARH,2013,By Consuming Insecticides,0,1,1,0,0,2,0,0,0,0,0,0,2
CHANDIGARH,2013,By Consuming Other Poison,0,3,4,3,2,12,0,3,1,1,0,5,17
CHANDIGARH,2013,By Self Infliction of injury,0,0,0,0,0,0,0,0,0,0,0,0,0
CHANDIGARH,2013,By Jumping from (Building),0,3,1,0,0,4,0,0,0,0,0,0,4
CHANDIGARH,2013,By Jumping from (Other sites),0,0,0,0,0,0,0,0,0,0,0,0,0
CHANDIGARH,2013,By Jumping off Moving Vehicles/Trains,0,0,0,0,0,0,0,0,0,0,0,0,0
CHANDIGARH,2013,By Machine,0,0,0,0,0,0,0,0,0,0,0,0,0
CHANDIGARH,2013,By Overdose of sleeping pills,0,0,0,0,0,0,0,0,0,0,0,0,0
CHANDIGARH,2013,By touching electric wires,0,0,0,0,0,0,0,0,0,0,0,0,0
CHANDIGARH,2013,By coming under running vehicles/trains,0,0,0,0,0,0,0,0,0,0,0,0,0
CHANDIGARH,2013,By Other means (please specify),0,0,0,0,0,0,0,0,0,0,0,0,0
CHANDIGARH,2013,Total,0,28,18,11,2,59,1,26,9,2,0,38,97
CHANDIGARH,2013,Total (Poison),0,4,5,3,2,14,0,3,1,1,0,5,19
CHANDIGARH,2013,Total (Jumping),0,3,1,0,0,4,0,0,0,0,0,0,4
D & N HAVELI,2013,By Over Alcoholism,0,0,0,0,0,0,0,0,0,0,0,0,0
D & N HAVELI,2013,By Drowning,0,0,0,0,0,0,0,0,0,0,0,0,0
D & N HAVELI,2013,By Fire/Self Immolation,0,0,0,0,0,0,0,0,0,0,0,0,0
D & N HAVELI,2013,By Fire-Arms,0,0,0,0,0,0,0,0,0,0,0,0,0
D & N HAVELI,2013,By Hanging,0,23,11,14,2,50,0,13,2,2,6,23,73
D & N HAVELI,2013,By Consuming Insecticides,0,0,0,0,0,0,0,0,0,0,0,0,0
D & N HAVELI,2013,By Consuming Other Poison,0,1,1,3,0,5,0,0,3,3,0,6,11
D & N HAVELI,2013,By Self Infliction of injury,0,0,0,0,0,0,0,0,0,0,0,0,0
D & N HAVELI,2013,By Jumping from (Building),0,0,0,0,0,0,0,0,0,0,0,0,0
D & N HAVELI,2013,By Jumping from (Other sites),0,0,0,0,0,0,0,0,0,0,0,0,0
D & N HAVELI,2013,By Jumping off Moving Vehicles/Trains,0,0,0,0,0,0,0,0,0,0,0,0,0
D & N HAVELI,2013,By Machine,0,0,0,0,0,0,0,0,0,0,0,0,0
D & N HAVELI,2013,By Overdose of sleeping pills,0,0,0,0,0,0,0,0,0,0,0,0,0
D & N HAVELI,2013,By touching electric wires,0,0,0,0,0,0,0,0,0,0,0,0,0
D & N HAVELI,2013,By coming under running vehicles/trains,0,0,0,0,0,0,0,0,0,0,0,0,0
D & N HAVELI,2013,By Other means (please specify),0,0,0,0,0,0,0,0,0,0,0,0,0
D & N HAVELI,2013,Total,0,24,12,17,2,55,0,13,5,5,6,29,84
D & N HAVELI,2013,Total (Poison),0,1,1,3,0,5,0,0,3,3,0,6,11
D & N HAVELI,2013,Total (Jumping),0,0,0,0,0,0,0,0,0,0,0,0,0
DAMAN & DIU,2013,By Over Alcoholism,0,0,0,0,0,0,0,0,0,0,0,0,0
DAMAN & DIU,2013,By Drowning,0,0,0,0,0,0,0,0,0,0,0,0,0
DAMAN & DIU,2013,By Fire/Self Immolation,0,0,0,0,0,0,0,1,0,1,0,2,2
DAMAN & DIU,2013,By Fire-Arms,0,0,0,0,0,0,0,0,0,0,0,0,0
DAMAN & DIU,2013,By Hanging,0,7,1,2,0,10,0,4,4,1,0,9,19
DAMAN & DIU,2013,By Consuming Insecticides,0,1,1,1,0,3,0,0,0,0,0,0,3
DAMAN & DIU,2013,By Consuming Other Poison,0,0,0,0,0,0,0,1,1,0,0,2,2
DAMAN & DIU,2013,By Self Infliction of injury,0,0,0,0,0,0,0,0,0,0,0,0,0
DAMAN & DIU,2013,By Jumping from (Building),0,0,0,0,0,0,0,0,0,0,0,0,0
DAMAN & DIU,2013,By Jumping from (Other sites),0,0,0,0,0,0,0,0,0,0,0,0,0
DAMAN & DIU,2013,By Jumping off Moving Vehicles/Trains,0,0,0,0,0,0,0,0,0,0,0,0,0
DAMAN & DIU,2013,By Machine,0,0,0,0,0,0,0,0,0,0,0,0,0
DAMAN & DIU,2013,By Overdose of sleeping pills,0,0,0,0,0,0,0,0,0,0,0,0,0
DAMAN & DIU,2013,By touching electric wires,0,0,0,0,0,0,0,0,0,0,0,0,0
DAMAN & DIU,2013,By coming under running vehicles/trains,0,0,0,0,0,0,0,0,0,0,0,0,0
DAMAN & DIU,2013,By Other means (please specify),0,0,0,0,0,0,0,2,0,1,0,3,3
DAMAN & DIU,2013,Total,0,8,2,3,0,13,0,8,5,3,0,16,29
DAMAN & DIU,2013,Total (Poison),0,1,1,1,0,3,0,1,1,0,0,2,5
DAMAN & DIU,2013,Total (Jumping),0,0,0,0,0,0,0,0,0,0,0,0,0
DELHI (UT),2013,By Over Alcoholism,0,5,5,1,0,11,0,1,1,0,0,2,13
DELHI (UT),2013,By Drowning,0,14,19,12,2,47,0,6,2,1,0,9,56
DELHI (UT),2013,By Fire/Self Immolation,2,5,4,3,4,18,0,13,4,2,1,20,38
DELHI (UT),2013,By Fire-Arms,0,2,8,4,0,14,0,0,1,0,0,1,15
DELHI (UT),2013,By Hanging,13,454,384,125,43,1019,18,311,120,21,4,474,1493
DELHI (UT),2013,By Consuming Insecticides,0,20,14,8,1,43,0,14,5,3,0,22,65
DELHI (UT),2013,By Consuming Other Poison,0,51,40,18,15,124,6,45,13,4,2,70,194
DELHI (UT),2013,By Self Infliction of injury,0,2,0,1,1,4,0,0,0,0,0,0,4
DELHI (UT),2013,By Jumping from (Building),1,4,3,5,2,15,0,3,1,0,1,5,20
DELHI (UT),2013,By Jumping from (Other sites),0,2,0,0,0,2,0,0,0,0,0,0,2
DELHI (UT),2013,By Jumping off Moving Vehicles/Trains,0,0,0,0,0,0,0,0,0,0,0,0,0
DELHI (UT),2013,By Machine,0,1,1,1,0,3,0,4,0,1,1,6,9
DELHI (UT),2013,By Overdose of sleeping pills,0,0,0,3,2,5,0,1,0,0,0,1,6
DELHI (UT),2013,By touching electric wires,1,1,1,1,0,4,0,0,0,0,0,0,4
DELHI (UT),2013,By coming under running vehicles/trains,0,2,5,2,2,11,0,1,0,0,0,1,12
DELHI (UT),2013,By Other means (please specify),4,25,26,14,28,97,0,21,6,4,0,31,128
DELHI (UT),2013,Total,21,588,510,198,100,1417,24,420,153,36,9,642,2059
DELHI (UT),2013,Total (Poison),0,73,54,27,17,171,6,59,18,7,2,92,263
DELHI (UT),2013,Total (Jumping),1,6,3,5,2,17,0,3,1,0,1,5,22
LAKSHADWEEP,2013,By Over Alcoholism,0,0,0,0,0,0,0,0,0,0,0,0,0
LAKSHADWEEP,2013,By Drowning,0,0,0,0,0,0,0,0,0,0,0,0,0
LAKSHADWEEP,2013,By Fire/Self Immolation,0,0,0,0,0,0,0,0,1,0,0,1,1
LAKSHADWEEP,2013,By Fire-Arms,0,0,0,0,0,0,0,0,0,0,0,0,0
LAKSHADWEEP,2013,By Hanging,0,0,0,0,1,1,0,1,0,0,0,1,2
LAKSHADWEEP,2013,By Consuming Insecticides,0,0,0,0,0,0,0,0,0,0,0,0,0
LAKSHADWEEP,2013,By Consuming Other Poison,0,0,0,0,0,0,0,0,0,0,0,0,0
LAKSHADWEEP,2013,By Self Infliction of injury,0,0,0,0,0,0,0,0,0,0,0,0,0
LAKSHADWEEP,2013,By Jumping from (Building),0,0,0,0,0,0,0,0,0,0,0,0,0
LAKSHADWEEP,2013,By Jumping from (Other sites),0,0,0,0,0,0,0,0,0,0,0,0,0
LAKSHADWEEP,2013,By Jumping off Moving Vehicles/Trains,0,0,0,0,0,0,0,0,0,0,0,0,0
LAKSHADWEEP,2013,By Machine,0,0,0,0,0,0,0,0,0,0,0,0,0
LAKSHADWEEP,2013,By Overdose of sleeping pills,0,0,0,0,0,0,0,0,0,0,0,0,0
LAKSHADWEEP,2013,By touching electric wires,0,0,0,0,0,0,0,0,0,0,0,0,0
LAKSHADWEEP,2013,By coming under running vehicles/trains,0,0,0,0,0,0,0,0,0,0,0,0,0
LAKSHADWEEP,2013,By Other means (please specify),0,0,0,0,0,0,0,0,0,0,0,0,0
LAKSHADWEEP,2013,Total,0,0,0,0,1,1,0,1,1,0,0,2,3
LAKSHADWEEP,2013,Total (Poison),0,0,0,0,0,0,0,0,0,0,0,0,0
LAKSHADWEEP,2013,Total (Jumping),0,0,0,0,0,0,0,0,0,0,0,0,0
PUDUCHERRY,2013,By Over Alcoholism,0,0,0,0,0,0,0,0,0,0,0,0,0
PUDUCHERRY,2013,By Drowning,0,0,0,0,0,0,0,0,0,0,0,0,0
PUDUCHERRY,2013,By Fire/Self Immolation,0,0,7,5,1,13,1,11,8,2,1,23,36
PUDUCHERRY,2013,By Fire-Arms,0,0,0,0,0,0,0,0,0,0,0,0,0
PUDUCHERRY,2013,By Hanging,2,75,109,121,35,342,1,42,23,6,17,89,431
PUDUCHERRY,2013,By Consuming Insecticides,0,3,11,11,2,27,0,3,3,1,0,7,34
PUDUCHERRY,2013,By Consuming Other Poison,1,3,3,9,1,17,0,8,4,2,0,14,31
PUDUCHERRY,2013,By Self Infliction of injury,0,1,0,0,0,1,0,0,0,0,0,0,1
PUDUCHERRY,2013,By Jumping from (Building),0,0,1,0,0,1,0,0,0,0,0,0,1
PUDUCHERRY,2013,By Jumping from (Other sites),0,1,0,2,0,3,0,0,1,0,0,1,4
PUDUCHERRY,2013,By Jumping off Moving Vehicles/Trains,0,0,0,0,0,0,0,0,0,0,0,0,0
PUDUCHERRY,2013,By Machine,0,0,0,0,0,0,0,0,0,0,0,0,0
PUDUCHERRY,2013,By Overdose of sleeping pills,0,0,0,0,0,0,0,1,1,0,0,2,2
PUDUCHERRY,2013,By touching electric wires,0,0,0,0,0,0,0,0,0,0,0,0,0
PUDUCHERRY,2013,By coming under running vehicles/trains,0,1,1,2,0,4,0,1,0,1,0,2,6
PUDUCHERRY,2013,By Other means (please specify),0,0,0,0,0,0,0,0,0,0,0,0,0
PUDUCHERRY,2013,Total,3,84,132,150,39,408,2,66,40,12,18,138,546
PUDUCHERRY,2013,Total (Poison),1,7,14,20,3,45,0,11,7,3,0,21,66
