0,1,2,3,4,5,6,7,8,9,10,11,12,13,14,15
ANDHRA PRADESH,2001,House Wife,0,0,0,0,0,0,0,1132,811,397,104,2444,2444
ANDHRA PRADESH,2001,Service (Government),0,34,57,44,0,135,0,23,22,9,7,61,196
ANDHRA PRADESH,2001,Service (Private),1,250,275,138,10,674,5,43,24,28,6,106,780
ANDHRA PRADESH,2001,Public Sector Undertaking,0,32,36,29,13,110,0,4,5,1,0,10,120
ANDHRA PRADESH,2001,Student,56,202,19,18,0,295,46,115,5,9,0,175,470
ANDHRA PRADESH,2001,Unemployed,1,230,206,94,12,543,1,57,12,8,0,78,621
ANDHRA PRADESH,2001,Self-employed (Business activity),25,107,223,117,14,486,20,24,22,4,12,82,568
ANDHRA PRADESH,2001,Professional Activity,13,118,157,80,22,390,5,22,4,10,0,41,431
ANDHRA PRADESH,2001,Farming/Agriculture Activity,16,382,480,374,79,1331,12,65,46,45,10,178,1509
ANDHRA PRADESH,2001,Others (Please Specify),29,299,358,264,79,1029,38,212,154,78,16,498,1527
ANDHRA PRADESH,2001,Retired Person,0,0,1,4,16,21,0,0,2,0,3,5,26
ANDHRA PRADESH,2001,Others (Please Specify),32,404,401,404,124,1365,58,174,91,108,34,465,1830
ANDHRA PRADESH,2001,Total,173,2058,2213,1566,369,6379,185,1871,1198,697,192,4143,10522
ANDHRA PRADESH,2001,Total Salaried,1,316,368,211,23,919,5,70,51,38,13,177,1096
ANDHRA PRADESH,2001,Total Self-employed,83,906,1218,835,194,3236,75,323,226,137,38,799,4035
ANDHRA PRADESH,2002,House Wife,0,0,0,0,0,0,0,1009,773,319,91,2192,2192
ANDHRA PRADESH,2002,Service (Government),0,19,56,25,0,100,0,6,10,5,0,21,121
ANDHRA PRADESH,2002,Service (Private),0,248,248,126,7,629,0,44,24,15,4,87,716
ANDHRA PRADESH,2002,Public Sector Undertaking,0,32,47,45,3,127,0,14,13,3,4,34,161
ANDHRA PRADESH,2002,Student,48,238,15,2,0,303,72,134,2,0,0,208,511
ANDHRA PRADESH,2002,Unemployed,0,276,283,115,0,674,0,114,37,18,0,169,843
ANDHRA PRADESH,2002,Self-employed (Business activity),12,142,272,224,58,708,10,9,41,20,9,89,797
ANDHRA PRADESH,2002,Professional Activity,0,74,129,124,45,372,0,7,18,24,5,54,426
ANDHRA PRADESH,2002,Farming/Agriculture Activity,2,448,609,443,127,1629,2,85,119,53,8,267,1896
ANDHRA PRADESH,2002,Others (Please Specify),21,292,402,308,121,1144,7,93,131,71,50,352,1496
ANDHRA PRADESH,2002,Retired Person,0,0,3,16,17,36,0,0,0,0,0,0,36
ANDHRA PRADESH,2002,Others (Please Specify),18,404,767,507,153,1849,48,289,206,44,62,649,2498
ANDHRA PRADESH,2002,Total,101,2173,2831,1935,531,7571,139,1804,1374,572,233,4122,11693
ANDHRA PRADESH,2002,Total Salaried,0,299,351,196,10,856,0,64,47,23,8,142,998
ANDHRA PRADESH,2002,Total Self-employed,35,956,1412,1099,351,3853,19,194,309,168,72,762,4615
ANDHRA PRADESH,2003,House Wife,0,0,0,0,0,0,4,955,622,256,92,1929,1929
ANDHRA PRADESH,2003,Service (Government),0,76,84,79,11,250,0,11,21,4,0,36,286
ANDHRA PRADESH,2003,Service (Private),2,90,166,103,8,369,2,32,43,21,5,103,472
ANDHRA PRADESH,2003,Public Sector Undertaking,0,20,48,37,16,121,0,20,21,11,3,55,176
ANDHRA PRADESH,2003,Student,69,240,39,0,0,348,71,148,2,0,0,221,569
ANDHRA PRADESH,2003,Unemployed,1,224,307,116,0,648,9,52,14,3,0,78,726
ANDHRA PRADESH,2003,Self-employed (Business activity),2,87,238,222,47,596,9,18,49,27,5,108,704
ANDHRA PRADESH,2003,Professional Activity,0,104,180,90,16,390,1,6,18,2,0,27,417
ANDHRA PRADESH,2003,Farming/Agriculture Activity,7,325,585,376,149,1442,6,81,163,96,12,358,1800
ANDHRA PRADESH,2003,Others (Please Specify),17,333,475,254,118,1197,31,129,68,58,29,315,1512
ANDHRA PRADESH,2003,Retired Person,0,0,15,25,37,77,0,0,3,33,16,52,129
ANDHRA PRADESH,2003,Others (Please Specify),57,771,709,443,95,2075,64,233,180,98,39,614,2689
ANDHRA PRADESH,2003,Total,155,2270,2846,1745,497,7513,197,1685,1204,609,201,3896,11409
ANDHRA PRADESH,2003,Total Salaried,2,186,298,219,35,740,2,63,85,36,8,194,934
ANDHRA PRADESH,2003,Total Self-employed,26,849,1478,942,330,3625,47,234,298,183,46,808,4433
ANDHRA PRADESH,2004,House Wife,0,0,0,0,0,0,0,1163,795,264,93,2315,2315
ANDHRA PRADESH,2004,Service (Government),0,81,163,51,5,300,0,5,8,1,0,14,314
ANDHRA PRADESH,2004,Service (Private),4,174,248,171,22,619,0,34,35,11,0,80,699
ANDHRA PRADESH,2004,Public Sector Undertaking,0,20,30,10,3,63,0,5,17,1,0,23,86
ANDHRA PRADESH,2004,Student,37,230,48,0,0,315,43,127,7,0,0,177,492
ANDHRA PRADESH,2004,Unemployed,1,175,239,147,0,562,2,46,18,14,0,80,642
ANDHRA PRADESH,2004,Self-employed (Business activity),4,248,348,205,108,913,0,29,19,18,1,67,980
ANDHRA PRADESH,2004,Professional Activity,1,87,154,60,27,329,1,24,21,23,12,81,410
ANDHRA PRADESH,2004,Farming/Agriculture Activity,2,455,857,687,217,2218,14,154,150,84,46,448,2666
ANDHRA PRADESH,2004,Others (Please Specify),6,460,526,380,94,1466,20,142,88,81,36,367,1833
ANDHRA PRADESH,2004,Retired Person,0,0,6,33,23,62,0,0,0,17,6,23,85
ANDHRA PRADESH,2004,Others (Please Specify),40,632,829,431,303,2235,62,230,186,175,116,769,3004
ANDHRA PRADESH,2004,Total,95,2562,3448,2175,802,9082,142,1959,1344,689,310,4444,13526
ANDHRA PRADESH,2004,Total Salaried,4,275,441,232,30,982,0,44,60,13,0,117,1099
ANDHRA PRADESH,2004,Total Self-employed,13,1250,1885,1332,446,4926,35,349,278,206,95,963,5889
ANDHRA PRADESH,2005,House Wife,0,0,0,0,0,0,0,932,693,382,172,2179,2179
ANDHRA PRADESH,2005,Service (Government),0,10,43,57,0,110,0,6,24,0,0,30,140
ANDHRA PRADESH,2005,Service (Private),2,213,286,161,37,699,0,69,39,18,5,131,830
ANDHRA PRADESH,2005,Public Sector Undertaking,0,42,109,80,2,233,0,5,36,3,0,44,277
ANDHRA PRADESH,2005,Student,53,197,24,0,0,274,65,155,6,0,0,226,500
ANDHRA PRADESH,2005,Unemployed,1,169,160,52,48,430,0,70,10,0,0,80,510
ANDHRA PRADESH,2005,Self-employed (Business activity),2,238,304,244,94,882,0,53,31,27,4,115,997
ANDHRA PRADESH,2005,Professional Activity,0,37,61,43,41,182,1,26,8,3,0,38,220
ANDHRA PRADESH,2005,Farming/Agriculture Activity,6,481,729,578,223,2017,22,127,174,85,65,473,2490
ANDHRA PRADESH,2005,Others (Please Specify),25,357,443,256,168,1249,23,208,138,70,29,468,1717
ANDHRA PRADESH,2005,Retired Person,0,2,0,35,20,57,0,1,0,1,1,3,60
ANDHRA PRADESH,2005,Others (Please Specify),54,698,1019,650,311,2732,50,252,201,144,143,790,3522
ANDHRA PRADESH,2005,Total,143,2444,3178,2156,944,8865,161,1904,1360,733,419,4577,13442
ANDHRA PRADESH,2005,Total Salaried,2,265,438,298,39,1042,0,80,99,21,5,205,1247
ANDHRA PRADESH,2005,Total Self-employed,33,1113,1537,1121,526,4330,46,414,351,185,98,1094,5424
ANDHRA PRADESH,2006,House Wife,0,0,0,0,0,0,2,994,750,303,107,2156,2156
ANDHRA PRADESH,2006,Service (Government),4,51,84,44,0,183,0,19,26,3,0,48,231
ANDHRA PRADESH,2006,Service (Private),0,157,240,159,20,576,0,30,35,6,0,71,647
ANDHRA PRADESH,2006,Public Sector Undertaking,0,67,69,48,6,190,0,1,10,3,0,14,204
ANDHRA PRADESH,2006,Student,55,216,12,4,0,287,53,168,4,0,0,225,512
ANDHRA PRADESH,2006,Unemployed,0,169,132,70,0,371,0,34,24,0,0,58,429
ANDHRA PRADESH,2006,Self-employed (Business activity),0,263,305,214,60,842,0,15,12,21,4,52,894
ANDHRA PRADESH,2006,Professional Activity,0,66,240,197,49,552,1,12,8,0,1,22,574
ANDHRA PRADESH,2006,Farming/Agriculture Activity,15,505,777,489,214,2000,14,241,210,115,27,607,2607
ANDHRA PRADESH,2006,Others (Please Specify),46,505,651,430,191,1823,71,269,145,83,110,678,2501
ANDHRA PRADESH,2006,Retired Person,0,1,3,9,38,51,0,0,5,0,1,6,57
ANDHRA PRADESH,2006,Others (Please Specify),49,696,765,368,110,1988,54,204,128,49,41,476,2464
ANDHRA PRADESH,2006,Total,169,2696,3278,2032,688,8863,195,1987,1357,583,291,4413,13276
ANDHRA PRADESH,2006,Total Salaried,4,275,393,251,26,949,0,50,71,12,0,133,1082
ANDHRA PRADESH,2006,Total Self-employed,61,1339,1973,1330,514,5217,86,537,375,219,142,1359,6576
ANDHRA PRADESH,2007,House Wife,0,0,0,0,0,0,0,1105,811,405,159,2480,2480
ANDHRA PRADESH,2007,Service (Government),0,71,86,63,0,220,1,26,19,9,0,55,275
ANDHRA PRADESH,2007,Service (Private),6,239,490,266,102,1103,3,41,105,72,49,270,1373
ANDHRA PRADESH,2007,Public Sector Undertaking,0,46,99,62,3,210,4,8,13,4,0,29,239
ANDHRA PRADESH,2007,Student,63,327,27,3,0,420,80,193,6,0,0,279,699
ANDHRA PRADESH,2007,Unemployed,0,120,146,74,0,340,7,43,10,3,0,63,403
ANDHRA PRADESH,2007,Self-employed (Business activity),0,262,374,249,40,925,0,16,16,22,1,55,980
ANDHRA PRADESH,2007,Professional Activity,2,110,151,109,49,421,7,31,17,3,0,58,479
ANDHRA PRADESH,2007,Farming/Agriculture Activity,5,325,620,421,137,1508,20,113,90,53,13,289,1797
ANDHRA PRADESH,2007,Others (Please Specify),9,636,913,563,341,2462,32,283,166,126,61,668,3130
ANDHRA PRADESH,2007,Retired Person,0,1,7,4,55,67,0,0,0,6,5,11,78
ANDHRA PRADESH,2007,Others (Please Specify),36,799,747,490,201,2273,40,280,197,101,58,676,2949
ANDHRA PRADESH,2007,Total,121,2936,3660,2304,928,9949,194,2139,1450,804,346,4933,14882
ANDHRA PRADESH,2007,Total Salaried,6,356,675,391,105,1533,8,75,137,85,49,354,1887
ANDHRA PRADESH,2007,Total Self-employed,16,1333,2058,1342,567,5316,59,443,289,204,75,1070,6386
ANDHRA PRADESH,2008,House Wife,0,0,0,0,0,0,0,984,1012,381,139,2516,2516
ANDHRA PRADESH,2008,Service (Government),0,17,108,121,0,246,0,7,37,15,0,59,305
ANDHRA PRADESH,2008,Service (Private),0,239,420,217,92,968,0,68,75,31,15,189,1157
ANDHRA PRADESH,2008,Public Sector Undertaking,4,123,155,181,68,531,0,34,33,21,22,110,641
ANDHRA PRADESH,2008,Student,37,233,19,5,0,294,44,133,9,1,0,187,481
ANDHRA PRADESH,2008,Unemployed,0,185,164,170,0,519,0,7,20,25,0,52,571
ANDHRA PRADESH,2008,Self-employed (Business activity),0,194,458,218,65,935,0,11,17,0,2,30,965
ANDHRA PRADESH,2008,Professional Activity,2,60,202,157,38,459,0,25,4,0,4,33,492
ANDHRA PRADESH,2008,Farming/Agriculture Activity,2,436,628,505,176,1747,6,142,91,84,35,358,2105
ANDHRA PRADESH,2008,Others (Please Specify),7,561,815,427,146,1956,34,270,140,95,41,580,2536
ANDHRA PRADESH,2008,Retired Person,0,0,21,7,24,52,0,0,5,2,8,15,67
ANDHRA PRADESH,2008,Others (Please Specify),39,666,679,469,161,2014,38,201,141,83,41,504,2518
ANDHRA PRADESH,2008,Total,91,2714,3669,2477,770,9721,122,1882,1584,738,307,4633,14354
ANDHRA PRADESH,2008,Total Salaried,4,379,683,519,160,1745,0,109,145,67,37,358,2103
ANDHRA PRADESH,2008,Total Self-employed,11,1251,2103,1307,425,5097,40,448,252,179,82,1001,6098
ANDHRA PRADESH,2009,House Wife,0,0,0,0,0,0,0,1033,779,428,151,2391,2391
ANDHRA PRADESH,2009,Service (Government),0,54,100,57,2,213,0,13,6,2,0,21,234
ANDHRA PRADESH,2009,Service (Private),0,277,468,222,79,1046,0,65,44,33,19,161,1207
ANDHRA PRADESH,2009,Public Sector Undertaking,0,154,203,152,78,587,0,36,20,8,14,78,665
ANDHRA PRADESH,2009,Student,38,293,33,0,0,364,65,164,4,0,0,233,597
ANDHRA PRADESH,2009,Unemployed,0,263,252,129,0,644,0,41,15,14,0,70,714
ANDHRA PRADESH,2009,Self-employed (Business activity),0,341,460,387,138,1326,0,14,9,1,1,25,1351
ANDHRA PRADESH,2009,Professional Activity,0,74,132,249,11,466,0,18,1,3,1,23,489
ANDHRA PRADESH,2009,Farming/Agriculture Activity,5,392,885,562,172,2016,5,132,141,100,20,398,2414
ANDHRA PRADESH,2009,Others (Please Specify),8,541,728,532,137,1946,25,229,240,125,51,670,2616
ANDHRA PRADESH,2009,Retired Person,0,0,0,8,61,69,0,0,25,1,3,29,98
ANDHRA PRADESH,2009,Others (Please Specify),16,338,461,288,107,1210,32,189,136,114,43,514,1724
ANDHRA PRADESH,2009,Total,67,2727,3722,2586,785,9887,127,1934,1420,829,303,4613,14500
ANDHRA PRADESH,2009,Total Salaried,0,485,771,431,159,1846,0,114,70,43,33,260,2106
ANDHRA PRADESH,2009,Total Self-employed,13,1348,2205,1730,458,5754,30,393,391,229,73,1116,6870
ANDHRA PRADESH,2010,House Wife,0,0,0,0,0,0,0,1067,879,409,246,2601,2601
ANDHRA PRADESH,2010,Service (Government),0,39,96,52,0,187,0,41,31,0,0,72,259
ANDHRA PRADESH,2010,Service (Private),0,352,361,198,18,929,0,58,36,11,9,114,1043
ANDHRA PRADESH,2010,Public Sector Undertaking,0,156,184,96,49,485,0,9,29,9,0,47,532
ANDHRA PRADESH,2010,Student,41,333,0,0,0,374,62,220,0,0,0,282,656
ANDHRA PRADESH,2010,Unemployed,0,266,208,87,0,561,0,27,48,0,0,75,636
ANDHRA PRADESH,2010,Self-employed (Business activity),0,324,371,192,50,937,0,43,2,10,3,58,995
ANDHRA PRADESH,2010,Professional Activity,0,86,75,37,20,218,0,6,1,2,1,10,228
ANDHRA PRADESH,2010,Farming/Agriculture Activity,4,563,824,573,166,2130,12,165,137,40,41,395,2525
ANDHRA PRADESH,2010,Others (Please Specify),32,963,1216,894,368,3473,29,343,187,112,76,747,4220
ANDHRA PRADESH,2010,Retired Person,0,0,0,9,57,66,0,0,0,11,7,18,84
ANDHRA PRADESH,2010,Others (Please Specify),18,448,527,428,166,1587,27,166,222,74,46,535,2122
ANDHRA PRADESH,2010,Total,95,3530,3862,2566,894,10947,130,2145,1572,678,429,4954,15901
ANDHRA PRADESH,2010,Total Salaried,0,547,641,346,67,1601,0,108,96,20,9,233,1834
ANDHRA PRADESH,2010,Total Self-employed,36,1936,2486,1696,604,6758,41,557,327,164,121,1210,7968
ANDHRA PRADESH,2011,House Wife,0,0,0,0,0,0,1,1007,832,332,116,2288,2288
ANDHRA PRADESH,2011,Service (Government),0,12,41,36,0,89,0,10,8,2,0,20,109
ANDHRA PRADESH,2011,Service (Private),0,311,543,419,114,1387,0,91,104,36,12,243,1630
ANDHRA PRADESH,2011,Public Sector Undertaking,0,99,83,81,25,288,0,22,51,3,3,79,367
ANDHRA PRADESH,2011,Student,45,235,7,0,0,287,59,216,1,0,0,276,563
ANDHRA PRADESH,2011,Unemployed,0,181,248,98,8,535,0,59,30,14,4,107,642
ANDHRA PRADESH,2011,Self-employed (Business activity),0,275,311,263,112,961,0,69,39,22,3,133,1094
ANDHRA PRADESH,2011,Professional Activity,0,116,123,76,25,340,0,21,11,9,11,52,392
ANDHRA PRADESH,2011,Farming/Agriculture Activity,5,463,670,541,143,1822,3,202,102,67,10,384,2206
ANDHRA PRADESH,2011,Others (Please Specify),34,707,903,559,280,2483,47,342,221,105,98,813,3296
ANDHRA PRADESH,2011,Retired Person,0,0,0,5,30,35,0,0,0,1,5,6,41
ANDHRA PRADESH,2011,Others (Please Specify),28,429,622,632,182,1893,33,245,156,72,50,556,2449
ANDHRA PRADESH,2011,Total,112,2828,3551,2710,919,10120,143,2284,1555,663,312,4957,15077
ANDHRA PRADESH,2011,Total Salaried,0,422,667,536,139,1764,0,123,163,41,15,342,2106
ANDHRA PRADESH,2011,Total Self-employed,39,1561,2007,1439,560,5606,50,634,373,203,122,1382,6988
ANDHRA PRADESH,2012,House Wife,0,0,0,0,0,0,1,946,669,401,126,2143,2143
ANDHRA PRADESH,2012,Service (Government),0,18,42,45,3,108,0,7,16,6,0,29,137
ANDHRA PRADESH,2012,Service (Private),0,411,563,244,50,1268,0,84,67,24,10,185,1453
ANDHRA PRADESH,2012,Public Sector Undertaking,0,70,124,60,26,280,0,9,38,2,2,51,331
ANDHRA PRADESH,2012,Student,35,222,19,0,0,276,54,225,4,0,0,283,559
ANDHRA PRADESH,2012,Unemployed,0,195,266,133,46,640,0,81,33,11,2,127,767
ANDHRA PRADESH,2012,Self-employed (Business activity),0,207,300,165,49,721,0,7,19,3,1,30,751
ANDHRA PRADESH,2012,Professional Activity,0,85,142,98,9,334,1,15,14,1,0,31,365
ANDHRA PRADESH,2012,Farming/Agriculture Activity,0,474,753,624,249,2100,7,132,207,70,56,472,2572
ANDHRA PRADESH,2012,Others (Please Specify),11,601,976,651,282,2521,49,285,265,128,86,813,3334
ANDHRA PRADESH,2012,Retired Person,0,0,1,31,52,84,0,0,0,0,0,0,84
ANDHRA PRADESH,2012,Others (Please Specify),19,260,442,289,185,1195,31,255,134,84,43,547,1742
ANDHRA PRADESH,2012,Total,65,2543,3628,2340,951,9527,143,2046,1466,730,326,4711,14238
ANDHRA PRADESH,2012,Total Salaried,0,499,729,349,79,1656,0,100,121,32,12,265,1921
ANDHRA PRADESH,2012,Total Self-employed,11,1367,2171,1538,589,5676,57,439,505,202,143,1346,7022
ARUNACHAL PRADESH,2001,House Wife,0,0,0,0,0,0,0,9,5,1,0,15,15
ARUNACHAL PRADESH,2001,Service (Government),0,5,7,2,0,14,0,0,0,0,0,0,14
ARUNACHAL PRADESH,2001,Service (Private),0,12,19,1,0,32,0,5,4,0,0,9,41
ARUNACHAL PRADESH,2001,Public Sector Undertaking,0,0,0,0,0,0,0,0,0,0,0,0,0
ARUNACHAL PRADESH,2001,Student,0,2,0,0,0,2,2,4,0,0,0,6,8
ARUNACHAL PRADESH,2001,Unemployed,0,2,1,0,0,3,0,0,0,0,0,0,3
ARUNACHAL PRADESH,2001,Self-employed (Business activity),0,2,6,3,1,12,0,0,0,0,0,0,12
ARUNACHAL PRADESH,2001,Professional Activity,0,0,0,0,0,0,0,0,0,0,0,0,0
ARUNACHAL PRADESH,2001,Farming/Agriculture Activity,2,1,5,4,0,12,0,5,0,0,0,5,17
ARUNACHAL PRADESH,2001,Others (Please Specify),0,0,0,0,0,0,0,0,0,0,0,0,0
ARUNACHAL PRADESH,2001,Retired Person,0,0,0,1,0,1,0,0,0,0,0,0,1
ARUNACHAL PRADESH,2001,Others (Please Specify),0,0,0,0,0,0,0,0,0,0,0,0,0
ARUNACHAL PRADESH,2001,Total,2,24,38,11,1,76,2,23,9,1,0,35,111
ARUNACHAL PRADESH,2001,Total Salaried,0,17,26,3,0,46,0,5,4,0,0,9,55
ARUNACHAL PRADESH,2001,Total Self-employed,2,3,11,7,1,24,0,5,0,0,0,5,29
ARUNACHAL PRADESH,2002,House Wife,0,0,0,0,0,0,0,14,11,1,1,27,27
ARUNACHAL PRADESH,2002,Service (Government),0,5,9,1,0,15,0,0,0,0,0,0,15
ARUNACHAL PRADESH,2002,Service (Private),0,2,9,2,0,13,0,0,0,0,0,0,13
ARUNACHAL PRADESH,2002,Public Sector Undertaking,0,0,0,0,0,0,0,0,0,0,0,0,0
ARUNACHAL PRADESH,2002,Student,1,3,0,0,0,4,1,4,0,0,0,5,9
ARUNACHAL PRADESH,2002,Unemployed,0,1,0,1,0,2,0,4,0,0,0,4,6
ARUNACHAL PRADESH,2002,Self-employed (Business activity),0,4,7,3,0,14,0,1,0,0,0,1,15
ARUNACHAL PRADESH,2002,Professional Activity,0,0,1,0,0,1,0,0,0,0,0,0,1
ARUNACHAL PRADESH,2002,Farming/Agriculture Activity,0,5,12,1,3,21,1,5,0,0,0,6,27
ARUNACHAL PRADESH,2002,Others (Please Specify),0,0,0,0,0,0,0,0,0,0,0,0,0
ARUNACHAL PRADESH,2002,Retired Person,0,0,0,1,0,1,0,0,0,0,0,0,1
ARUNACHAL PRADESH,2002,Others (Please Specify),0,0,0,0,0,0,0,0,0,0,0,0,0
ARUNACHAL PRADESH,2002,Total,1,20,38,9,3,71,2,28,11,1,1,43,114
ARUNACHAL PRADESH,2002,Total Salaried,0,7,18,3,0,28,0,0,0,0,0,0,28
ARUNACHAL PRADESH,2002,Total Self-employed,0,9,20,4,3,36,1,6,0,0,0,7,43
ARUNACHAL PRADESH,2003,House Wife,0,0,0,0,0,0,0,8,8,2,0,18,18
ARUNACHAL PRADESH,2003,Service (Government),0,1,7,4,0,12,0,0,2,0,0,2,14
ARUNACHAL PRADESH,2003,Service (Private),0,2,1,0,0,3,0,0,0,0,0,0,3
ARUNACHAL PRADESH,2003,Public Sector Undertaking,0,1,0,0,0,1,0,0,0,0,0,0,1
ARUNACHAL PRADESH,2003,Student,1,0,0,0,0,1,1,3,0,0,0,4,5
ARUNACHAL PRADESH,2003,Unemployed,1,2,0,0,0,3,0,0,0,0,0,0,3
ARUNACHAL PRADESH,2003,Self-employed (Business activity),0,5,12,7,0,24,0,2,0,0,0,2,26
ARUNACHAL PRADESH,2003,Professional Activity,0,0,0,0,0,0,0,0,0,0,0,0,0
ARUNACHAL PRADESH,2003,Farming/Agriculture Activity,1,0,6,1,2,10,0,1,0,0,0,1,11
ARUNACHAL PRADESH,2003,Others (Please Specify),0,0,0,0,0,0,0,0,0,0,0,0,0
ARUNACHAL PRADESH,2003,Retired Person,0,0,0,0,0,0,0,0,0,0,0,0,0
ARUNACHAL PRADESH,2003,Others (Please Specify),0,0,0,0,0,0,0,0,0,0,0,0,0
ARUNACHAL PRADESH,2003,Total,3,11,26,12,2,54,1,14,10,2,0,27,81
ARUNACHAL PRADESH,2003,Total Salaried,0,4,8,4,0,16,0,0,2,0,0,2,18
ARUNACHAL PRADESH,2003,Total Self-employed,1,5,18,8,2,34,0,3,0,0,0,3,37
ARUNACHAL PRADESH,2004,House Wife,0,0,0,0,0,0,0,7,10,0,0,17,17
ARUNACHAL PRADESH,2004,Service (Government),0,2,7,1,0,10,0,1,0,0,0,1,11
ARUNACHAL PRADESH,2004,Service (Private),0,1,1,0,0,2,0,0,0,0,0,0,2
ARUNACHAL PRADESH,2004,Public Sector Undertaking,0,0,0,0,0,0,0,0,0,0,0,0,0
ARUNACHAL PRADESH,2004,Student,1,4,0,0,0,5,2,3,0,0,0,5,10
ARUNACHAL PRADESH,2004,Unemployed,0,1,1,0,0,2,1,0,2,0,0,3,5
ARUNACHAL PRADESH,2004,Self-employed (Business activity),0,5,6,3,0,14,0,0,0,0,0,0,14
ARUNACHAL PRADESH,2004,Professional Activity,0,0,0,0,0,0,0,0,0,0,0,0,0
ARUNACHAL PRADESH,2004,Farming/Agriculture Activity,0,5,9,2,0,16,1,2,1,0,0,4,20
ARUNACHAL PRADESH,2004,Others (Please Specify),0,0,0,0,0,0,0,0,0,0,0,0,0
ARUNACHAL PRADESH,2004,Retired Person,0,0,0,0,0,0,0,0,0,0,0,0,0
ARUNACHAL PRADESH,2004,Others (Please Specify),0,0,0,0,0,0,0,0,0,0,0,0,0
ARUNACHAL PRADESH,2004,Total,1,18,24,6,0,49,4,13,13,0,0,30,79
ARUNACHAL PRADESH,2004,Total Salaried,0,3,8,1,0,12,0,1,0,0,0,1,13
ARUNACHAL PRADESH,2004,Total Self-employed,0,10,15,5,0,30,1,2,1,0,0,4,34
ARUNACHAL PRADESH,2005,House Wife,0,0,0,0,0,0,0,1,6,1,1,9,9
ARUNACHAL PRADESH,2005,Service (Government),0,0,3,0,0,3,0,1,0,0,0,1,4
ARUNACHAL PRADESH,2005,Service (Private),0,0,4,0,0,4,0,0,1,0,0,1,5
ARUNACHAL PRADESH,2005,Public Sector Undertaking,0,0,0,0,0,0,0,0,0,0,0,0,0
ARUNACHAL PRADESH,2005,Student,0,1,0,0,0,1,0,1,0,0,0,1,2
ARUNACHAL PRADESH,2005,Unemployed,0,1,2,1,0,4,0,1,0,0,0,1,5
ARUNACHAL PRADESH,2005,Self-employed (Business activity),0,5,11,1,1,18,0,1,0,0,0,1,19
ARUNACHAL PRADESH,2005,Professional Activity,0,1,0,0,0,1,0,0,0,0,0,0,1
ARUNACHAL PRADESH,2005,Farming/Agriculture Activity,0,5,8,2,3,18,0,5,2,0,0,7,25
ARUNACHAL PRADESH,2005,Others (Please Specify),0,0,0,0,0,0,0,0,0,0,0,0,0
ARUNACHAL PRADESH,2005,Retired Person,0,0,0,0,0,0,0,0,0,0,0,0,0
ARUNACHAL PRADESH,2005,Others (Please Specify),0,0,0,0,0,0,0,0,0,0,0,0,0
ARUNACHAL PRADESH,2005,Total,0,13,28,4,4,49,0,10,9,1,1,21,70
ARUNACHAL PRADESH,2005,Total Salaried,0,0,7,0,0,7,0,1,1,0,0,2,9
ARUNACHAL PRADESH,2005,Total Self-employed,0,11,19,3,4,37,0,6,2,0,0,8,45
ARUNACHAL PRADESH,2006,House Wife,0,0,0,0,0,0,0,7,11,3,0,21,21
ARUNACHAL PRADESH,2006,Service (Government),0,2,9,7,0,18,0,0,1,0,0,1,19
ARUNACHAL PRADESH,2006,Service (Private),0,11,12,4,1,28,0,0,0,0,0,0,28
ARUNACHAL PRADESH,2006,Public Sector Undertaking,0,0,0,0,0,0,0,0,0,0,0,0,0
ARUNACHAL PRADESH,2006,Student,1,1,0,0,0,2,2,6,0,0,0,8,10
ARUNACHAL PRADESH,2006,Unemployed,0,3,5,1,0,9,0,0,0,0,0,0,9
ARUNACHAL PRADESH,2006,Self-employed (Business activity),0,2,2,1,0,5,0,0,0,0,0,0,5
ARUNACHAL PRADESH,2006,Professional Activity,0,0,0,0,0,0,0,0,0,0,0,0,0
ARUNACHAL PRADESH,2006,Farming/Agriculture Activity,0,1,2,1,0,4,0,0,0,0,0,0,4
ARUNACHAL PRADESH,2006,Others (Please Specify),0,8,12,3,0,23,1,2,0,0,0,3,26
ARUNACHAL PRADESH,2006,Retired Person,0,0,0,0,0,0,0,0,0,0,0,0,0
ARUNACHAL PRADESH,2006,Others (Please Specify),0,0,3,4,0,7,0,0,0,0,0,0,7
ARUNACHAL PRADESH,2006,Total,1,28,45,21,1,96,3,15,12,3,0,33,129
ARUNACHAL PRADESH,2006,Total Salaried,0,13,21,11,1,46,0,0,1,0,0,1,47
ARUNACHAL PRADESH,2006,Total Self-employed,0,11,16,5,0,32,1,2,0,0,0,3,35
ARUNACHAL PRADESH,2007,House Wife,0,0,0,0,0,0,0,2,8,0,0,10,10
ARUNACHAL PRADESH,2007,Service (Government),0,0,5,4,0,9,0,0,0,0,0,0,9
ARUNACHAL PRADESH,2007,Service (Private),0,10,5,2,1,18,0,1,0,0,0,1,19
ARUNACHAL PRADESH,2007,Public Sector Undertaking,0,0,0,0,0,0,0,0,0,0,0,0,0
ARUNACHAL PRADESH,2007,Student,1,2,0,0,0,3,2,6,0,0,0,8,11
ARUNACHAL PRADESH,2007,Unemployed,1,11,12,1,0,25,0,1,1,0,0,2,27
ARUNACHAL PRADESH,2007,Self-employed (Business activity),0,1,1,2,0,4,0,0,0,0,0,0,4
ARUNACHAL PRADESH,2007,Professional Activity,0,1,0,0,0,1,0,0,0,0,0,0,1
ARUNACHAL PRADESH,2007,Farming/Agriculture Activity,0,4,9,1,0,14,0,1,0,0,0,1,15
ARUNACHAL PRADESH,2007,Others (Please Specify),0,6,10,0,0,16,1,3,0,1,0,5,21
ARUNACHAL PRADESH,2007,Retired Person,0,0,0,0,2,2,0,0,0,0,0,0,2
ARUNACHAL PRADESH,2007,Others (Please Specify),0,4,2,0,0,6,2,0,1,1,0,4,10
ARUNACHAL PRADESH,2007,Total,2,39,44,10,3,98,5,14,10,2,0,31,129
ARUNACHAL PRADESH,2007,Total Salaried,0,10,10,6,1,27,0,1,0,0,0,1,28
ARUNACHAL PRADESH,2007,Total Self-employed,0,12,20,3,0,35,1,4,0,1,0,6,41
ARUNACHAL PRADESH,2008,House Wife,0,0,0,0,0,0,0,6,7,1,0,14,14
ARUNACHAL PRADESH,2008,Service (Government),0,10,14,1,0,25,0,0,1,0,0,1,26
ARUNACHAL PRADESH,2008,Service (Private),0,3,2,0,0,5,0,0,3,0,0,3,8
ARUNACHAL PRADESH,2008,Public Sector Undertaking,0,0,0,0,0,0,0,0,0,0,0,0,0
ARUNACHAL PRADESH,2008,Student,1,1,0,0,0,2,0,3,0,0,0,3,5
ARUNACHAL PRADESH,2008,Unemployed,0,4,6,1,0,11,0,0,1,0,0,1,12
ARUNACHAL PRADESH,2008,Self-employed (Business activity),0,0,0,0,0,0,0,0,0,0,0,0,0
ARUNACHAL PRADESH,2008,Professional Activity,0,0,0,0,0,0,0,0,0,0,0,0,0
ARUNACHAL PRADESH,2008,Farming/Agriculture Activity,0,6,1,5,0,12,0,0,0,0,0,0,12
ARUNACHAL PRADESH,2008,Others (Please Specify),0,19,1,0,0,20,0,10,1,0,0,11,31
ARUNACHAL PRADESH,2008,Retired Person,0,0,0,0,0,0,0,0,0,0,0,0,0
ARUNACHAL PRADESH,2008,Others (Please Specify),1,0,1,0,0,2,0,0,0,0,0,0,2
ARUNACHAL PRADESH,2008,Total,2,43,25,7,0,77,0,19,13,1,0,33,110
ARUNACHAL PRADESH,2008,Total Salaried,0,13,16,1,0,30,0,0,4,0,0,4,34
ARUNACHAL PRADESH,2008,Total Self-employed,0,25,2,5,0,32,0,10,1,0,0,11,43
ARUNACHAL PRADESH,2009,House Wife,0,0,0,0,0,0,0,6,7,1,0,14,14
ARUNACHAL PRADESH,2009,Service (Government),0,10,14,1,0,25,0,0,1,0,0,1,26
ARUNACHAL PRADESH,2009,Service (Private),0,3,2,0,0,5,0,0,3,0,0,3,8
ARUNACHAL PRADESH,2009,Public Sector Undertaking,0,0,0,0,0,0,0,0,0,0,0,0,0
ARUNACHAL PRADESH,2009,Student,1,1,0,0,0,2,0,3,0,0,0,3,5
ARUNACHAL PRADESH,2009,Unemployed,0,4,6,1,0,11,0,0,1,0,0,1,12
ARUNACHAL PRADESH,2009,Self-employed (Business activity),0,0,0,0,0,0,0,0,0,0,0,0,0
ARUNACHAL PRADESH,2009,Professional Activity,0,0,0,0,0,0,0,0,0,0,0,0,0
ARUNACHAL PRADESH,2009,Farming/Agriculture Activity,0,6,1,5,0,12,0,0,0,0,0,0,12
ARUNACHAL PRADESH,2009,Others (Please Specify),0,19,1,0,0,20,0,10,1,0,0,11,31
ARUNACHAL PRADESH,2009,Retired Person,0,0,0,0,0,0,0,0,0,0,0,0,0
ARUNACHAL PRADESH,2009,Others (Please Specify),1,0,1,0,0,2,0,0,0,0,0,0,2
ARUNACHAL PRADESH,2009,Total,2,43,25,7,0,77,0,19,13,1,0,33,110
ARUNACHAL PRADESH,2009,Total Salaried,0,13,16,1,0,30,0,0,4,0,0,4,34
ARUNACHAL PRADESH,2009,Total Self-employed,0,25,2,5,0,32,0,10,1,0,0,11,43
ARUNACHAL PRADESH,2010,House Wife,0,0,0,0,0,0,0,9,7,1,0,17,17
ARUNACHAL PRADESH,2010,Service (Government),0,6,4,1,0,11,0,0,0,0,0,0,11
ARUNACHAL PRADESH,2010,Service (Private),0,3,5,1,0,9,0,0,1,0,0,1,10
ARUNACHAL PRADESH,2010,Public Sector Undertaking,0,0,0,0,0,0,0,0,0,0,0,0,0
ARUNACHAL PRADESH,2010,Student,4,4,0,0,0,8,4,4,0,0,0,8,16
ARUNACHAL PRADESH,2010,Unemployed,0,2,4,0,0,6,0,1,0,0,0,1,7
ARUNACHAL PRADESH,2010,Self-employed (Business activity),0,4,0,0,0,4,0,0,0,0,0,0,4
ARUNACHAL PRADESH,2010,Professional Activity,0,0,0,0,0,0,0,0,0,0,0,0,0
ARUNACHAL PRADESH,2010,Farming/Agriculture Activity,0,7,9,1,1,18,0,0,0,0,0,0,18
ARUNACHAL PRADESH,2010,Others (Please Specify),0,4,4,3,1,12,0,0,0,0,0,0,12
ARUNACHAL PRADESH,2010,Retired Person,0,0,0,0,0,0,0,0,0,0,0,0,0
ARUNACHAL PRADESH,2010,Others (Please Specify),0,17,6,0,0,23,0,12,0,1,0,13,36
ARUNACHAL PRADESH,2010,Total,4,47,32,6,2,91,4,26,8,2,0,40,131
ARUNACHAL PRADESH,2010,Total Salaried,0,9,9,2,0,20,0,0,1,0,0,1,21
ARUNACHAL PRADESH,2010,Total Self-employed,0,15,13,4,2,34,0,0,0,0,0,0,34
ARUNACHAL PRADESH,2011,House Wife,0,0,0,0,0,0,0,11,8,1,1,21,21
ARUNACHAL PRADESH,2011,Service (Government),0,2,9,5,0,16,0,0,0,0,0,0,16
ARUNACHAL PRADESH,2011,Service (Private),0,9,4,1,1,15,0,0,0,0,0,0,15
ARUNACHAL PRADESH,2011,Public Sector Undertaking,0,2,3,4,0,9,0,0,0,0,0,0,9
ARUNACHAL PRADESH,2011,Student,3,7,0,0,0,10,1,4,0,0,0,5,15
ARUNACHAL PRADESH,2011,Unemployed,0,5,2,0,0,7,1,2,0,0,0,3,10
ARUNACHAL PRADESH,2011,Self-employed (Business activity),0,5,1,3,0,9,0,0,0,0,0,0,9
ARUNACHAL PRADESH,2011,Professional Activity,0,0,0,0,0,0,0,0,0,0,0,0,0
ARUNACHAL PRADESH,2011,Farming/Agriculture Activity,0,4,4,3,1,12,0,1,0,0,0,1,13
ARUNACHAL PRADESH,2011,Others (Please Specify),1,4,4,4,0,13,3,1,1,0,0,5,18
ARUNACHAL PRADESH,2011,Retired Person,0,0,0,0,1,1,0,0,0,0,0,0,1
ARUNACHAL PRADESH,2011,Others (Please Specify),0,0,7,0,0,7,0,0,0,0,0,0,7
ARUNACHAL PRADESH,2011,Total,4,38,34,20,3,99,5,19,9,1,1,35,134
ARUNACHAL PRADESH,2011,Total Salaried,0,13,16,10,1,40,0,0,0,0,0,0,40
ARUNACHAL PRADESH,2011,Total Self-employed,1,13,9,10,1,34,3,2,1,0,0,6,40
ARUNACHAL PRADESH,2012,House Wife,0,0,0,0,0,0,0,9,9,1,0,19,19
ARUNACHAL PRADESH,2012,Service (Government),0,1,1,2,0,4,0,5,0,0,0,5,9
ARUNACHAL PRADESH,2012,Service (Private),0,4,13,12,0,29,0,1,0,0,0,1,30
ARUNACHAL PRADESH,2012,Public Sector Undertaking,0,2,0,0,0,2,0,0,0,0,0,0,2
ARUNACHAL PRADESH,2012,Student,1,9,0,0,0,10,0,3,0,0,0,3,13
ARUNACHAL PRADESH,2012,Unemployed,0,3,8,5,0,16,0,0,0,0,0,0,16
ARUNACHAL PRADESH,2012,Self-employed (Business activity),0,0,0,0,0,0,0,0,0,0,0,0,0
ARUNACHAL PRADESH,2012,Professional Activity,0,0,0,0,0,0,0,0,0,0,0,0,0
ARUNACHAL PRADESH,2012,Farming/Agriculture Activity,0,1,7,3,0,11,0,0,0,0,0,0,11
ARUNACHAL PRADESH,2012,Others (Please Specify),0,4,8,6,1,19,0,2,0,0,0,2,21
ARUNACHAL PRADESH,2012,Retired Person,0,0,0,0,0,0,0,0,0,0,0,0,0
ARUNACHAL PRADESH,2012,Others (Please Specify),0,4,2,3,0,9,0,0,0,0,0,0,9
ARUNACHAL PRADESH,2012,Total,1,28,39,31,1,100,0,20,9,1,0,30,130
ARUNACHAL PRADESH,2012,Total Salaried,0,7,14,14,0,35,0,6,0,0,0,6,41
ARUNACHAL PRADESH,2012,Total Self-employed,0,5,15,9,1,30,0,2,0,0,0,2,32
ASSAM,2001,House Wife,0,0,0,0,0,0,0,158,161,68,7,394,394
ASSAM,2001,Service (Government),0,7,25,13,0,45,0,0,2,0,0,2,47
ASSAM,2001,Service (Private),0,46,49,32,4,131,0,13,12,3,0,28,159
ASSAM,2001,Public Sector Undertaking,0,39,28,17,0,84,0,0,2,0,0,2,86
ASSAM,2001,Student,29,86,6,0,0,121,9,55,6,0,0,70,191
ASSAM,2001,Unemployed,0,108,124,59,5,296,0,21,14,3,0,38,334
ASSAM,2001,Self-employed (Business activity),0,59,85,45,10,199,0,12,5,7,0,24,223
ASSAM,2001,Professional Activity,0,16,36,15,0,67,0,1,0,0,0,1,68
ASSAM,2001,Farming/Agriculture Activity,0,30,62,43,9,144,0,7,6,9,1,23,167
ASSAM,2001,Others (Please Specify),1,129,173,123,11,437,5,76,36,12,1,130,567
ASSAM,2001,Retired Person,0,0,0,2,4,6,0,0,0,0,0,0,6
ASSAM,2001,Others (Please Specify),5,100,114,69,18,306,5,40,30,17,7,99,405
ASSAM,2001,Total,35,620,702,418,61,1836,19,383,274,119,16,811,2647
ASSAM,2001,Total Salaried,0,92,102,62,4,260,0,13,16,3,0,32,292
ASSAM,2001,Total Self-employed,1,234,356,226,30,847,5,96,47,28,2,178,1025
ASSAM,2002,House Wife,0,0,0,0,0,0,0,221,178,67,19,485,485
ASSAM,2002,Service (Government),0,4,4,6,0,14,0,1,3,0,0,4,18
ASSAM,2002,Service (Private),0,26,36,15,2,79,0,4,4,4,0,12,91
ASSAM,2002,Public Sector Undertaking,0,25,20,17,2,64,0,5,2,1,0,8,72
ASSAM,2002,Student,7,77,3,1,0,88,10,19,0,0,0,29,117
ASSAM,2002,Unemployed,0,69,127,28,7,231,0,20,6,5,0,31,262
ASSAM,2002,Self-employed (Business activity),0,73,106,60,0,239,0,11,6,3,0,20,259
ASSAM,2002,Professional Activity,0,13,17,12,0,42,0,0,0,0,0,0,42
ASSAM,2002,Farming/Agriculture Activity,0,62,112,69,5,248,0,13,7,3,0,23,271
ASSAM,2002,Others (Please Specify),6,138,151,127,15,437,5,56,40,20,2,123,560
ASSAM,2002,Retired Person,0,0,0,0,6,6,0,0,0,0,0,0,6
ASSAM,2002,Others (Please Specify),10,77,104,46,17,254,9,26,29,5,4,73,327
ASSAM,2002,Total,23,564,680,381,54,1702,24,376,275,108,25,808,2510
ASSAM,2002,Total Salaried,0,55,60,38,4,157,0,10,9,5,0,24,181
ASSAM,2002,Total Self-employed,6,286,386,268,20,966,5,80,53,26,2,166,1132
ASSAM,2003,House Wife,0,0,0,0,0,0,2,183,126,57,13,381,381
ASSAM,2003,Service (Government),0,2,9,4,0,15,0,0,0,0,0,0,15
ASSAM,2003,Service (Private),0,27,26,33,2,88,0,5,1,2,0,8,96
ASSAM,2003,Public Sector Undertaking,0,35,22,15,1,73,0,16,5,1,0,22,95
ASSAM,2003,Student,24,101,4,0,0,129,19,72,0,0,0,91,220
ASSAM,2003,Unemployed,0,40,111,52,2,205,0,28,28,10,1,67,272
ASSAM,2003,Self-employed (Business activity),0,56,72,51,2,181,0,22,2,2,0,26,207
ASSAM,2003,Professional Activity,2,8,17,3,4,34,0,0,0,0,0,0,34
ASSAM,2003,Farming/Agriculture Activity,2,53,56,27,18,156,0,30,1,0,0,31,187
ASSAM,2003,Others (Please Specify),20,270,182,106,17,595,15,98,42,15,13,183,778
ASSAM,2003,Retired Person,0,0,0,0,1,1,0,0,0,0,0,0,1
ASSAM,2003,Others (Please Specify),13,79,58,32,17,199,12,58,20,14,7,111,310
ASSAM,2003,Total,61,671,557,323,64,1676,48,512,225,101,34,920,2596
ASSAM,2003,Total Salaried,0,64,57,52,3,176,0,21,6,3,0,30,206
ASSAM,2003,Total Self-employed,24,387,327,187,41,966,15,150,45,17,13,240,1206
ASSAM,2004,House Wife,0,0,0,0,0,0,0,212,159,70,5,446,446
ASSAM,2004,Service (Government),0,0,4,6,0,10,0,0,1,1,0,2,12
ASSAM,2004,Service (Private),0,31,26,12,0,69,0,2,6,7,0,15,84
ASSAM,2004,Public Sector Undertaking,0,24,16,9,1,50,0,6,7,2,0,15,65
ASSAM,2004,Student,20,89,4,0,0,113,10,50,2,0,0,62,175
ASSAM,2004,Unemployed,0,50,90,86,11,237,0,33,18,10,1,62,299
ASSAM,2004,Self-employed (Business activity),2,118,122,52,6,300,0,16,16,2,0,34,334
ASSAM,2004,Professional Activity,2,47,64,10,1,124,0,0,0,0,0,0,124
ASSAM,2004,Farming/Agriculture Activity,0,83,155,67,11,316,2,8,3,2,0,15,331
ASSAM,2004,Others (Please Specify),14,144,216,117,28,519,4,70,57,13,4,148,667
ASSAM,2004,Retired Person,0,0,0,0,4,4,0,0,0,0,0,0,4
ASSAM,2004,Others (Please Specify),3,105,67,18,10,203,2,49,27,13,4,95,298
ASSAM,2004,Total,41,691,764,377,72,1945,18,446,296,120,14,894,2839
ASSAM,2004,Total Salaried,0,55,46,27,1,129,0,8,14,10,0,32,161
ASSAM,2004,Total Self-employed,18,392,557,246,46,1259,6,94,76,17,4,197,1456
ASSAM,2005,House Wife,0,0,0,0,0,0,0,281,206,76,3,566,566
ASSAM,2005,Service (Government),0,2,6,6,0,14,0,0,0,0,0,0,14
ASSAM,2005,Service (Private),0,17,17,9,0,43,0,8,2,0,0,10,53
ASSAM,2005,Public Sector Undertaking,0,20,17,19,0,56,0,4,0,0,0,4,60
ASSAM,2005,Student,16,87,0,0,0,103,18,33,0,0,0,51,154
ASSAM,2005,Unemployed,0,5,40,33,9,87,0,0,8,1,0,9,96
ASSAM,2005,Self-employed (Business activity),0,112,164,72,2,350,0,14,13,1,1,29,379
ASSAM,2005,Professional Activity,0,15,32,19,0,66,0,0,0,0,3,3,69
ASSAM,2005,Farming/Agriculture Activity,0,60,117,65,14,256,2,16,16,9,0,43,299
ASSAM,2005,Others (Please Specify),11,260,292,119,21,703,11,46,43,19,5,124,827
ASSAM,2005,Retired Person,0,0,0,3,6,9,0,0,0,0,2,2,11
ASSAM,2005,Others (Please Specify),9,65,106,63,21,264,6,23,11,10,4,54,318
ASSAM,2005,Total,36,643,791,408,73,1951,37,425,299,116,18,895,2846
ASSAM,2005,Total Salaried,0,39,40,34,0,113,0,12,2,0,0,14,127
ASSAM,2005,Total Self-employed,11,447,605,275,37,1375,13,76,72,29,9,199,1574
ASSAM,2006,House Wife,0,0,0,0,0,0,0,258,247,68,6,579,579
ASSAM,2006,Service (Government),0,6,6,5,0,17,0,0,0,0,0,0,17
ASSAM,2006,Service (Private),0,14,19,5,0,38,0,4,3,1,0,8,46
ASSAM,2006,Public Sector Undertaking,0,18,10,11,0,39,0,9,5,0,0,14,53
ASSAM,2006,Student,27,127,3,0,0,157,19,32,2,0,0,53,210
ASSAM,2006,Unemployed,0,0,15,24,2,41,0,0,0,0,0,0,41
ASSAM,2006,Self-employed (Business activity),0,148,199,118,1,466,0,28,13,6,0,47,513
ASSAM,2006,Professional Activity,1,26,82,29,0,138,0,0,0,0,0,0,138
ASSAM,2006,Farming/Agriculture Activity,0,82,139,54,20,295,2,2,13,10,0,27,322
ASSAM,2006,Others (Please Specify),9,261,310,106,23,709,4,27,35,14,8,88,797
ASSAM,2006,Retired Person,0,2,1,2,5,10,0,0,0,0,0,0,10
ASSAM,2006,Others (Please Specify),7,69,69,31,30,206,7,53,30,8,1,99,305
ASSAM,2006,Total,44,753,853,385,81,2116,32,413,348,107,15,915,3031
ASSAM,2006,Total Salaried,0,38,35,21,0,94,0,13,8,1,0,22,116
ASSAM,2006,Total Self-employed,10,517,730,307,44,1608,6,57,61,30,8,162,1770
ASSAM,2007,House Wife,0,0,0,0,0,0,0,188,214,95,19,516,516
ASSAM,2007,Service (Government),0,6,7,2,0,15,0,0,2,0,0,2,17
ASSAM,2007,Service (Private),0,9,11,10,0,30,0,7,3,2,0,12,42
ASSAM,2007,Public Sector Undertaking,0,13,52,8,1,74,0,9,8,2,0,19,93
ASSAM,2007,Student,29,90,0,0,0,119,23,62,3,1,1,90,209
ASSAM,2007,Unemployed,0,7,2,15,6,30,0,5,1,0,0,6,36
ASSAM,2007,Self-employed (Business activity),0,105,182,88,2,377,1,35,13,2,0,51,428
ASSAM,2007,Professional Activity,0,30,86,34,0,150,0,0,0,0,0,0,150
ASSAM,2007,Farming/Agriculture Activity,0,90,111,67,8,276,0,0,2,0,0,2,278
ASSAM,2007,Others (Please Specify),1,300,279,233,24,837,5,61,49,9,8,132,969
ASSAM,2007,Retired Person,0,0,0,0,7,7,0,0,0,0,0,0,7
ASSAM,2007,Others (Please Specify),8,54,69,50,20,201,4,60,36,9,7,116,317
ASSAM,2007,Total,38,704,799,507,68,2116,33,427,331,120,35,946,3062
ASSAM,2007,Total Salaried,0,28,70,20,1,119,0,16,13,4,0,33,152
ASSAM,2007,Total Self-employed,1,525,658,422,34,1640,6,96,64,11,8,185,1825
ASSAM,2008,House Wife,0,0,0,0,0,0,0,226,247,89,11,573,573
ASSAM,2008,Service (Government),0,2,13,4,0,19,0,2,0,0,0,2,21
ASSAM,2008,Service (Private),0,16,26,10,0,52,0,12,6,3,0,21,73
ASSAM,2008,Public Sector Undertaking,0,5,28,13,0,46,0,5,1,1,0,7,53
ASSAM,2008,Student,21,108,0,0,0,129,12,65,0,0,0,77,206
ASSAM,2008,Unemployed,0,15,3,19,0,37,0,7,0,0,0,7,44
ASSAM,2008,Self-employed (Business activity),0,117,171,86,1,375,0,35,8,10,1,54,429
ASSAM,2008,Professional Activity,0,33,66,32,2,133,0,0,4,0,0,4,137
ASSAM,2008,Farming/Agriculture Activity,0,70,61,55,6,192,0,5,0,0,0,5,197
ASSAM,2008,Others (Please Specify),2,241,314,156,28,741,1,72,37,9,4,123,864
ASSAM,2008,Retired Person,0,0,0,0,4,4,0,0,0,0,1,1,5
ASSAM,2008,Others (Please Specify),5,109,90,23,15,242,4,74,57,8,2,145,387
ASSAM,2008,Total,28,716,772,398,56,1970,17,503,360,120,19,1019,2989
ASSAM,2008,Total Salaried,0,23,67,27,0,117,0,19,7,4,0,30,147
ASSAM,2008,Total Self-employed,2,461,612,329,37,1441,1,112,49,19,5,186,1627
ASSAM,2009,House Wife,0,0,0,0,0,0,0,222,213,94,12,541,541
ASSAM,2009,Service (Government),0,1,1,3,0,5,0,0,0,0,0,0,5
ASSAM,2009,Service (Private),0,27,13,15,1,56,0,4,2,1,0,7,63
ASSAM,2009,Public Sector Undertaking,0,13,23,14,0,50,0,3,3,8,0,14,64
ASSAM,2009,Student,11,118,0,0,0,129,8,83,0,0,0,91,220
ASSAM,2009,Unemployed,0,3,24,31,0,58,0,3,6,6,0,15,73
ASSAM,2009,Self-employed (Business activity),0,101,164,94,2,361,0,36,16,7,0,59,420
ASSAM,2009,Professional Activity,0,37,69,23,2,131,0,4,5,3,0,12,143
ASSAM,2009,Farming/Agriculture Activity,0,95,137,80,5,317,0,8,7,9,0,24,341
ASSAM,2009,Others (Please Specify),9,210,220,114,31,584,7,107,67,46,11,238,822
ASSAM,2009,Retired Person,0,0,0,3,10,13,0,0,0,0,0,0,13
ASSAM,2009,Others (Please Specify),7,50,61,48,12,178,9,44,21,6,3,83,261
ASSAM,2009,Total,27,655,712,425,63,1882,24,514,340,180,26,1084,2966
ASSAM,2009,Total Salaried,0,41,37,32,1,111,0,7,5,9,0,21,132
ASSAM,2009,Total Self-employed,9,443,590,311,40,1393,7,155,95,65,11,333,1726
ASSAM,2010,House Wife,0,0,0,0,0,0,0,205,146,55,9,415,415
ASSAM,2010,Service (Government),0,2,7,9,0,18,0,1,0,0,0,1,19
ASSAM,2010,Service (Private),0,19,28,10,0,57,0,11,5,0,0,16,73
ASSAM,2010,Public Sector Undertaking,0,19,51,26,2,98,0,2,12,6,0,20,118
ASSAM,2010,Student,20,128,0,0,0,148,14,85,0,0,0,99,247
ASSAM,2010,Unemployed,0,3,28,34,1,66,0,12,2,2,0,16,82
ASSAM,2010,Self-employed (Business activity),0,112,163,95,1,371,0,36,23,11,0,70,441
ASSAM,2010,Professional Activity,0,59,45,29,3,136,0,7,3,0,0,10,146
ASSAM,2010,Farming/Agriculture Activity,0,132,126,82,12,352,0,6,9,1,1,17,369
ASSAM,2010,Others (Please Specify),9,189,219,112,36,565,8,96,83,42,9,238,803
ASSAM,2010,Retired Person,0,0,2,2,6,10,0,0,0,0,0,0,10
ASSAM,2010,Others (Please Specify),5,82,66,43,9,205,10,28,19,5,3,65,270
ASSAM,2010,Total,34,745,735,442,70,2026,32,489,302,122,22,967,2993
ASSAM,2010,Total Salaried,0,40,86,45,2,173,0,14,17,6,0,37,210
ASSAM,2010,Total Self-employed,9,492,553,318,52,1424,8,145,118,54,10,335,1759
ASSAM,2011,House Wife,0,0,0,0,0,0,0,175,214,92,9,490,490
ASSAM,2011,Service (Government),0,5,13,9,0,27,0,0,1,0,0,1,28
ASSAM,2011,Service (Private),0,26,44,16,0,86,0,0,8,4,0,12,98
ASSAM,2011,Public Sector Undertaking,0,17,52,22,0,91,1,4,2,1,0,8,99
ASSAM,2011,Student,8,152,0,0,0,160,3,81,8,0,0,92,252
ASSAM,2011,Unemployed,0,7,15,21,5,48,0,6,5,0,0,11,59
ASSAM,2011,Self-employed (Business activity),0,107,110,63,1,281,0,17,22,1,0,40,321
ASSAM,2011,Professional Activity,0,28,33,24,0,85,0,0,0,0,0,0,85
ASSAM,2011,Farming/Agriculture Activity,0,97,125,70,8,300,0,6,5,0,1,12,312
ASSAM,2011,Others (Please Specify),7,154,216,134,20,531,4,69,35,13,3,124,655
ASSAM,2011,Retired Person,0,0,0,0,3,3,0,0,0,0,0,0,3
ASSAM,2011,Others (Please Specify),5,74,78,49,8,214,2,52,41,15,0,110,324
ASSAM,2011,Total,20,667,686,408,45,1826,10,410,341,126,13,900,2726
ASSAM,2011,Total Salaried,0,48,109,47,0,204,1,4,11,5,0,21,225
ASSAM,2011,Total Self-employed,7,386,484,291,29,1197,4,92,62,14,4,176,1373
ASSAM,2012,House Wife,0,0,0,0,0,0,0,133,175,91,4,403,403
ASSAM,2012,Service (Government),0,1,10,17,1,29,0,12,9,4,0,25,54
ASSAM,2012,Service (Private),0,44,50,28,0,122,0,3,6,2,0,11,133
ASSAM,2012,Public Sector Undertaking,0,25,51,30,1,107,0,4,4,1,0,9,116
ASSAM,2012,Student,6,116,2,0,0,124,7,88,2,0,0,97,221
ASSAM,2012,Unemployed,0,12,12,33,7,64,0,2,1,1,0,4,68
ASSAM,2012,Self-employed (Business activity),0,99,119,102,0,320,0,12,16,5,0,33,353
ASSAM,2012,Professional Activity,0,30,55,24,1,110,0,4,8,3,0,15,125
ASSAM,2012,Farming/Agriculture Activity,2,103,143,80,12,340,0,0,4,0,0,4,344
ASSAM,2012,Others (Please Specify),19,244,424,262,20,969,8,83,60,24,5,180,1149
ASSAM,2012,Retired Person,0,0,0,0,4,4,0,0,0,0,0,0,4
ASSAM,2012,Others (Please Specify),10,21,117,51,4,203,1,21,37,32,0,91,294
ASSAM,2012,Total,37,695,983,627,50,2392,16,362,322,163,9,872,3264
ASSAM,2012,Total Salaried,0,70,111,75,2,258,0,19,19,7,0,45,303
ASSAM,2012,Total Self-employed,21,476,741,468,33,1739,8,99,88,32,5,232,1971
BIHAR,2001,House Wife,0,0,0,0,0,0,0,62,62,13,3,140,140
BIHAR,2001,Service (Government),0,1,4,0,0,5,0,1,0,0,0,1,6
BIHAR,2001,Service (Private),0,11,3,0,1,15,0,3,0,0,0,3,18
BIHAR,2001,Public Sector Undertaking,0,0,1,0,0,1,0,0,0,0,0,0,1
BIHAR,2001,Student,3,34,2,0,0,39,6,17,2,0,0,25,64
BIHAR,2001,Unemployed,1,13,6,1,1,22,2,10,2,2,0,16,38
BIHAR,2001,Self-employed (Business activity),0,2,12,0,0,14,1,0,0,0,0,1,15
BIHAR,2001,Professional Activity,0,2,1,0,0,3,0,0,0,0,0,0,3
BIHAR,2001,Farming/Agriculture Activity,0,19,23,12,1,55,0,4,1,1,0,6,61
BIHAR,2001,Others (Please Specify),3,22,7,1,1,34,0,7,7,0,0,14,48
BIHAR,2001,Retired Person,0,0,0,0,2,2,0,0,0,0,0,0,2
BIHAR,2001,Others (Please Specify),1,27,62,17,10,117,5,49,20,11,5,90,207
BIHAR,2001,Total,8,131,121,31,16,307,14,153,94,27,8,296,603
BIHAR,2001,Total Salaried,0,12,8,0,1,21,0,4,0,0,0,4,25
BIHAR,2001,Total Self-employed,3,45,43,13,2,106,1,11,8,1,0,21,127
BIHAR,2002,House Wife,0,0,0,0,0,0,0,70,52,22,4,148,148
BIHAR,2002,Service (Government),0,0,3,3,0,6,0,0,0,0,0,0,6
BIHAR,2002,Service (Private),0,4,3,0,1,8,0,5,3,0,0,8,16
BIHAR,2002,Public Sector Undertaking,0,0,0,1,0,1,0,0,0,0,0,0,1
BIHAR,2002,Student,5,25,10,0,0,40,6,3,5,0,0,14,54
BIHAR,2002,Unemployed,0,21,31,5,0,57,1,6,4,0,0,11,68
BIHAR,2002,Self-employed (Business activity),0,8,12,6,0,26,0,0,0,0,0,0,26
BIHAR,2002,Professional Activity,0,2,3,0,0,5,0,0,0,0,0,0,5
BIHAR,2002,Farming/Agriculture Activity,0,18,40,8,2,68,0,10,1,1,0,12,80
BIHAR,2002,Others (Please Specify),0,14,26,15,2,57,0,11,4,3,0,18,75
BIHAR,2002,Retired Person,0,0,0,0,1,1,0,0,0,0,0,0,1
BIHAR,2002,Others (Please Specify),18,65,34,30,10,157,6,40,27,9,1,83,240
BIHAR,2002,Total,23,157,162,68,16,426,13,145,96,35,5,294,720
BIHAR,2002,Total Salaried,0,4,6,4,1,15,0,5,3,0,0,8,23
BIHAR,2002,Total Self-employed,0,42,81,29,4,156,0,21,5,4,0,30,186
BIHAR,2003,House Wife,0,0,0,0,0,0,0,75,61,2,0,138,138
BIHAR,2003,Service (Government),0,0,2,1,0,3,0,1,1,0,0,2,5
BIHAR,2003,Service (Private),0,10,9,2,0,21,0,3,3,0,0,6,27
BIHAR,2003,Public Sector Undertaking,0,0,2,1,0,3,0,0,0,0,0,0,3
BIHAR,2003,Student,15,26,0,0,0,41,9,9,0,0,0,18,59
BIHAR,2003,Unemployed,12,20,27,3,0,62,1,5,5,2,0,13,75
BIHAR,2003,Self-employed (Business activity),0,7,2,9,1,19,0,2,0,0,0,2,21
BIHAR,2003,Professional Activity,1,8,7,3,0,19,0,1,5,0,0,6,25
BIHAR,2003,Farming/Agriculture Activity,5,11,15,12,2,45,0,0,1,0,0,1,46
BIHAR,2003,Others (Please Specify),9,21,17,1,0,48,1,10,7,4,0,22,70
BIHAR,2003,Retired Person,0,0,0,1,5,6,0,0,0,0,0,0,6
BIHAR,2003,Others (Please Specify),7,32,23,18,4,84,4,21,7,4,4,40,124
BIHAR,2003,Total,49,135,104,51,12,351,15,127,90,12,4,248,599
BIHAR,2003,Total Salaried,0,10,13,4,0,27,0,4,4,0,0,8,35
BIHAR,2003,Total Self-employed,15,47,41,25,3,131,1,13,13,4,0,31,162
BIHAR,2004,House Wife,0,0,0,0,0,0,0,39,40,9,2,90,90
BIHAR,2004,Service (Government),0,0,4,4,0,8,0,0,0,0,0,0,8
BIHAR,2004,Service (Private),0,4,7,4,0,15,0,0,0,1,0,1,16
BIHAR,2004,Public Sector Undertaking,0,1,6,1,0,8,0,0,0,0,0,0,8
BIHAR,2004,Student,7,14,1,0,0,22,5,5,0,0,0,10,32
BIHAR,2004,Unemployed,5,24,11,3,0,43,1,1,4,1,0,7,50
BIHAR,2004,Self-employed (Business activity),0,7,7,2,0,16,0,4,3,0,0,7,23
BIHAR,2004,Professional Activity,0,2,2,2,0,6,0,0,0,0,0,0,6
BIHAR,2004,Farming/Agriculture Activity,0,4,10,6,3,23,0,0,0,0,0,0,23
BIHAR,2004,Others (Please Specify),0,1,0,1,0,2,0,0,0,0,1,1,3
BIHAR,2004,Retired Person,0,0,11,3,3,17,0,0,0,0,0,0,17
BIHAR,2004,Others (Please Specify),4,18,17,4,9,52,3,10,4,3,3,23,75
BIHAR,2004,Total,16,75,76,30,15,212,9,59,51,14,6,139,351
BIHAR,2004,Total Salaried,0,5,17,9,0,31,0,0,0,1,0,1,32
BIHAR,2004,Total Self-employed,0,14,19,11,3,47,0,4,3,0,1,8,55
BIHAR,2005,House Wife,0,0,0,0,0,0,0,55,38,11,5,109,109
BIHAR,2005,Service (Government),0,0,3,2,0,5,0,1,0,0,0,1,6
BIHAR,2005,Service (Private),0,12,15,7,0,34,0,0,2,0,0,2,36
BIHAR,2005,Public Sector Undertaking,0,1,3,5,0,9,0,0,0,0,0,0,9
BIHAR,2005,Student,7,24,2,0,0,33,3,5,6,0,0,14,47
BIHAR,2005,Unemployed,0,11,5,4,3,23,0,5,0,0,0,5,28
BIHAR,2005,Self-employed (Business activity),0,7,6,4,1,18,0,0,0,0,0,0,18
BIHAR,2005,Professional Activity,0,8,7,4,0,19,0,0,0,0,0,0,19
BIHAR,2005,Farming/Agriculture Activity,1,5,17,8,1,32,0,3,2,2,0,7,39
BIHAR,2005,Others (Please Specify),1,11,9,1,0,22,0,5,2,2,0,9,31
BIHAR,2005,Retired Person,0,0,0,1,1,2,0,1,1,0,0,2,4
BIHAR,2005,Others (Please Specify),5,44,39,34,8,130,2,29,26,8,2,67,197
BIHAR,2005,Total,14,123,106,70,14,327,5,104,77,23,7,216,543
BIHAR,2005,Total Salaried,0,13,21,14,0,48,0,1,2,0,0,3,51
BIHAR,2005,Total Self-employed,2,31,39,17,2,91,0,8,4,4,0,16,107
BIHAR,2006,House Wife,0,0,0,0,0,0,0,56,68,12,1,137,137
BIHAR,2006,Service (Government),0,1,3,2,0,6,0,1,3,0,0,4,10
BIHAR,2006,Service (Private),0,5,9,1,0,15,0,0,0,1,0,1,16
BIHAR,2006,Public Sector Undertaking,0,1,1,0,0,2,0,0,5,0,0,5,7
BIHAR,2006,Student,10,30,3,0,0,43,8,14,5,0,0,27,70
BIHAR,2006,Unemployed,0,8,9,0,1,18,1,4,2,1,0,8,26
BIHAR,2006,Self-employed (Business activity),0,7,8,1,0,16,0,1,7,0,0,8,24
BIHAR,2006,Professional Activity,0,1,2,0,0,3,0,0,0,1,0,1,4
BIHAR,2006,Farming/Agriculture Activity,0,13,21,2,2,38,0,4,4,0,0,8,46
BIHAR,2006,Others (Please Specify),0,13,15,13,1,42,1,13,16,3,0,33,75
BIHAR,2006,Retired Person,0,0,0,0,1,1,0,0,0,0,1,1,2
BIHAR,2006,Others (Please Specify),18,44,31,16,6,115,14,30,19,20,3,86,201
BIHAR,2006,Total,28,123,102,35,11,299,24,123,129,38,5,319,618
BIHAR,2006,Total Salaried,0,7,13,3,0,23,0,1,8,1,0,10,33
BIHAR,2006,Total Self-employed,0,34,46,16,3,99,1,18,27,4,0,50,149
BIHAR,2007,House Wife,0,0,0,0,0,0,0,63,73,29,6,171,171
BIHAR,2007,Service (Government),0,2,2,4,0,8,0,0,0,0,0,0,8
BIHAR,2007,Service (Private),0,12,9,15,0,36,0,0,0,0,0,0,36
BIHAR,2007,Public Sector Undertaking,0,4,5,8,2,19,0,0,0,0,0,0,19
BIHAR,2007,Student,14,34,7,1,0,56,26,32,1,0,0,59,115
BIHAR,2007,Unemployed,0,36,12,14,3,65,0,9,10,0,0,19,84
BIHAR,2007,Self-employed (Business activity),0,2,1,4,1,8,0,2,1,0,0,3,11
BIHAR,2007,Professional Activity,1,1,0,1,0,3,0,0,0,0,0,0,3
BIHAR,2007,Farming/Agriculture Activity,1,29,27,19,2,78,0,0,8,0,0,8,86
BIHAR,2007,Others (Please Specify),1,50,34,25,11,121,3,35,7,14,8,67,188
BIHAR,2007,Retired Person,0,0,0,1,2,3,0,0,0,0,0,0,3
BIHAR,2007,Others (Please Specify),16,42,49,23,7,137,15,55,17,8,9,104,241
BIHAR,2007,Total,33,212,146,115,28,534,44,196,117,51,23,431,965
BIHAR,2007,Total Salaried,0,18,16,27,2,63,0,0,0,0,0,0,63
BIHAR,2007,Total Self-employed,3,82,62,49,14,210,3,37,16,14,8,78,288
BIHAR,2008,House Wife,0,0,0,0,0,0,0,66,88,18,2,174,174
BIHAR,2008,Service (Government),0,3,2,2,1,8,0,0,0,0,0,0,8
BIHAR,2008,Service (Private),0,7,8,15,1,31,0,1,2,1,0,4,35
BIHAR,2008,Public Sector Undertaking,0,10,2,1,0,13,0,9,1,0,0,10,23
BIHAR,2008,Student,9,26,7,0,0,42,3,13,0,0,0,16,58
BIHAR,2008,Unemployed,2,24,17,6,0,49,1,3,0,0,0,4,53
BIHAR,2008,Self-employed (Business activity),0,8,7,0,0,15,0,0,0,0,0,0,15
BIHAR,2008,Professional Activity,0,1,3,1,0,5,0,0,0,0,0,0,5
BIHAR,2008,Farming/Agriculture Activity,0,15,21,21,5,62,0,4,1,0,0,5,67
BIHAR,2008,Others (Please Specify),2,10,13,12,19,56,8,7,26,4,10,55,111
BIHAR,2008,Retired Person,0,0,0,0,9,9,0,0,0,0,6,6,15
BIHAR,2008,Others (Please Specify),22,114,122,39,22,319,21,62,27,17,5,132,451
BIHAR,2008,Total,35,218,202,97,57,609,33,165,145,40,23,406,1015
BIHAR,2008,Total Salaried,0,20,12,18,2,52,0,10,3,1,0,14,66
BIHAR,2008,Total Self-employed,2,34,44,34,24,138,8,11,27,4,10,60,198
BIHAR,2009,House Wife,0,0,0,0,0,0,0,124,154,29,7,314,314
BIHAR,2009,Service (Government),0,2,1,0,0,3,0,0,0,0,0,0,3
BIHAR,2009,Service (Private),0,17,35,3,0,55,0,2,0,0,0,2,57
BIHAR,2009,Public Sector Undertaking,0,1,7,0,0,8,0,0,0,0,0,0,8
BIHAR,2009,Student,7,31,4,0,0,42,5,19,2,0,0,26,68
BIHAR,2009,Unemployed,0,24,19,0,0,43,1,1,6,0,0,8,51
BIHAR,2009,Self-employed (Business activity),0,9,9,6,0,24,0,0,0,0,0,0,24
BIHAR,2009,Professional Activity,0,2,0,1,0,3,0,0,22,0,0,22,25
BIHAR,2009,Farming/Agriculture Activity,0,20,40,23,2,85,0,10,17,0,0,27,112
BIHAR,2009,Others (Please Specify),3,34,33,11,1,82,0,0,4,2,0,6,88
BIHAR,2009,Retired Person,0,0,0,0,0,0,0,0,0,0,0,0,0
BIHAR,2009,Others (Please Specify),12,62,45,31,19,169,19,72,27,10,4,132,301
BIHAR,2009,Total,22,202,193,75,22,514,25,228,232,41,11,537,1051
BIHAR,2009,Total Salaried,0,20,43,3,0,66,0,2,0,0,0,2,68
BIHAR,2009,Total Self-employed,3,65,82,41,3,194,0,10,43,2,0,55,249
BIHAR,2010,House Wife,0,0,0,0,0,0,0,80,89,26,9,204,204
BIHAR,2010,Service (Government),0,6,5,2,0,13,0,2,6,0,0,8,21
BIHAR,2010,Service (Private),0,23,12,5,1,41,2,2,3,1,0,8,49
BIHAR,2010,Public Sector Undertaking,0,2,0,0,0,2,0,0,0,0,0,0,2
BIHAR,2010,Student,12,21,6,0,0,39,14,13,8,0,0,35,74
BIHAR,2010,Unemployed,0,36,28,9,0,73,3,3,6,3,0,15,88
BIHAR,2010,Self-employed (Business activity),0,4,6,2,0,12,0,2,2,0,0,4,16
BIHAR,2010,Professional Activity,0,2,2,1,0,5,0,0,0,0,0,0,5
BIHAR,2010,Farming/Agriculture Activity,0,27,39,20,5,91,0,3,1,0,0,4,95
BIHAR,2010,Others (Please Specify),12,49,108,80,15,264,7,17,25,2,0,51,315
BIHAR,2010,Retired Person,0,0,0,0,1,1,0,0,0,0,2,2,3
BIHAR,2010,Others (Please Specify),16,58,66,17,14,171,28,105,19,21,10,183,354
BIHAR,2010,Total,40,228,272,136,36,712,54,227,159,53,21,514,1226
BIHAR,2010,Total Salaried,0,31,17,7,1,56,2,4,9,1,0,16,72
BIHAR,2010,Total Self-employed,12,82,155,103,20,372,7,22,28,2,0,59,431
BIHAR,2011,House Wife,0,0,0,0,0,0,0,71,55,9,3,138,138
BIHAR,2011,Service (Government),0,3,5,1,0,9,0,10,9,1,0,20,29
BIHAR,2011,Service (Private),0,2,3,3,1,9,0,0,0,0,0,0,9
BIHAR,2011,Public Sector Undertaking,0,1,1,1,0,3,0,0,0,0,0,0,3
BIHAR,2011,Student,5,27,4,0,0,36,5,28,2,0,0,35,71
BIHAR,2011,Unemployed,0,14,22,12,1,49,0,5,2,0,0,7,56
BIHAR,2011,Self-employed (Business activity),0,1,4,4,0,9,0,0,0,0,0,0,9
BIHAR,2011,Professional Activity,0,2,2,3,0,7,0,0,0,0,0,0,7
BIHAR,2011,Farming/Agriculture Activity,0,11,27,19,6,63,0,0,20,0,0,20,83
BIHAR,2011,Others (Please Specify),3,21,13,13,4,54,8,9,10,1,0,28,82
BIHAR,2011,Retired Person,0,0,0,1,3,4,0,0,0,0,0,0,4
BIHAR,2011,Others (Please Specify),8,68,82,31,14,203,28,26,28,8,11,101,304
BIHAR,2011,Total,16,150,163,88,29,446,41,149,126,19,14,349,795
BIHAR,2011,Total Salaried,0,6,9,5,1,21,0,10,9,1,0,20,41
BIHAR,2011,Total Self-employed,3,35,46,39,10,133,8,9,30,1,0,48,181
BIHAR,2012,House Wife,0,0,0,0,0,0,0,59,55,11,5,130,130
BIHAR,2012,Service (Government),0,0,2,10,0,12,0,1,2,0,0,3,15
BIHAR,2012,Service (Private),0,12,5,4,1,22,0,2,0,0,0,2,24
BIHAR,2012,Public Sector Undertaking,0,0,0,0,0,0,0,0,0,0,0,0,0
BIHAR,2012,Student,1,29,6,0,0,36,1,22,5,0,0,28,64
BIHAR,2012,Unemployed,0,3,9,1,0,13,0,0,0,1,0,1,14
BIHAR,2012,Self-employed (Business activity),0,1,2,0,0,3,0,0,0,0,0,0,3
BIHAR,2012,Professional Activity,0,1,0,0,0,1,0,0,0,0,0,0,1
BIHAR,2012,Farming/Agriculture Activity,0,20,30,9,5,64,0,4,0,0,0,4,68
BIHAR,2012,Others (Please Specify),0,16,18,8,1,43,0,6,3,2,1,12,55
BIHAR,2012,Retired Person,0,0,0,0,1,1,0,0,0,0,0,0,1
BIHAR,2012,Others (Please Specify),4,73,140,31,12,260,5,41,58,15,5,124,384
BIHAR,2012,Total,5,155,212,63,20,455,6,135,123,29,11,304,759
BIHAR,2012,Total Salaried,0,12,7,14,1,34,0,3,2,0,0,5,39
BIHAR,2012,Total Self-employed,0,38,50,17,6,111,0,10,3,2,1,16,127
CHHATTISGARH,2001,House Wife,0,0,0,0,0,0,3,301,202,74,26,606,606
CHHATTISGARH,2001,Service (Government),0,11,36,15,1,63,0,4,2,1,0,7,70
CHHATTISGARH,2001,Service (Private),0,47,81,33,6,167,1,6,2,1,0,10,177
CHHATTISGARH,2001,Public Sector Undertaking,0,9,31,16,3,59,0,2,3,1,0,6,65
CHHATTISGARH,2001,Student,17,100,17,0,0,134,23,69,3,0,0,95,229
CHHATTISGARH,2001,Unemployed,0,100,69,17,7,193,0,19,6,0,0,25,218
CHHATTISGARH,2001,Self-employed (Business activity),1,21,30,9,5,66,0,2,0,0,0,2,68
CHHATTISGARH,2001,Professional Activity,0,12,14,4,2,32,0,2,2,0,0,4,36
CHHATTISGARH,2001,Farming/Agriculture Activity,8,286,429,302,173,1198,5,81,92,51,25,254,1452
CHHATTISGARH,2001,Others (Please Specify),10,133,142,106,53,444,6,74,61,45,26,212,656
CHHATTISGARH,2001,Retired Person,0,8,3,0,2,13,0,0,0,0,0,0,13
CHHATTISGARH,2001,Others (Please Specify),8,65,103,61,34,271,11,74,45,20,14,164,435
CHHATTISGARH,2001,Total,44,792,955,563,286,2640,49,634,418,193,91,1385,4025
CHHATTISGARH,2001,Total Salaried,0,67,148,64,10,289,1,12,7,3,0,23,312
CHHATTISGARH,2001,Total Self-employed,19,452,615,421,233,1740,11,159,155,96,51,472,2212
CHHATTISGARH,2002,House Wife,0,0,0,0,0,0,2,271,210,76,26,585,585
CHHATTISGARH,2002,Service (Government),0,6,34,12,0,52,0,5,7,0,0,12,64
CHHATTISGARH,2002,Service (Private),1,29,56,23,1,110,0,6,5,0,3,14,124
CHHATTISGARH,2002,Public Sector Undertaking,0,17,33,22,9,81,0,3,5,2,0,10,91
CHHATTISGARH,2002,Student,29,87,4,2,0,122,18,51,0,0,0,69,191
CHHATTISGARH,2002,Unemployed,1,97,59,18,4,179,0,25,8,0,0,33,212
CHHATTISGARH,2002,Self-employed (Business activity),0,22,30,11,1,64,0,0,0,0,0,0,64
CHHATTISGARH,2002,Professional Activity,0,17,13,9,2,41,0,9,2,0,0,11,52
CHHATTISGARH,2002,Farming/Agriculture Activity,8,311,357,296,82,1054,0,74,61,40,9,184,1238
CHHATTISGARH,2002,Others (Please Specify),22,69,169,111,38,409,5,58,67,36,19,185,594
CHHATTISGARH,2002,Retired Person,0,0,0,0,7,7,0,0,0,0,0,0,7
CHHATTISGARH,2002,Others (Please Specify),24,139,173,102,72,510,37,92,45,28,16,218,728
CHHATTISGARH,2002,Total,85,794,928,606,216,2629,62,594,410,182,73,1321,3950
CHHATTISGARH,2002,Total Salaried,1,52,123,57,10,243,0,14,17,2,3,36,279
CHHATTISGARH,2002,Total Self-employed,30,419,569,427,123,1568,5,141,130,76,28,380,1948
CHHATTISGARH,2003,House Wife,0,0,0,0,0,0,3,248,187,80,33,551,551
CHHATTISGARH,2003,Service (Government),0,10,27,17,0,54,0,1,2,0,0,3,57
CHHATTISGARH,2003,Service (Private),0,36,39,27,3,105,0,7,5,3,0,15,120
CHHATTISGARH,2003,Public Sector Undertaking,0,6,14,6,0,26,0,0,0,0,0,0,26
CHHATTISGARH,2003,Student,31,88,6,0,0,125,19,61,0,0,0,80,205
CHHATTISGARH,2003,Unemployed,7,85,56,12,0,160,1,12,7,4,0,24,184
CHHATTISGARH,2003,Self-employed (Business activity),0,15,21,12,4,52,0,4,1,0,0,5,57
CHHATTISGARH,2003,Professional Activity,1,32,43,19,2,97,0,13,14,3,1,31,128
CHHATTISGARH,2003,Farming/Agriculture Activity,11,230,309,220,89,859,28,104,55,17,3,207,1066
CHHATTISGARH,2003,Others (Please Specify),29,143,145,123,46,486,13,57,35,24,10,139,625
CHHATTISGARH,2003,Retired Person,0,0,1,1,2,4,0,0,0,0,0,0,4
CHHATTISGARH,2003,Others (Please Specify),24,201,217,117,65,624,42,115,67,30,18,272,896
CHHATTISGARH,2003,Total,103,846,878,554,211,2592,106,622,373,161,65,1327,3919
CHHATTISGARH,2003,Total Salaried,0,52,80,50,3,185,0,8,7,3,0,18,203
CHHATTISGARH,2003,Total Self-employed,41,420,518,374,141,1494,41,178,105,44,14,382,1876
CHHATTISGARH,2004,House Wife,0,0,0,0,0,0,1,358,264,114,40,777,777
CHHATTISGARH,2004,Service (Government),0,7,17,10,1,35,0,1,1,0,0,2,37
CHHATTISGARH,2004,Service (Private),0,25,31,22,2,80,0,0,0,2,0,2,82
CHHATTISGARH,2004,Public Sector Undertaking,0,3,7,5,0,15,0,1,0,0,0,1,16
CHHATTISGARH,2004,Student,20,112,6,0,0,138,27,61,0,0,0,88,226
CHHATTISGARH,2004,Unemployed,5,97,55,4,0,161,0,2,1,0,0,3,164
CHHATTISGARH,2004,Self-employed (Business activity),0,19,12,14,0,45,0,0,0,0,0,0,45
CHHATTISGARH,2004,Professional Activity,0,9,20,14,4,47,0,4,1,0,1,6,53
CHHATTISGARH,2004,Farming/Agriculture Activity,3,312,475,303,120,1213,0,64,56,44,18,182,1395
CHHATTISGARH,2004,Others (Please Specify),9,102,258,222,92,683,10,53,71,42,14,190,873
CHHATTISGARH,2004,Retired Person,0,0,0,0,0,0,0,0,0,0,0,0,0
CHHATTISGARH,2004,Others (Please Specify),40,193,176,113,47,569,54,110,66,23,5,258,827
CHHATTISGARH,2004,Total,77,879,1057,707,266,2986,92,654,460,225,78,1509,4495
CHHATTISGARH,2004,Total Salaried,0,35,55,37,3,130,0,2,1,2,0,5,135
CHHATTISGARH,2004,Total Self-employed,12,442,765,553,216,1988,10,121,128,86,33,378,2366
CHHATTISGARH,2005,House Wife,0,0,0,0,0,0,8,433,283,115,52,891,891
CHHATTISGARH,2005,Service (Government),0,27,18,12,1,58,0,3,1,1,1,6,64
CHHATTISGARH,2005,Service (Private),14,48,64,44,8,178,2,6,7,2,0,17,195
CHHATTISGARH,2005,Public Sector Undertaking,0,20,11,2,0,33,0,9,3,3,0,15,48
CHHATTISGARH,2005,Student,19,91,6,0,0,116,21,46,5,0,0,72,188
CHHATTISGARH,2005,Unemployed,17,139,50,17,5,228,3,10,7,4,1,25,253
CHHATTISGARH,2005,Self-employed (Business activity),13,36,43,43,12,147,1,13,7,5,1,27,174
CHHATTISGARH,2005,Professional Activity,13,33,50,27,8,131,1,4,2,2,0,9,140
CHHATTISGARH,2005,Farming/Agriculture Activity,6,301,490,309,94,1200,0,81,76,44,11,212,1412
CHHATTISGARH,2005,Others (Please Specify),24,83,180,82,41,410,8,41,42,15,11,117,527
CHHATTISGARH,2005,Retired Person,0,7,1,0,3,11,0,0,0,0,1,1,12
CHHATTISGARH,2005,Others (Please Specify),54,277,261,140,61,793,29,96,32,18,9,184,977
CHHATTISGARH,2005,Total,160,1062,1174,676,233,3305,73,742,465,209,87,1576,4881
CHHATTISGARH,2005,Total Salaried,14,95,93,58,9,269,2,18,11,6,1,38,307
CHHATTISGARH,2005,Total Self-employed,56,453,763,461,155,1888,10,139,127,66,23,365,2253
CHHATTISGARH,2006,House Wife,0,0,0,0,0,0,3,393,248,83,45,772,772
CHHATTISGARH,2006,Service (Government),0,6,13,11,1,31,0,1,2,1,0,4,35
CHHATTISGARH,2006,Service (Private),0,24,60,43,0,127,0,4,5,0,0,9,136
CHHATTISGARH,2006,Public Sector Undertaking,0,0,14,2,0,16,0,0,1,0,0,1,17
CHHATTISGARH,2006,Student,23,84,0,0,0,107,16,69,0,0,0,85,192
CHHATTISGARH,2006,Unemployed,0,93,41,10,0,144,1,5,1,1,0,8,152
CHHATTISGARH,2006,Self-employed (Business activity),0,29,63,17,4,113,0,12,2,8,0,22,135
CHHATTISGARH,2006,Professional Activity,1,25,38,13,6,83,0,0,0,0,0,0,83
CHHATTISGARH,2006,Farming/Agriculture Activity,6,377,481,245,103,1212,20,115,83,41,12,271,1483
CHHATTISGARH,2006,Others (Please Specify),24,179,178,105,21,507,17,84,28,23,4,156,663
CHHATTISGARH,2006,Retired Person,0,0,0,0,1,1,0,0,0,0,0,0,1
CHHATTISGARH,2006,Others (Please Specify),58,250,197,144,70,719,39,92,58,31,18,238,957
CHHATTISGARH,2006,Total,112,1067,1085,590,206,3060,96,775,428,188,79,1566,4626
CHHATTISGARH,2006,Total Salaried,0,30,87,56,1,174,0,5,8,1,0,14,188
CHHATTISGARH,2006,Total Self-employed,31,610,760,380,134,1915,37,211,113,72,16,449,2364
CHHATTISGARH,2007,House Wife,0,0,0,0,0,0,3,423,270,106,46,848,848
CHHATTISGARH,2007,Service (Government),0,9,12,13,0,34,0,1,3,0,0,4,38
CHHATTISGARH,2007,Service (Private),0,74,83,51,5,213,0,9,9,2,0,20,233
CHHATTISGARH,2007,Public Sector Undertaking,0,8,11,3,0,22,0,1,1,0,0,2,24
CHHATTISGARH,2007,Student,32,94,46,0,0,172,26,78,3,0,0,107,279
CHHATTISGARH,2007,Unemployed,0,119,43,11,4,177,1,9,4,0,0,14,191
CHHATTISGARH,2007,Self-employed (Business activity),0,36,64,24,8,132,0,1,2,0,0,3,135
CHHATTISGARH,2007,Professional Activity,0,31,43,18,11,103,0,2,2,1,1,6,109
CHHATTISGARH,2007,Farming/Agriculture Activity,2,359,458,310,135,1264,5,136,96,78,14,329,1593
CHHATTISGARH,2007,Others (Please Specify),2,131,151,139,87,510,4,43,65,28,14,154,664
CHHATTISGARH,2007,Retired Person,0,0,0,1,1,2,0,0,0,0,0,0,2
CHHATTISGARH,2007,Others (Please Specify),42,186,212,118,69,627,20,28,21,17,10,96,723
CHHATTISGARH,2007,Total,78,1047,1123,688,320,3256,59,731,476,232,85,1583,4839
CHHATTISGARH,2007,Total Salaried,0,91,106,67,5,269,0,11,13,2,0,26,295
CHHATTISGARH,2007,Total Self-employed,4,557,716,491,241,2009,9,182,165,107,29,492,2501
CHHATTISGARH,2008,House Wife,0,0,0,0,0,0,2,499,275,125,36,937,937
CHHATTISGARH,2008,Service (Government),0,9,17,13,0,39,0,6,0,0,0,6,45
CHHATTISGARH,2008,Service (Private),0,71,77,29,6,183,0,9,6,3,0,18,201
CHHATTISGARH,2008,Public Sector Undertaking,0,1,6,3,0,10,0,0,0,0,0,0,10
CHHATTISGARH,2008,Student,37,162,2,1,0,202,35,130,3,0,0,168,370
CHHATTISGARH,2008,Unemployed,0,86,65,16,0,167,0,6,2,2,0,10,177
CHHATTISGARH,2008,Self-employed (Business activity),0,51,63,33,6,153,0,4,0,0,0,4,157
CHHATTISGARH,2008,Professional Activity,0,27,26,19,8,80,0,0,11,2,0,13,93
CHHATTISGARH,2008,Farming/Agriculture Activity,9,436,576,346,124,1491,20,101,107,46,8,282,1773
CHHATTISGARH,2008,Others (Please Specify),13,213,242,149,45,662,11,82,45,17,9,164,826
CHHATTISGARH,2008,Retired Person,0,0,0,2,0,2,0,0,0,0,0,0,2
CHHATTISGARH,2008,Others (Please Specify),6,69,82,74,28,259,14,17,29,23,12,95,354
CHHATTISGARH,2008,Total,65,1125,1156,685,217,3248,82,854,478,218,65,1697,4945
CHHATTISGARH,2008,Total Salaried,0,81,100,45,6,232,0,15,6,3,0,24,256
CHHATTISGARH,2008,Total Self-employed,22,727,907,547,183,2386,31,187,163,65,17,463,2849
CHHATTISGARH,2009,House Wife,0,0,0,0,0,0,4,466,299,99,34,902,902
CHHATTISGARH,2009,Service (Government),0,19,14,9,0,42,0,5,1,0,0,6,48
CHHATTISGARH,2009,Service (Private),0,89,101,54,5,249,0,31,11,3,0,45,294
CHHATTISGARH,2009,Public Sector Undertaking,0,5,7,5,0,17,0,0,0,0,0,0,17
CHHATTISGARH,2009,Student,59,228,11,0,0,298,33,99,5,0,0,137,435
CHHATTISGARH,2009,Unemployed,4,159,204,87,7,461,4,5,18,1,0,28,489
CHHATTISGARH,2009,Self-employed (Business activity),0,34,31,33,6,104,0,1,2,1,0,4,108
CHHATTISGARH,2009,Professional Activity,0,33,56,39,3,131,0,3,2,1,0,6,137
CHHATTISGARH,2009,Farming/Agriculture Activity,9,364,496,412,136,1417,3,144,115,97,26,385,1802
CHHATTISGARH,2009,Others (Please Specify),4,153,218,209,99,683,3,59,76,32,8,178,861
CHHATTISGARH,2009,Retired Person,0,0,0,0,6,6,0,0,0,0,3,3,9
CHHATTISGARH,2009,Others (Please Specify),28,141,204,89,84,546,29,60,58,57,31,235,781
CHHATTISGARH,2009,Total,104,1225,1342,937,346,3954,76,873,587,291,102,1929,5883
CHHATTISGARH,2009,Total Salaried,0,113,122,68,5,308,0,36,12,3,0,51,359
CHHATTISGARH,2009,Total Self-employed,13,584,801,693,244,2335,6,207,195,131,34,573,2908
CHHATTISGARH,2010,House Wife,0,0,0,0,0,0,2,453,286,91,30,862,862
CHHATTISGARH,2010,Service (Government),0,8,16,14,0,38,0,1,0,1,0,2,40
CHHATTISGARH,2010,Service (Private),0,127,103,55,2,287,0,22,18,2,2,44,331
CHHATTISGARH,2010,Public Sector Undertaking,0,16,13,15,0,44,0,0,0,0,0,0,44
CHHATTISGARH,2010,Student,47,166,9,1,0,223,24,125,5,0,0,154,377
CHHATTISGARH,2010,Unemployed,4,177,306,104,2,593,2,13,4,0,0,19,612
CHHATTISGARH,2010,Self-employed (Business activity),0,42,31,18,7,98,0,2,4,0,0,6,104
CHHATTISGARH,2010,Professional Activity,0,86,95,40,10,231,0,2,1,1,0,4,235
CHHATTISGARH,2010,Farming/Agriculture Activity,3,196,274,219,86,778,2,65,137,103,41,348,1126
CHHATTISGARH,2010,Others (Please Specify),0,294,423,411,175,1303,5,93,113,47,26,284,1587
CHHATTISGARH,2010,Retired Person,0,0,0,0,1,1,0,0,0,0,0,0,1
CHHATTISGARH,2010,Others (Please Specify),56,272,268,225,128,949,23,86,79,47,19,254,1203
CHHATTISGARH,2010,Total,110,1384,1538,1102,411,4545,58,862,647,292,118,1977,6522
CHHATTISGARH,2010,Total Salaried,0,151,132,84,2,369,0,23,18,3,2,46,415
CHHATTISGARH,2010,Total Self-employed,3,618,823,688,278,2410,7,162,255,151,67,642,3052
CHHATTISGARH,2011,House Wife,0,0,0,0,0,0,3,384,239,121,28,775,775
CHHATTISGARH,2011,Service (Government),0,19,21,5,1,46,1,4,3,0,0,8,54
CHHATTISGARH,2011,Service (Private),2,135,120,59,5,321,2,42,31,8,6,89,410
CHHATTISGARH,2011,Public Sector Undertaking,0,12,20,29,0,61,0,3,6,2,0,11,72
CHHATTISGARH,2011,Student,40,152,9,0,0,201,31,130,0,0,0,161,362
CHHATTISGARH,2011,Unemployed,3,182,246,146,15,592,0,18,11,3,2,34,626
CHHATTISGARH,2011,Self-employed (Business activity),0,65,81,55,17,218,0,1,4,4,1,10,228
CHHATTISGARH,2011,Professional Activity,0,64,51,32,7,154,0,34,16,6,0,56,210
CHHATTISGARH,2011,Farming/Agriculture Activity,0,0,0,0,0,0,0,0,0,0,0,0,0
CHHATTISGARH,2011,Others (Please Specify),16,493,674,530,242,1955,13,220,214,153,57,657,2612
CHHATTISGARH,2011,Retired Person,0,5,3,4,7,19,0,0,0,0,0,0,19
CHHATTISGARH,2011,Others (Please Specify),41,301,276,221,121,960,36,152,114,79,47,428,1388
CHHATTISGARH,2011,Total,102,1428,1501,1081,415,4527,86,988,638,376,141,2229,6756
CHHATTISGARH,2011,Total Salaried,2,166,161,93,6,428,3,49,40,10,6,108,536
CHHATTISGARH,2011,Total Self-employed,16,622,806,617,266,2327,13,255,234,163,58,723,3050
CHHATTISGARH,2012,House Wife,0,0,0,0,0,0,0,353,262,125,39,779,779
CHHATTISGARH,2012,Service (Government),0,6,22,34,0,62,0,3,1,0,0,4,66
CHHATTISGARH,2012,Service (Private),4,133,109,85,20,351,2,25,18,9,1,55,406
CHHATTISGARH,2012,Public Sector Undertaking,0,0,4,6,0,10,0,0,0,0,0,0,10
CHHATTISGARH,2012,Student,13,145,3,0,0,161,25,103,1,0,0,129,290
CHHATTISGARH,2012,Unemployed,0,108,131,94,8,341,0,11,3,2,2,18,359
CHHATTISGARH,2012,Self-employed (Business activity),0,33,51,19,3,106,0,2,2,0,0,4,110
CHHATTISGARH,2012,Professional Activity,0,72,75,63,19,229,0,0,0,0,0,0,229
CHHATTISGARH,2012,Farming/Agriculture Activity,0,1,2,1,0,4,0,0,0,0,0,0,4
CHHATTISGARH,2012,Others (Please Specify),14,416,549,432,93,1504,16,139,87,55,25,322,1826
CHHATTISGARH,2012,Retired Person,0,0,0,6,11,17,0,0,0,0,0,0,17
CHHATTISGARH,2012,Others (Please Specify),52,390,448,179,160,1229,35,130,69,41,54,329,1558
CHHATTISGARH,2012,Total,83,1304,1394,919,314,4014,78,766,443,232,121,1640,5654
CHHATTISGARH,2012,Total Salaried,4,139,135,125,20,423,2,28,19,9,1,59,482
CHHATTISGARH,2012,Total Self-employed,14,522,677,515,115,1843,16,141,89,55,25,326,2169
GOA,2001,House Wife,0,0,0,0,0,0,0,11,24,6,14,55,55
GOA,2001,Service (Government),0,0,2,2,0,4,0,0,1,0,1,2,6
GOA,2001,Service (Private),0,11,29,6,0,46,0,5,1,0,0,6,52
GOA,2001,Public Sector Undertaking,0,0,0,0,0,0,0,0,0,0,0,0,0
GOA,2001,Student,0,4,0,0,0,4,3,6,0,0,0,9,13
GOA,2001,Unemployed,0,17,21,3,3,44,0,6,4,0,0,10,54
GOA,2001,Self-employed (Business activity),0,1,2,6,1,10,0,0,0,0,0,0,10
GOA,2001,Professional Activity,0,0,2,0,0,2,0,0,0,0,0,0,2
GOA,2001,Farming/Agriculture Activity,0,1,4,9,4,18,0,0,0,0,0,0,18
GOA,2001,Others (Please Specify),0,4,5,2,0,11,0,2,0,0,2,4,15
GOA,2001,Retired Person,0,0,0,0,3,3,0,0,0,0,0,0,3
GOA,2001,Others (Please Specify),0,5,8,7,5,25,0,0,2,0,1,3,28
GOA,2001,Total,0,43,73,35,16,167,3,30,32,6,18,89,256
GOA,2001,Total Salaried,0,11,31,8,0,50,0,5,2,0,1,8,58
GOA,2001,Total Self-employed,0,6,13,17,5,41,0,2,0,0,2,4,45
GOA,2002,House Wife,0,0,0,0,0,0,0,17,13,6,6,42,42
GOA,2002,Service (Government),0,0,2,2,0,4,0,0,3,0,0,3,7
GOA,2002,Service (Private),0,21,25,9,0,55,0,3,4,1,0,8,63
GOA,2002,Public Sector Undertaking,0,0,3,1,0,4,0,0,0,0,0,0,4
GOA,2002,Student,0,8,0,0,0,8,2,7,0,0,0,9,17
GOA,2002,Unemployed,0,21,26,15,3,65,0,5,2,1,0,8,73
GOA,2002,Self-employed (Business activity),0,2,6,3,0,11,0,0,0,0,0,0,11
GOA,2002,Professional Activity,0,0,0,1,1,2,0,0,0,0,0,0,2
GOA,2002,Farming/Agriculture Activity,0,2,4,3,0,9,0,1,1,0,0,2,11
GOA,2002,Others (Please Specify),0,2,7,4,4,17,0,0,0,0,0,0,17
GOA,2002,Retired Person,0,0,0,1,4,5,0,0,0,0,0,0,5
GOA,2002,Others (Please Specify),0,17,17,7,5,46,0,7,3,1,0,11,57
GOA,2002,Total,0,73,90,46,17,226,2,40,26,9,6,83,309
GOA,2002,Total Salaried,0,21,30,12,0,63,0,3,7,1,0,11,74
GOA,2002,Total Self-employed,0,6,17,11,5,39,0,1,1,0,0,2,41
GOA,2003,House Wife,0,0,0,0,0,0,0,27,12,8,2,49,49
GOA,2003,Service (Government),0,0,6,1,0,7,0,0,1,0,0,1,8
GOA,2003,Service (Private),0,15,32,15,0,62,0,7,2,1,0,10,72
GOA,2003,Public Sector Undertaking,0,0,1,0,0,1,0,0,0,0,0,0,1
GOA,2003,Student,0,11,1,0,0,12,3,4,0,0,0,7,19
GOA,2003,Unemployed,0,17,26,2,2,47,0,10,1,0,0,11,58
GOA,2003,Self-employed (Business activity),0,6,7,3,0,16,0,0,1,1,0,2,18
GOA,2003,Professional Activity,0,1,1,0,0,2,0,0,1,0,0,1,3
GOA,2003,Farming/Agriculture Activity,0,1,3,9,4,17,0,0,0,1,0,1,18
GOA,2003,Others (Please Specify),0,1,8,7,1,17,0,0,0,0,1,1,18
GOA,2003,Retired Person,0,0,0,0,0,0,0,0,0,0,0,0,0
GOA,2003,Others (Please Specify),0,9,11,5,7,32,1,3,0,0,0,4,36
GOA,2003,Total,0,61,96,42,14,213,4,51,18,11,3,87,300
GOA,2003,Total Salaried,0,15,39,16,0,70,0,7,3,1,0,11,81
GOA,2003,Total Self-employed,0,9,19,19,5,52,0,0,2,2,1,5,57
GOA,2004,House Wife,0,0,0,0,0,0,0,19,22,10,4,55,55
GOA,2004,Service (Government),0,1,4,2,0,7,0,0,1,2,0,3,10
GOA,2004,Service (Private),0,11,19,9,0,39,0,6,0,1,0,7,46
GOA,2004,Public Sector Undertaking,0,4,3,3,0,10,0,0,3,0,0,3,13
GOA,2004,Student,2,11,0,0,0,13,3,7,0,0,0,10,23
GOA,2004,Unemployed,0,20,19,8,1,48,0,9,1,0,1,11,59
GOA,2004,Self-employed (Business activity),0,6,4,2,0,12,0,1,1,0,0,2,14
GOA,2004,Professional Activity,0,0,1,0,0,1,0,1,0,0,0,1,2
GOA,2004,Farming/Agriculture Activity,0,0,2,5,0,7,0,0,1,0,0,1,8
GOA,2004,Others (Please Specify),0,2,5,2,1,10,0,0,0,0,0,0,10
GOA,2004,Retired Person,0,0,0,2,1,3,0,0,0,0,0,0,3
GOA,2004,Others (Please Specify),4,18,25,11,4,62,2,3,2,1,1,9,71
GOA,2004,Total,6,73,82,44,7,212,5,46,31,14,6,102,314
GOA,2004,Total Salaried,0,16,26,14,0,56,0,6,4,3,0,13,69
GOA,2004,Total Self-employed,0,8,12,9,1,30,0,2,2,0,0,4,34
GOA,2005,House Wife,0,0,0,0,0,0,0,18,8,13,8,47,47
GOA,2005,Service (Government),0,2,3,2,0,7,0,0,0,0,0,0,7
GOA,2005,Service (Private),0,13,25,8,0,46,0,4,2,0,0,6,52
GOA,2005,Public Sector Undertaking,0,2,3,1,0,6,0,0,0,0,0,0,6
GOA,2005,Student,2,6,0,0,0,8,1,6,0,0,0,7,15
GOA,2005,Unemployed,0,15,17,8,5,45,0,10,1,1,1,13,58
GOA,2005,Self-employed (Business activity),0,2,3,3,0,8,0,0,1,0,0,1,9
GOA,2005,Professional Activity,0,1,0,0,0,1,0,0,0,0,0,0,1
GOA,2005,Farming/Agriculture Activity,0,0,4,2,4,10,0,0,0,0,1,1,11
GOA,2005,Others (Please Specify),0,2,7,2,2,13,0,0,1,0,0,1,14
GOA,2005,Retired Person,0,0,0,3,1,4,0,0,0,0,1,1,5
GOA,2005,Others (Please Specify),0,11,23,11,4,49,1,4,2,1,0,8,57
GOA,2005,Total,2,54,85,40,16,197,2,42,15,15,11,85,282
GOA,2005,Total Salaried,0,17,31,11,0,59,0,4,2,0,0,6,65
GOA,2005,Total Self-employed,0,5,14,7,6,32,0,0,2,0,1,3,35
GOA,2006,House Wife,0,0,0,0,0,0,0,12,16,13,10,51,51
GOA,2006,Service (Government),0,2,1,0,0,3,0,0,0,0,0,0,3
GOA,2006,Service (Private),0,20,18,11,0,49,0,3,1,0,0,4,53
GOA,2006,Public Sector Undertaking,0,0,0,0,0,0,0,0,0,0,0,0,0
GOA,2006,Student,1,7,0,0,0,8,4,8,0,0,0,12,20
GOA,2006,Unemployed,0,19,22,8,2,51,0,10,2,0,0,12,63
GOA,2006,Self-employed (Business activity),0,2,2,5,0,9,0,0,0,0,0,0,9
GOA,2006,Professional Activity,0,0,0,0,0,0,0,0,0,0,0,0,0
GOA,2006,Farming/Agriculture Activity,0,0,5,0,0,5,0,0,0,0,0,0,5
GOA,2006,Others (Please Specify),0,1,5,4,3,13,0,1,0,0,0,1,14
GOA,2006,Retired Person,0,0,0,2,6,8,0,0,0,0,0,0,8
GOA,2006,Others (Please Specify),0,9,16,10,2,37,2,6,3,0,1,12,49
GOA,2006,Total,1,60,69,40,13,183,6,40,22,13,11,92,275
GOA,2006,Total Salaried,0,22,19,11,0,52,0,3,1,0,0,4,56
GOA,2006,Total Self-employed,0,3,12,9,3,27,0,1,0,0,0,1,28
GOA,2007,House Wife,0,0,0,0,0,0,0,24,20,11,4,59,59
GOA,2007,Service (Government),0,0,2,1,0,3,0,0,1,2,0,3,6
GOA,2007,Service (Private),0,19,23,11,2,55,0,7,1,1,0,9,64
GOA,2007,Public Sector Undertaking,0,0,0,0,0,0,0,0,0,0,0,0,0
GOA,2007,Student,1,10,3,0,0,14,1,3,0,0,0,4,18
GOA,2007,Unemployed,0,16,29,15,7,67,0,12,2,0,0,14,81
GOA,2007,Self-employed (Business activity),0,3,7,4,2,16,0,0,0,0,0,0,16
GOA,2007,Professional Activity,0,1,0,0,0,1,0,0,0,0,0,0,1
GOA,2007,Farming/Agriculture Activity,0,0,0,0,0,0,0,0,0,0,0,0,0
GOA,2007,Others (Please Specify),0,2,1,0,1,4,0,0,0,0,0,0,4
GOA,2007,Retired Person,0,0,0,4,6,10,0,0,0,0,0,0,10
GOA,2007,Others (Please Specify),0,3,4,1,0,8,1,1,1,0,0,3,11
GOA,2007,Total,1,54,69,36,18,178,2,47,25,14,4,92,270
GOA,2007,Total Salaried,0,19,25,12,2,58,0,7,2,3,0,12,70
GOA,2007,Total Self-employed,0,6,8,4,3,21,0,0,0,0,0,0,21
GOA,2008,House Wife,0,0,0,0,0,0,0,25,19,10,11,65,65
GOA,2008,Service (Government),0,0,3,0,0,3,0,1,0,0,0,1,4
GOA,2008,Service (Private),0,23,25,7,1,56,0,5,2,0,0,7,63
GOA,2008,Public Sector Undertaking,0,0,0,0,0,0,0,0,0,0,0,0,0
GOA,2008,Student,0,5,0,0,0,5,2,5,0,0,0,7,12
GOA,2008,Unemployed,0,18,22,12,2,54,1,13,3,0,0,17,71
GOA,2008,Self-employed (Business activity),0,1,7,3,0,11,0,0,1,0,0,1,12
GOA,2008,Professional Activity,0,0,1,0,0,1,0,0,0,0,0,0,1
GOA,2008,Farming/Agriculture Activity,0,0,2,2,2,6,0,0,0,0,0,0,6
GOA,2008,Others (Please Specify),0,1,3,0,4,8,0,1,0,0,0,1,9
GOA,2008,Retired Person,0,0,0,0,2,2,0,0,0,0,0,0,2
GOA,2008,Others (Please Specify),0,7,21,5,4,37,0,4,1,0,0,5,42
GOA,2008,Total,0,55,84,29,15,183,3,54,26,10,11,104,287
GOA,2008,Total Salaried,0,23,28,7,1,59,0,6,2,0,0,8,67
GOA,2008,Total Self-employed,0,2,13,5,6,26,0,1,1,0,0,2,28
GOA,2009,House Wife,0,0,0,0,0,0,0,24,19,10,7,60,60
GOA,2009,Service (Government),0,2,2,1,0,5,0,2,2,1,0,5,10
GOA,2009,Service (Private),0,14,19,10,1,44,0,6,0,0,0,6,50
GOA,2009,Public Sector Undertaking,0,1,0,2,0,3,0,0,0,0,0,0,3
GOA,2009,Student,1,7,0,0,0,8,2,4,0,1,0,7,15
GOA,2009,Unemployed,0,15,22,16,0,53,0,4,0,1,1,6,59
GOA,2009,Self-employed (Business activity),0,2,1,0,1,4,0,2,0,0,0,2,6
GOA,2009,Professional Activity,0,1,2,1,0,4,0,0,1,0,0,1,5
GOA,2009,Farming/Agriculture Activity,0,0,2,1,1,4,0,0,0,0,0,0,4
GOA,2009,Others (Please Specify),0,5,3,6,5,19,0,3,0,1,0,4,23
GOA,2009,Retired Person,0,0,0,0,4,4,0,0,0,0,0,0,4
GOA,2009,Others (Please Specify),0,3,21,7,5,36,0,3,0,0,0,3,39
GOA,2009,Total,1,50,72,44,17,184,2,48,22,14,8,94,278
GOA,2009,Total Salaried,0,17,21,13,1,52,0,8,2,1,0,11,63
GOA,2009,Total Self-employed,0,8,8,8,7,31,0,5,1,1,0,7,38
GOA,2010,House Wife,0,0,0,0,0,0,0,14,18,9,11,52,52
GOA,2010,Service (Government),0,1,4,4,0,9,0,0,0,0,0,0,9
GOA,2010,Service (Private),0,24,31,11,1,67,0,3,0,0,0,3,70
GOA,2010,Public Sector Undertaking,0,1,1,0,0,2,0,0,0,0,0,0,2
GOA,2010,Student,2,10,1,0,0,13,2,8,0,0,0,10,23
GOA,2010,Unemployed,0,15,19,14,3,51,1,7,2,0,0,10,61
GOA,2010,Self-employed (Business activity),0,2,4,5,0,11,0,0,0,0,0,0,11
GOA,2010,Professional Activity,0,0,0,1,0,1,0,0,0,0,0,0,1
GOA,2010,Farming/Agriculture Activity,0,2,3,3,7,15,0,0,0,0,0,0,15
GOA,2010,Others (Please Specify),0,5,5,4,4,18,0,0,0,0,0,0,18
GOA,2010,Retired Person,0,0,0,0,3,3,0,0,0,0,0,0,3
GOA,2010,Others (Please Specify),0,9,13,21,3,46,0,5,1,0,5,11,57
GOA,2010,Total,2,69,81,63,21,236,3,37,21,9,16,86,322
GOA,2010,Total Salaried,0,26,36,15,1,78,0,3,0,0,0,3,81
GOA,2010,Total Self-employed,0,9,12,13,11,45,0,0,0,0,0,0,45
GOA,2011,House Wife,0,0,0,0,0,0,0,18,22,7,9,56,56
GOA,2011,Service (Government),0,0,0,0,0,0,0,0,0,0,0,0,0
GOA,2011,Service (Private),0,19,25,9,0,53,0,7,1,0,0,8,61
GOA,2011,Public Sector Undertaking,0,0,0,0,0,0,0,0,0,0,0,0,0
GOA,2011,Student,3,4,0,0,0,7,2,17,1,0,0,20,27
GOA,2011,Unemployed,1,13,12,13,4,43,1,5,2,0,0,8,51
GOA,2011,Self-employed (Business activity),0,0,0,0,0,0,0,0,0,0,0,0,0
GOA,2011,Professional Activity,0,2,1,1,0,4,0,1,0,0,0,1,5
GOA,2011,Farming/Agriculture Activity,0,0,0,0,1,1,0,0,0,0,0,0,1
GOA,2011,Others (Please Specify),1,1,5,4,2,13,0,0,0,0,0,0,13
GOA,2011,Retired Person,0,0,0,0,4,4,0,0,0,1,0,1,5
GOA,2011,Others (Please Specify),0,13,38,12,7,70,0,3,0,1,0,4,74
GOA,2011,Total,5,52,81,39,18,195,3,51,26,9,9,98,293
GOA,2011,Total Salaried,0,19,25,9,0,53,0,7,1,0,0,8,61
GOA,2011,Total Self-employed,1,3,6,5,3,18,0,1,0,0,0,1,19
GOA,2012,House Wife,0,0,0,0,0,0,0,11,24,7,13,55,55
GOA,2012,Service (Government),0,1,5,3,0,9,0,0,1,0,0,1,10
GOA,2012,Service (Private),0,23,17,8,2,50,0,4,1,0,0,5,55
GOA,2012,Public Sector Undertaking,0,2,2,1,1,6,0,1,1,0,0,2,8
GOA,2012,Student,3,5,0,0,0,8,2,13,0,0,0,15,23
GOA,2012,Unemployed,0,12,20,12,2,46,0,3,0,0,0,3,49
GOA,2012,Self-employed (Business activity),0,1,10,6,1,18,0,0,0,0,0,0,18
GOA,2012,Professional Activity,0,1,1,1,1,4,0,0,0,0,0,0,4
GOA,2012,Farming/Agriculture Activity,0,0,0,1,0,1,0,0,0,0,0,0,1
GOA,2012,Others (Please Specify),0,2,9,2,0,13,0,1,0,0,1,2,15
GOA,2012,Retired Person,0,0,0,0,5,5,0,0,0,0,0,0,5
GOA,2012,Others (Please Specify),2,6,14,10,4,36,1,4,3,2,0,10,46
GOA,2012,Total,5,53,78,44,16,196,3,37,30,9,14,93,289
GOA,2012,Total Salaried,0,26,24,12,3,65,0,5,3,0,0,8,73
GOA,2012,Total Self-employed,0,4,20,10,2,36,0,1,0,0,1,2,38
GUJARAT,2001,House Wife,0,0,0,0,0,0,15,736,534,199,84,1568,1568
GUJARAT,2001,Service (Government),0,12,26,24,0,62,0,3,5,0,0,8,70
GUJARAT,2001,Service (Private),0,145,169,45,6,365,0,18,14,7,0,39,404
GUJARAT,2001,Public Sector Undertaking,0,22,47,21,2,92,0,8,4,3,0,15,107
GUJARAT,2001,Student,19,109,6,0,0,134,28,101,1,0,0,130,264
GUJARAT,2001,Unemployed,5,210,137,66,8,426,6,27,28,10,0,71,497
GUJARAT,2001,Self-employed (Business activity),6,67,116,58,8,255,0,0,1,0,0,1,256
GUJARAT,2001,Professional Activity,0,98,127,86,14,325,0,18,5,2,2,27,352
GUJARAT,2001,Farming/Agriculture Activity,1,188,213,84,31,517,2,34,30,7,4,77,594
GUJARAT,2001,Others (Please Specify),4,114,144,46,14,322,4,57,22,13,10,106,428
GUJARAT,2001,Retired Person,0,0,0,13,43,56,0,0,0,5,38,43,99
GUJARAT,2001,Others (Please Specify),5,37,34,9,10,95,3,28,13,11,2,57,152
GUJARAT,2001,Total,40,1002,1019,452,136,2649,58,1030,657,257,140,2142,4791
GUJARAT,2001,Total Salaried,0,179,242,90,8,519,0,29,23,10,0,62,581
GUJARAT,2001,Total Self-employed,11,467,600,274,67,1419,6,109,58,22,16,211,1630
GUJARAT,2002,House Wife,0,0,0,0,0,0,2,698,508,191,62,1461,1461
GUJARAT,2002,Service (Government),0,10,12,18,0,40,0,3,0,0,0,3,43
GUJARAT,2002,Service (Private),0,108,155,46,8,317,0,18,8,7,0,33,350
GUJARAT,2002,Public Sector Undertaking,0,24,31,13,4,72,0,6,1,1,0,8,80
GUJARAT,2002,Student,16,127,12,0,0,155,26,85,3,0,0,114,269
GUJARAT,2002,Unemployed,1,192,169,92,13,467,1,30,18,8,2,59,526
GUJARAT,2002,Self-employed (Business activity),0,90,112,51,4,257,0,3,1,1,0,5,262
GUJARAT,2002,Professional Activity,1,117,125,93,8,344,0,15,1,3,0,19,363
GUJARAT,2002,Farming/Agriculture Activity,0,173,208,74,27,482,2,43,22,16,5,88,570
GUJARAT,2002,Others (Please Specify),5,129,134,68,14,350,4,33,17,17,3,74,424
GUJARAT,2002,Retired Person,0,0,0,18,45,63,0,0,2,3,28,33,96
GUJARAT,2002,Others (Please Specify),2,52,38,45,22,159,4,12,9,11,5,41,200
GUJARAT,2002,Total,25,1022,996,518,145,2706,39,946,590,258,105,1938,4644
GUJARAT,2002,Total Salaried,0,142,198,77,12,429,0,27,9,8,0,44,473
GUJARAT,2002,Total Self-employed,6,509,579,286,53,1433,6,94,41,37,8,186,1619
GUJARAT,2003,House Wife,0,0,0,0,0,0,1,608,466,202,97,1374,1374
GUJARAT,2003,Service (Government),0,21,33,15,2,71,0,1,4,0,0,5,76
GUJARAT,2003,Service (Private),0,120,144,56,6,326,0,34,18,3,0,55,381
GUJARAT,2003,Public Sector Undertaking,0,8,18,11,0,37,0,7,3,0,0,10,47
GUJARAT,2003,Student,12,77,2,0,0,91,21,73,1,1,0,96,187
GUJARAT,2003,Unemployed,0,176,153,64,12,405,3,30,16,6,1,56,461
GUJARAT,2003,Self-employed (Business activity),0,59,98,50,18,225,0,3,0,0,0,3,228
GUJARAT,2003,Professional Activity,0,143,135,81,17,376,0,8,1,0,5,14,390
GUJARAT,2003,Farming/Agriculture Activity,0,149,169,121,30,469,0,46,33,24,9,112,581
GUJARAT,2003,Others (Please Specify),2,113,172,72,10,369,11,37,16,7,7,78,447
GUJARAT,2003,Retired Person,0,5,6,17,57,85,0,2,3,4,29,38,123
GUJARAT,2003,Others (Please Specify),8,60,66,36,26,196,7,24,20,13,11,75,271
GUJARAT,2003,Total,22,931,996,523,178,2650,43,873,581,260,159,1916,4566
GUJARAT,2003,Total Salaried,0,149,195,82,8,434,0,42,25,3,0,70,504
GUJARAT,2003,Total Self-employed,2,464,574,324,75,1439,11,94,50,31,21,207,1646
GUJARAT,2004,House Wife,0,0,0,0,0,0,6,616,489,190,59,1360,1360
GUJARAT,2004,Service (Government),0,15,30,15,0,60,0,1,4,1,0,6,66
GUJARAT,2004,Service (Private),0,107,153,81,10,351,0,40,19,9,1,69,420
GUJARAT,2004,Public Sector Undertaking,0,9,14,16,2,41,0,1,1,0,0,2,43
GUJARAT,2004,Student,15,115,10,0,0,140,13,92,1,0,1,107,247
GUJARAT,2004,Unemployed,1,171,170,73,10,425,0,27,19,6,0,52,477
GUJARAT,2004,Self-employed (Business activity),0,71,96,57,10,234,0,1,3,1,1,6,240
GUJARAT,2004,Professional Activity,0,123,141,85,16,365,0,10,8,2,1,21,386
GUJARAT,2004,Farming/Agriculture Activity,0,134,153,123,42,452,0,31,20,18,2,71,523
GUJARAT,2004,Others (Please Specify),4,163,184,97,29,477,5,69,30,8,7,119,596
GUJARAT,2004,Retired Person,0,0,0,15,46,61,0,0,0,11,30,41,102
GUJARAT,2004,Others (Please Specify),14,80,86,49,15,244,5,39,10,11,7,72,316
GUJARAT,2004,Total,34,988,1037,611,180,2850,29,927,604,257,109,1926,4776
GUJARAT,2004,Total Salaried,0,131,197,112,12,452,0,42,24,10,1,77,529
GUJARAT,2004,Total Self-employed,4,491,574,362,97,1528,5,111,61,29,11,217,1745
GUJARAT,2005,House Wife,0,0,0,0,0,0,0,548,498,203,71,1320,1320
GUJARAT,2005,Service (Government),0,21,35,17,0,73,0,1,1,2,0,4,77
GUJARAT,2005,Service (Private),0,135,191,97,5,428,0,32,19,5,0,56,484
GUJARAT,2005,Public Sector Undertaking,0,18,33,16,0,67,0,2,1,0,0,3,70
GUJARAT,2005,Student,16,82,7,0,0,105,21,99,0,0,0,120,225
GUJARAT,2005,Unemployed,1,151,140,75,5,372,1,26,8,3,2,40,412
GUJARAT,2005,Self-employed (Business activity),0,84,108,59,16,267,0,1,0,0,1,2,269
GUJARAT,2005,Professional Activity,0,120,115,68,17,320,0,10,3,0,0,13,333
GUJARAT,2005,Farming/Agriculture Activity,0,159,182,136,42,519,2,45,29,16,4,96,615
GUJARAT,2005,Others (Please Specify),3,139,173,67,10,392,2,34,18,9,5,68,460
GUJARAT,2005,Retired Person,0,0,1,35,68,104,0,0,0,5,23,28,132
GUJARAT,2005,Others (Please Specify),5,71,97,53,29,255,7,53,24,16,13,113,368
GUJARAT,2005,Total,25,980,1082,623,192,2902,33,851,601,259,119,1863,4765
GUJARAT,2005,Total Salaried,0,174,259,130,5,568,0,35,21,7,0,63,631
GUJARAT,2005,Total Self-employed,3,502,578,330,85,1498,4,90,50,25,10,179,1677
GUJARAT,2006,House Wife,0,0,0,0,0,0,0,651,469,219,57,1396,1396
GUJARAT,2006,Service (Government),0,8,22,14,1,45,0,5,3,1,0,9,54
GUJARAT,2006,Service (Private),0,141,215,102,3,461,0,37,25,8,0,70,531
GUJARAT,2006,Public Sector Undertaking,0,13,17,10,1,41,0,10,4,1,0,15,56
GUJARAT,2006,Student,24,100,13,0,0,137,17,85,1,0,0,103,240
GUJARAT,2006,Unemployed,0,162,154,86,8,410,0,19,22,5,0,46,456
GUJARAT,2006,Self-employed (Business activity),0,73,108,68,8,257,0,1,5,0,0,6,263
GUJARAT,2006,Professional Activity,0,126,141,87,16,370,2,10,12,5,0,29,399
GUJARAT,2006,Farming/Agriculture Activity,0,101,175,116,19,411,3,24,29,14,6,76,487
GUJARAT,2006,Others (Please Specify),2,165,176,110,24,477,3,48,23,9,3,86,563
GUJARAT,2006,Retired Person,0,2,1,24,86,113,0,0,0,7,50,57,170
GUJARAT,2006,Others (Please Specify),4,95,112,77,38,326,3,35,21,29,6,94,420
GUJARAT,2006,Total,30,986,1134,694,204,3048,28,925,614,298,122,1987,5035
GUJARAT,2006,Total Salaried,0,162,254,126,5,547,0,52,32,10,0,94,641
GUJARAT,2006,Total Self-employed,2,465,600,381,67,1515,8,83,69,28,9,197,1712
GUJARAT,2007,House Wife,0,0,0,0,0,0,2,729,540,235,107,1613,1613
GUJARAT,2007,Service (Government),0,29,37,19,0,85,0,8,7,4,1,20,105
GUJARAT,2007,Service (Private),0,190,215,105,6,516,1,26,19,8,1,55,571
GUJARAT,2007,Public Sector Undertaking,0,37,59,42,2,140,0,7,7,1,0,15,155
GUJARAT,2007,Student,23,123,6,3,0,155,26,102,17,3,0,148,303
GUJARAT,2007,Unemployed,1,179,182,73,8,443,1,23,22,9,2,57,500
GUJARAT,2007,Self-employed (Business activity),0,69,110,80,11,270,0,4,2,0,0,6,276
GUJARAT,2007,Professional Activity,0,179,173,79,23,454,0,16,15,5,1,37,491
GUJARAT,2007,Farming/Agriculture Activity,0,60,128,81,20,289,0,12,8,5,3,28,317
GUJARAT,2007,Others (Please Specify),2,195,232,101,24,554,0,48,26,11,7,92,646
GUJARAT,2007,Retired Person,0,20,23,34,98,175,0,7,0,14,28,49,224
GUJARAT,2007,Others (Please Specify),7,108,101,56,22,294,5,30,25,16,9,85,379
GUJARAT,2007,Total,33,1189,1266,673,214,3375,35,1012,688,311,159,2205,5580
GUJARAT,2007,Total Salaried,0,256,311,166,8,741,1,41,33,13,2,90,831
GUJARAT,2007,Total Self-employed,2,503,643,341,78,1567,0,80,51,21,11,163,1730
GUJARAT,2008,House Wife,0,0,0,0,0,0,3,751,622,255,113,1744,1744
GUJARAT,2008,Service (Government),0,9,30,18,0,57,0,2,3,0,0,5,62
GUJARAT,2008,Service (Private),0,178,244,119,3,544,0,25,30,9,0,64,608
GUJARAT,2008,Public Sector Undertaking,0,23,55,22,2,102,0,16,7,2,0,25,127
GUJARAT,2008,Student,13,131,9,2,0,155,18,122,7,2,0,149,304
GUJARAT,2008,Unemployed,1,206,219,76,11,513,4,28,8,4,1,45,558
GUJARAT,2008,Self-employed (Business activity),0,75,124,78,10,287,0,0,3,0,0,3,290
GUJARAT,2008,Professional Activity,0,155,161,85,19,420,0,4,4,0,0,8,428
GUJARAT,2008,Farming/Agriculture Activity,0,115,182,92,52,441,1,21,19,38,6,85,526
GUJARAT,2008,Others (Please Specify),2,225,241,133,26,627,2,50,42,9,7,110,737
GUJARAT,2008,Retired Person,0,3,1,48,90,142,0,0,0,11,34,45,187
GUJARAT,2008,Others (Please Specify),9,130,156,114,38,447,11,71,41,17,7,147,594
GUJARAT,2008,Total,25,1250,1422,787,251,3735,39,1090,786,347,168,2430,6165
GUJARAT,2008,Total Salaried,0,210,329,159,5,703,0,43,40,11,0,94,797
GUJARAT,2008,Total Self-employed,2,570,708,388,107,1775,3,75,68,47,13,206,1981
GUJARAT,2009,House Wife,0,0,0,0,0,0,3,781,580,262,110,1736,1736
GUJARAT,2009,Service (Government),0,10,19,13,1,43,0,17,4,4,1,26,69
GUJARAT,2009,Service (Private),0,192,247,133,9,581,0,16,24,8,0,48,629
GUJARAT,2009,Public Sector Undertaking,0,24,48,17,2,91,0,13,6,5,0,24,115
GUJARAT,2009,Student,17,154,2,1,0,174,25,118,10,1,0,154,328
GUJARAT,2009,Unemployed,1,184,226,69,19,499,0,43,28,7,2,80,579
GUJARAT,2009,Self-employed (Business activity),0,108,148,65,15,336,0,0,0,2,0,2,338
GUJARAT,2009,Professional Activity,0,180,198,109,22,509,0,21,16,6,0,43,552
GUJARAT,2009,Farming/Agriculture Activity,0,153,198,107,40,498,0,36,30,14,10,90,588
GUJARAT,2009,Others (Please Specify),4,168,216,119,40,547,1,64,49,25,25,164,711
GUJARAT,2009,Retired Person,0,1,1,16,76,94,0,0,1,2,21,24,118
GUJARAT,2009,Others (Please Specify),5,81,101,88,24,299,1,50,23,12,8,94,393
GUJARAT,2009,Total,27,1255,1404,737,248,3671,30,1159,771,348,177,2485,6156
GUJARAT,2009,Total Salaried,0,226,314,163,12,715,0,46,34,17,1,98,813
GUJARAT,2009,Total Self-employed,4,609,760,400,117,1890,1,121,95,47,35,299,2189
GUJARAT,2010,House Wife,0,0,0,0,0,0,2,726,512,253,82,1575,1575
GUJARAT,2010,Service (Government),0,17,31,14,0,62,0,6,5,2,0,13,75
GUJARAT,2010,Service (Private),0,197,202,116,9,524,0,42,44,11,1,98,622
GUJARAT,2010,Public Sector Undertaking,0,23,31,20,3,77,0,11,7,6,0,24,101
GUJARAT,2010,Student,19,125,6,1,0,151,18,121,3,0,0,142,293
GUJARAT,2010,Unemployed,1,217,231,81,18,548,0,39,17,5,0,61,609
GUJARAT,2010,Self-employed (Business activity),1,151,185,70,21,428,6,8,12,11,2,39,467
GUJARAT,2010,Professional Activity,2,116,127,63,13,321,0,10,5,4,0,19,340
GUJARAT,2010,Farming/Agriculture Activity,1,127,201,104,25,458,1,18,25,17,4,65,523
GUJARAT,2010,Others (Please Specify),3,193,203,168,32,599,4,58,34,26,8,130,729
GUJARAT,2010,Retired Person,0,2,1,11,85,99,0,0,0,8,44,52,151
GUJARAT,2010,Others (Please Specify),10,175,194,110,57,546,11,66,58,24,17,176,722
GUJARAT,2010,Total,37,1343,1412,758,263,3813,42,1105,722,367,158,2394,6207
GUJARAT,2010,Total Salaried,0,237,264,150,12,663,0,59,56,19,1,135,798
GUJARAT,2010,Total Self-employed,7,587,716,405,91,1806,11,94,76,58,14,253,2059
GUJARAT,2011,House Wife,0,0,0,0,0,0,4,719,512,258,78,1571,1571
GUJARAT,2011,Service (Government),0,18,26,16,0,60,0,7,2,2,3,14,74
GUJARAT,2011,Service (Private),0,226,226,119,10,581,0,39,31,17,5,92,673
GUJARAT,2011,Public Sector Undertaking,0,31,35,24,8,98,0,8,9,9,0,26,124
GUJARAT,2011,Student,24,146,8,0,0,178,36,110,2,0,0,148,326
GUJARAT,2011,Unemployed,2,163,182,82,14,443,0,24,18,6,0,48,491
GUJARAT,2011,Self-employed (Business activity),0,107,130,61,14,312,0,0,1,0,0,1,313
GUJARAT,2011,Professional Activity,0,210,185,107,29,531,2,31,24,2,2,61,592
GUJARAT,2011,Farming/Agriculture Activity,1,133,189,118,32,473,3,25,35,31,11,105,578
GUJARAT,2011,Others (Please Specify),1,214,268,139,31,653,3,58,61,28,8,158,811
GUJARAT,2011,Retired Person,0,3,1,29,70,103,0,0,0,11,43,54,157
GUJARAT,2011,Others (Please Specify),7,173,148,105,47,480,5,72,60,35,20,192,672
GUJARAT,2011,Total,35,1424,1398,800,255,3912,53,1093,755,399,170,2470,6382
GUJARAT,2011,Total Salaried,0,275,287,159,18,739,0,54,42,28,8,132,871
GUJARAT,2011,Total Self-employed,2,664,772,425,106,1969,8,114,121,61,21,325,2294
GUJARAT,2012,House Wife,0,0,0,0,0,0,2,800,595,310,88,1795,1795
GUJARAT,2012,Service (Government),0,20,35,20,0,75,0,6,3,7,0,16,91
GUJARAT,2012,Service (Private),1,277,329,137,14,758,0,61,54,22,0,137,895
GUJARAT,2012,Public Sector Undertaking,0,38,52,21,4,115,0,12,17,5,1,35,150
GUJARAT,2012,Student,23,188,4,0,0,215,23,148,2,0,0,173,388
GUJARAT,2012,Unemployed,7,191,215,91,7,511,4,18,14,10,0,46,557
GUJARAT,2012,Self-employed (Business activity),0,79,105,68,13,265,0,4,0,0,0,4,269
GUJARAT,2012,Professional Activity,1,189,168,97,23,478,0,20,9,2,1,32,510
GUJARAT,2012,Farming/Agriculture Activity,2,138,193,110,29,472,4,46,23,16,3,92,564
GUJARAT,2012,Others (Please Specify),4,256,283,157,37,737,5,60,46,32,11,154,891
GUJARAT,2012,Retired Person,0,4,4,29,102,139,3,3,2,6,33,47,186
GUJARAT,2012,Others (Please Specify),14,174,200,152,57,597,16,68,79,39,15,217,814
GUJARAT,2012,Total,52,1554,1588,882,286,4362,57,1246,844,449,152,2748,7110
GUJARAT,2012,Total Salaried,1,335,416,178,18,948,0,79,74,34,1,188,1136
GUJARAT,2012,Total Self-employed,7,662,749,432,102,1952,9,130,78,50,15,282,2234
HARYANA,2001,House Wife,0,0,0,0,0,0,0,167,104,15,11,297,297
HARYANA,2001,Service (Government),0,25,32,16,0,73,0,0,13,8,0,21,94
HARYANA,2001,Service (Private),0,40,45,13,0,98,0,24,15,6,2,47,145
HARYANA,2001,Public Sector Undertaking,0,33,29,4,0,66,0,14,13,1,0,28,94
HARYANA,2001,Student,15,64,8,0,0,87,7,29,2,3,0,41,128
HARYANA,2001,Unemployed,13,117,52,42,3,227,7,26,18,9,0,60,287
HARYANA,2001,Self-employed (Business activity),0,28,16,12,1,57,0,0,0,0,0,0,57
HARYANA,2001,Professional Activity,0,17,33,12,2,64,0,0,1,0,0,1,65
HARYANA,2001,Farming/Agriculture Activity,0,50,43,27,13,133,0,6,3,3,0,12,145
HARYANA,2001,Others (Please Specify),0,27,51,14,11,103,0,4,17,3,4,28,131
HARYANA,2001,Retired Person,0,0,0,1,17,18,0,0,0,0,4,4,22
HARYANA,2001,Others (Please Specify),6,118,190,95,29,438,6,52,34,8,4,104,542
HARYANA,2001,Total,34,519,499,236,76,1364,20,322,220,56,25,643,2007
HARYANA,2001,Total Salaried,0,98,106,33,0,237,0,38,41,15,2,96,333
HARYANA,2001,Total Self-employed,0,122,143,65,27,357,0,10,21,6,4,41,398
HARYANA,2002,House Wife,0,0,0,0,0,0,1,198,131,31,10,371,371
HARYANA,2002,Service (Government),0,18,28,20,0,66,0,9,13,9,0,31,97
HARYANA,2002,Service (Private),0,66,107,31,4,208,0,26,9,0,0,35,243
HARYANA,2002,Public Sector Undertaking,0,29,34,2,0,65,0,5,9,0,0,14,79
HARYANA,2002,Student,10,69,20,0,0,99,1,55,2,0,0,58,157
HARYANA,2002,Unemployed,1,67,73,51,2,194,0,2,7,2,0,11,205
HARYANA,2002,Self-employed (Business activity),0,13,15,9,2,39,0,0,0,0,0,0,39
HARYANA,2002,Professional Activity,0,9,11,9,3,32,0,1,0,0,0,1,33
HARYANA,2002,Farming/Agriculture Activity,0,52,66,40,9,167,0,15,6,0,2,23,190
HARYANA,2002,Others (Please Specify),13,79,67,44,16,219,2,3,4,2,0,11,230
HARYANA,2002,Retired Person,0,0,1,3,4,8,0,0,7,2,0,9,17
HARYANA,2002,Others (Please Specify),12,128,201,87,45,473,16,23,15,7,5,66,539
HARYANA,2002,Total,36,530,623,296,85,1570,20,337,203,53,17,630,2200
HARYANA,2002,Total Salaried,0,113,169,53,4,339,0,40,31,9,0,80,419
HARYANA,2002,Total Self-employed,13,153,159,102,30,457,2,19,10,2,2,35,492
HARYANA,2003,House Wife,0,0,0,0,0,0,0,173,107,29,12,321,321
HARYANA,2003,Service (Government),0,20,28,20,0,68,0,5,4,1,0,10,78
HARYANA,2003,Service (Private),6,68,90,25,1,190,0,26,8,2,0,36,226
HARYANA,2003,Public Sector Undertaking,0,17,33,4,0,54,0,10,6,1,0,17,71
HARYANA,2003,Student,5,69,12,0,0,86,10,28,1,0,0,39,125
HARYANA,2003,Unemployed,2,89,65,25,3,184,1,17,7,3,0,28,212
HARYANA,2003,Self-employed (Business activity),0,7,55,50,23,135,0,1,0,0,0,1,136
HARYANA,2003,Professional Activity,0,11,13,9,0,33,0,0,0,0,0,0,33
HARYANA,2003,Farming/Agriculture Activity,1,59,66,51,15,192,0,5,6,4,0,15,207
HARYANA,2003,Others (Please Specify),4,120,25,26,12,187,6,24,25,13,5,73,260
HARYANA,2003,Retired Person,0,0,0,10,13,23,0,0,0,4,3,7,30
HARYANA,2003,Others (Please Specify),16,116,215,78,36,461,8,25,21,9,4,67,528
HARYANA,2003,Total,34,576,602,298,103,1613,25,314,185,66,24,614,2227
HARYANA,2003,Total Salaried,6,105,151,49,1,312,0,41,18,4,0,63,375
HARYANA,2003,Total Self-employed,5,197,159,136,50,547,6,30,31,17,5,89,636
HARYANA,2004,House Wife,0,0,0,0,0,0,1,157,120,37,15,330,330
HARYANA,2004,Service (Government),0,20,28,19,0,67,0,11,4,1,0,16,83
HARYANA,2004,Service (Private),0,62,82,26,2,172,0,27,8,2,0,37,209
HARYANA,2004,Public Sector Undertaking,0,13,32,5,0,50,0,3,6,1,0,10,60
HARYANA,2004,Student,5,71,3,0,0,79,11,27,0,0,0,38,117
HARYANA,2004,Unemployed,4,71,72,34,6,187,3,6,10,5,0,24,211
HARYANA,2004,Self-employed (Business activity),0,28,30,20,11,89,0,0,0,0,0,0,89
HARYANA,2004,Professional Activity,0,1,19,13,0,33,0,0,0,0,0,0,33
HARYANA,2004,Farming/Agriculture Activity,0,40,56,38,10,144,0,6,6,4,0,16,160
HARYANA,2004,Others (Please Specify),4,55,69,40,8,176,2,8,19,9,2,40,216
HARYANA,2004,Retired Person,0,0,0,0,9,9,0,0,0,0,0,0,9
HARYANA,2004,Others (Please Specify),21,155,153,60,59,448,5,62,31,13,6,117,565
HARYANA,2004,Total,34,516,544,255,105,1454,22,307,204,72,23,628,2082
HARYANA,2004,Total Salaried,0,95,142,50,2,289,0,41,18,4,0,63,352
HARYANA,2004,Total Self-employed,4,124,174,111,29,442,2,14,25,13,2,56,498
HARYANA,2005,House Wife,0,0,0,0,0,0,2,119,125,49,8,303,303
HARYANA,2005,Service (Government),0,14,16,7,0,37,0,1,5,0,0,6,43
HARYANA,2005,Service (Private),0,72,48,24,0,144,1,6,3,1,0,11,155
HARYANA,2005,Public Sector Undertaking,0,4,10,1,0,15,0,3,2,0,0,5,20
HARYANA,2005,Student,7,57,3,0,0,67,6,25,3,0,0,34,101
HARYANA,2005,Unemployed,5,64,54,17,6,146,0,7,4,1,1,13,159
HARYANA,2005,Self-employed (Business activity),0,10,38,15,8,71,0,0,0,0,0,0,71
HARYANA,2005,Professional Activity,0,6,11,0,1,18,1,0,0,0,0,1,19
HARYANA,2005,Farming/Agriculture Activity,1,37,57,23,10,128,2,6,2,2,0,12,140
HARYANA,2005,Others (Please Specify),5,83,68,34,12,202,2,11,3,3,0,19,221
HARYANA,2005,Retired Person,0,0,6,4,1,11,0,0,2,2,1,5,16
HARYANA,2005,Others (Please Specify),10,163,297,149,35,654,1,79,38,18,8,144,798
HARYANA,2005,Total,28,510,608,274,73,1493,15,257,187,76,18,553,2046
HARYANA,2005,Total Salaried,0,90,74,32,0,196,1,10,10,1,0,22,218
HARYANA,2005,Total Self-employed,6,136,174,72,31,419,5,17,5,5,0,32,451
HARYANA,2006,House Wife,0,0,0,0,0,0,2,152,110,40,15,319,319
HARYANA,2006,Service (Government),0,13,28,8,0,49,0,5,5,0,0,10,59
HARYANA,2006,Service (Private),0,129,127,58,7,321,0,12,23,15,4,54,375
HARYANA,2006,Public Sector Undertaking,0,14,50,14,0,78,0,16,5,0,0,21,99
HARYANA,2006,Student,8,75,3,0,0,86,10,30,0,0,0,40,126
HARYANA,2006,Unemployed,1,81,105,51,5,243,0,5,7,2,1,15,258
HARYANA,2006,Self-employed (Business activity),0,17,33,25,14,89,0,4,8,0,0,12,101
HARYANA,2006,Professional Activity,0,10,8,6,0,24,0,2,0,0,0,2,26
HARYANA,2006,Farming/Agriculture Activity,0,48,78,35,20,181,0,6,2,1,0,9,190
HARYANA,2006,Others (Please Specify),2,88,75,40,13,218,0,2,5,5,3,15,233
HARYANA,2006,Retired Person,1,20,18,10,5,54,0,1,0,0,0,1,55
HARYANA,2006,Others (Please Specify),13,115,176,91,28,423,9,17,12,8,6,52,475
HARYANA,2006,Total,25,610,701,338,92,1766,21,252,177,71,29,550,2316
HARYANA,2006,Total Salaried,0,156,205,80,7,448,0,33,33,15,4,85,533
HARYANA,2006,Total Self-employed,2,163,194,106,47,512,0,14,15,6,3,38,550
HARYANA,2007,House Wife,0,0,0,0,0,0,0,193,110,37,16,356,356
HARYANA,2007,Service (Government),0,18,25,20,1,64,0,12,3,0,0,15,79
HARYANA,2007,Service (Private),0,99,95,28,2,224,0,18,4,0,0,22,246
HARYANA,2007,Public Sector Undertaking,0,29,42,4,0,75,0,5,6,1,0,12,87
HARYANA,2007,Student,8,68,4,0,0,80,4,34,3,1,0,42,122
HARYANA,2007,Unemployed,2,111,108,32,6,259,0,5,12,6,0,23,282
HARYANA,2007,Self-employed (Business activity),0,24,30,23,9,86,0,0,1,1,0,2,88
HARYANA,2007,Professional Activity,0,5,23,29,0,57,0,0,0,0,0,0,57
HARYANA,2007,Farming/Agriculture Activity,0,68,63,37,11,179,0,0,0,0,0,0,179
HARYANA,2007,Others (Please Specify),1,50,37,24,9,121,1,10,23,6,2,42,163
HARYANA,2007,Retired Person,0,13,26,16,18,73,0,1,0,0,1,2,75
HARYANA,2007,Others (Please Specify),17,175,267,127,48,634,3,35,10,13,4,65,699
HARYANA,2007,Total,28,660,720,340,104,1852,8,313,172,65,23,581,2433
HARYANA,2007,Total Salaried,0,146,162,52,3,363,0,35,13,1,0,49,412
HARYANA,2007,Total Self-employed,1,147,153,113,29,443,1,10,24,7,2,44,487
HARYANA,2008,House Wife,0,0,0,0,0,0,0,159,135,52,20,366,366
HARYANA,2008,Service (Government),0,29,40,14,7,90,0,3,0,0,0,3,93
HARYANA,2008,Service (Private),0,95,101,38,5,239,0,9,2,0,0,11,250
HARYANA,2008,Public Sector Undertaking,0,41,33,11,7,92,0,3,1,0,0,4,96
HARYANA,2008,Student,10,78,3,1,0,92,15,28,0,0,0,43,135
HARYANA,2008,Unemployed,0,47,75,30,7,159,0,6,12,5,1,24,183
HARYANA,2008,Self-employed (Business activity),0,15,16,7,0,38,0,3,0,0,0,3,41
HARYANA,2008,Professional Activity,0,12,28,9,1,50,0,0,0,0,0,0,50
HARYANA,2008,Farming/Agriculture Activity,0,34,62,36,18,150,0,0,0,0,0,0,150
HARYANA,2008,Others (Please Specify),0,42,57,18,6,123,0,9,8,4,0,21,144
HARYANA,2008,Retired Person,0,1,0,0,7,8,0,2,0,2,0,4,12
HARYANA,2008,Others (Please Specify),37,293,359,158,86,933,24,52,97,22,8,203,1136
HARYANA,2008,Total,47,687,774,322,144,1974,39,274,255,85,29,682,2656
HARYANA,2008,Total Salaried,0,165,174,63,19,421,0,15,3,0,0,18,439
HARYANA,2008,Total Self-employed,0,103,163,70,25,361,0,12,8,4,0,24,385
HARYANA,2009,House Wife,0,0,0,0,0,0,2,176,196,57,10,441,441
HARYANA,2009,Service (Government),0,26,34,15,5,80,0,3,3,0,0,6,86
HARYANA,2009,Service (Private),0,100,98,47,8,253,0,16,13,3,0,32,285
HARYANA,2009,Public Sector Undertaking,0,35,19,8,2,64,0,7,0,0,0,7,71
HARYANA,2009,Student,10,70,3,0,0,83,16,16,0,0,0,32,115
HARYANA,2009,Unemployed,0,86,90,37,7,220,0,17,15,0,1,33,253
HARYANA,2009,Self-employed (Business activity),0,16,18,13,2,49,0,0,0,0,0,0,49
HARYANA,2009,Professional Activity,0,7,13,8,0,28,0,0,0,0,0,0,28
HARYANA,2009,Farming/Agriculture Activity,0,44,107,62,12,225,0,1,2,2,0,5,230
HARYANA,2009,Others (Please Specify),0,76,57,21,10,164,3,1,0,0,0,4,168
HARYANA,2009,Retired Person,0,0,0,0,0,0,0,0,0,0,0,0,0
HARYANA,2009,Others (Please Specify),28,232,220,127,42,649,13,57,16,33,9,128,777
HARYANA,2009,Total,38,692,659,338,88,1815,34,294,245,95,20,688,2503
HARYANA,2009,Total Salaried,0,161,151,70,15,397,0,26,16,3,0,45,442
HARYANA,2009,Total Self-employed,0,143,195,104,24,466,3,2,2,2,0,9,475
HARYANA,2010,House Wife,0,0,0,0,0,0,0,174,124,50,16,364,364
HARYANA,2010,Service (Government),0,14,16,10,0,40,0,24,18,3,0,45,85
HARYANA,2010,Service (Private),0,78,72,42,2,194,0,18,7,2,0,27,221
HARYANA,2010,Public Sector Undertaking,0,8,2,1,0,11,1,4,0,0,0,5,16
HARYANA,2010,Student,12,101,6,0,0,119,8,21,0,0,0,29,148
HARYANA,2010,Unemployed,3,143,118,67,16,347,0,21,9,4,3,37,384
HARYANA,2010,Self-employed (Business activity),0,16,12,16,2,46,0,0,0,0,0,0,46
HARYANA,2010,Professional Activity,0,14,17,13,1,45,0,0,0,0,0,0,45
HARYANA,2010,Farming/Agriculture Activity,0,94,103,59,25,281,0,9,5,2,0,16,297
HARYANA,2010,Others (Please Specify),2,190,183,133,45,553,5,11,20,9,5,50,603
HARYANA,2010,Retired Person,0,0,0,0,0,0,0,0,0,0,0,0,0
HARYANA,2010,Others (Please Specify),7,181,209,114,31,542,3,38,59,39,5,144,686
HARYANA,2010,Total,24,839,738,455,122,2178,17,320,242,109,29,717,2895
HARYANA,2010,Total Salaried,0,100,90,53,2,245,1,46,25,5,0,77,322
HARYANA,2010,Total Self-employed,2,314,315,221,73,925,5,20,25,11,5,66,991
HARYANA,2011,House Wife,0,0,0,0,0,0,0,203,148,56,9,416,416
HARYANA,2011,Service (Government),0,20,28,24,0,72,0,2,5,0,0,7,79
HARYANA,2011,Service (Private),0,75,91,22,5,193,0,11,7,2,0,20,213
HARYANA,2011,Public Sector Undertaking,0,9,9,2,0,20,0,5,0,0,0,5,25
HARYANA,2011,Student,14,105,5,5,0,129,4,47,0,0,0,51,180
HARYANA,2011,Unemployed,4,91,146,75,16,332,0,15,11,17,1,44,376
HARYANA,2011,Self-employed (Business activity),0,21,29,12,0,62,0,0,0,0,0,0,62
HARYANA,2011,Professional Activity,0,8,13,3,0,24,0,0,0,0,0,0,24
HARYANA,2011,Farming/Agriculture Activity,0,140,113,74,23,350,0,8,18,8,0,34,384
HARYANA,2011,Others (Please Specify),0,80,88,61,13,242,6,5,5,2,0,18,260
HARYANA,2011,Retired Person,0,1,0,1,0,2,0,0,0,0,0,0,2
HARYANA,2011,Others (Please Specify),52,411,363,162,50,1038,15,84,58,22,7,186,1224
HARYANA,2011,Total,70,961,885,441,107,2464,25,380,252,107,17,781,3245
HARYANA,2011,Total Salaried,0,104,128,48,5,285,0,18,12,2,0,32,317
HARYANA,2011,Total Self-employed,0,249,243,150,36,678,6,13,23,10,0,52,730
HARYANA,2012,House Wife,0,0,0,0,0,0,0,221,119,37,12,389,389
HARYANA,2012,Service (Government),0,15,17,16,0,48,0,2,1,0,0,3,51
HARYANA,2012,Service (Private),4,88,102,38,3,235,0,4,4,4,0,12,247
HARYANA,2012,Public Sector Undertaking,0,25,22,5,0,52,0,1,4,0,0,5,57
HARYANA,2012,Student,11,86,7,5,0,109,6,27,0,0,0,33,142
HARYANA,2012,Unemployed,2,120,108,52,11,293,1,12,16,4,1,34,327
HARYANA,2012,Self-employed (Business activity),0,14,20,11,0,45,0,0,0,0,0,0,45
HARYANA,2012,Professional Activity,0,11,21,9,0,41,0,0,0,0,0,0,41
HARYANA,2012,Farming/Agriculture Activity,0,53,100,73,25,251,0,9,12,2,2,25,276
HARYANA,2012,Others (Please Specify),15,232,210,110,59,626,16,55,42,21,3,137,763
HARYANA,2012,Retired Person,0,0,0,2,1,3,0,0,0,0,0,0,3
HARYANA,2012,Others (Please Specify),11,122,130,76,29,368,5,26,36,35,16,118,486
HARYANA,2012,Total,43,766,737,397,128,2071,28,357,234,103,34,756,2827
HARYANA,2012,Total Salaried,4,128,141,59,3,335,0,7,9,4,0,20,355
HARYANA,2012,Total Self-employed,15,310,351,203,84,963,16,64,54,23,5,162,1125
HIMACHAL PRADESH,2001,House Wife,0,0,0,0,0,0,0,44,26,12,2,84,84
HIMACHAL PRADESH,2001,Service (Government),0,0,5,3,0,8,0,2,1,0,0,3,11
HIMACHAL PRADESH,2001,Service (Private),0,6,9,8,1,24,0,0,0,0,0,0,24
HIMACHAL PRADESH,2001,Public Sector Undertaking,0,0,3,4,0,7,0,0,0,0,0,0,7
HIMACHAL PRADESH,2001,Student,0,8,0,0,0,8,2,9,0,0,0,11,19
HIMACHAL PRADESH,2001,Unemployed,0,18,9,4,0,31,0,6,1,0,0,7,38
HIMACHAL PRADESH,2001,Self-employed (Business activity),0,4,5,0,0,9,0,0,0,0,0,0,9
HIMACHAL PRADESH,2001,Professional Activity,0,0,2,0,0,2,0,0,1,0,0,1,3
HIMACHAL PRADESH,2001,Farming/Agriculture Activity,0,3,9,8,2,22,0,0,0,0,0,0,22
HIMACHAL PRADESH,2001,Others (Please Specify),0,1,6,5,1,13,0,0,6,0,0,6,19
HIMACHAL PRADESH,2001,Retired Person,0,0,0,1,0,1,0,0,0,0,0,0,1
HIMACHAL PRADESH,2001,Others (Please Specify),1,14,16,16,5,52,1,9,3,2,3,18,70
HIMACHAL PRADESH,2001,Total,1,54,64,49,9,177,3,70,38,14,5,130,307
HIMACHAL PRADESH,2001,Total Salaried,0,6,17,15,1,39,0,2,1,0,0,3,42
HIMACHAL PRADESH,2001,Total Self-employed,0,8,22,13,3,46,0,0,7,0,0,7,53
HIMACHAL PRADESH,2002,House Wife,0,0,0,0,0,0,2,46,29,5,1,83,83
HIMACHAL PRADESH,2002,Service (Government),0,3,6,2,0,11,0,1,1,0,0,2,13
HIMACHAL PRADESH,2002,Service (Private),0,6,5,1,0,12,0,0,0,0,0,0,12
HIMACHAL PRADESH,2002,Public Sector Undertaking,0,2,1,1,0,4,0,0,0,1,0,1,5
HIMACHAL PRADESH,2002,Student,2,16,1,0,0,19,1,11,0,0,0,12,31
HIMACHAL PRADESH,2002,Unemployed,0,11,6,7,1,25,0,3,1,0,0,4,29
HIMACHAL PRADESH,2002,Self-employed (Business activity),0,12,17,0,0,29,0,0,0,0,1,1,30
HIMACHAL PRADESH,2002,Professional Activity,0,0,12,0,0,12,0,0,1,0,0,1,13
HIMACHAL PRADESH,2002,Farming/Agriculture Activity,0,7,12,3,2,24,0,0,0,1,0,1,25
HIMACHAL PRADESH,2002,Others (Please Specify),0,8,4,5,1,18,0,1,0,0,0,1,19
HIMACHAL PRADESH,2002,Retired Person,0,0,0,0,0,0,0,0,0,0,0,0,0
HIMACHAL PRADESH,2002,Others (Please Specify),2,22,18,10,2,54,0,14,5,1,0,20,74
HIMACHAL PRADESH,2002,Total,4,87,82,29,6,208,3,76,37,8,2,126,334
HIMACHAL PRADESH,2002,Total Salaried,0,11,12,4,0,27,0,1,1,1,0,3,30
HIMACHAL PRADESH,2002,Total Self-employed,0,27,45,8,3,83,0,1,1,1,1,4,87
HIMACHAL PRADESH,2003,House Wife,0,0,0,0,0,0,0,37,25,10,0,72,72
HIMACHAL PRADESH,2003,Service (Government),0,1,8,5,0,14,0,0,1,1,0,2,16
HIMACHAL PRADESH,2003,Service (Private),0,8,12,9,1,30,0,1,1,0,0,2,32
HIMACHAL PRADESH,2003,Public Sector Undertaking,0,0,2,0,0,2,0,0,0,0,0,0,2
HIMACHAL PRADESH,2003,Student,2,9,0,0,0,11,4,15,0,0,0,19,30
HIMACHAL PRADESH,2003,Unemployed,0,24,15,0,2,41,0,1,0,0,0,1,42
HIMACHAL PRADESH,2003,Self-employed (Business activity),0,0,5,6,2,13,0,0,0,0,0,0,13
HIMACHAL PRADESH,2003,Professional Activity,0,1,0,0,1,2,0,0,0,0,0,0,2
HIMACHAL PRADESH,2003,Farming/Agriculture Activity,0,5,13,10,1,29,0,2,3,0,0,5,34
HIMACHAL PRADESH,2003,Others (Please Specify),0,7,14,17,4,42,1,3,1,1,0,6,48
HIMACHAL PRADESH,2003,Retired Person,0,0,0,0,1,1,0,0,0,0,0,0,1
HIMACHAL PRADESH,2003,Others (Please Specify),0,23,12,16,4,55,0,13,15,9,2,39,94
HIMACHAL PRADESH,2003,Total,2,78,81,63,16,240,5,72,46,21,2,146,386
HIMACHAL PRADESH,2003,Total Salaried,0,9,22,14,1,46,0,1,2,1,0,4,50
HIMACHAL PRADESH,2003,Total Self-employed,0,13,32,33,8,86,1,5,4,1,0,11,97
HIMACHAL PRADESH,2004,House Wife,0,0,0,0,0,0,0,40,24,9,2,75,75
HIMACHAL PRADESH,2004,Service (Government),0,6,4,3,0,13,0,0,0,1,0,1,14
HIMACHAL PRADESH,2004,Service (Private),1,21,21,4,2,49,0,1,1,0,0,2,51
HIMACHAL PRADESH,2004,Public Sector Undertaking,0,1,0,1,0,2,0,0,0,0,0,0,2
HIMACHAL PRADESH,2004,Student,4,7,0,0,0,11,2,9,1,0,0,12,23
HIMACHAL PRADESH,2004,Unemployed,0,18,10,2,4,34,0,12,0,0,0,12,46
HIMACHAL PRADESH,2004,Self-employed (Business activity),0,5,3,3,0,11,0,1,0,0,0,1,12
HIMACHAL PRADESH,2004,Professional Activity,0,0,0,1,0,1,0,0,0,0,0,0,1
HIMACHAL PRADESH,2004,Farming/Agriculture Activity,0,14,14,13,2,43,0,3,4,1,1,9,52
HIMACHAL PRADESH,2004,Others (Please Specify),0,5,15,8,1,29,0,5,5,0,0,10,39
HIMACHAL PRADESH,2004,Retired Person,0,0,0,0,0,0,0,0,0,0,0,0,0
HIMACHAL PRADESH,2004,Others (Please Specify),0,0,15,19,9,43,2,0,7,3,1,13,56
HIMACHAL PRADESH,2004,Total,5,77,82,54,18,236,4,71,42,14,4,135,371
HIMACHAL PRADESH,2004,Total Salaried,1,28,25,8,2,64,0,1,1,1,0,3,67
HIMACHAL PRADESH,2004,Total Self-employed,0,24,32,25,3,84,0,9,9,1,1,20,104
HIMACHAL PRADESH,2005,House Wife,0,0,0,0,0,0,0,41,26,8,0,75,75
HIMACHAL PRADESH,2005,Service (Government),0,1,9,4,0,14,0,1,1,0,0,2,16
HIMACHAL PRADESH,2005,Service (Private),0,10,14,4,1,29,0,0,0,0,0,0,29
HIMACHAL PRADESH,2005,Public Sector Undertaking,0,1,5,1,0,7,0,1,0,0,0,1,8
HIMACHAL PRADESH,2005,Student,0,9,1,0,0,10,1,14,0,0,0,15,25
HIMACHAL PRADESH,2005,Unemployed,0,9,9,1,0,19,0,5,3,0,0,8,27
HIMACHAL PRADESH,2005,Self-employed (Business activity),0,2,3,2,0,7,0,0,0,0,0,0,7
HIMACHAL PRADESH,2005,Professional Activity,0,1,3,0,0,4,0,0,0,0,0,0,4
HIMACHAL PRADESH,2005,Farming/Agriculture Activity,0,8,3,7,2,20,0,0,0,0,0,0,20
HIMACHAL PRADESH,2005,Others (Please Specify),0,12,24,16,12,64,0,4,6,4,1,15,79
HIMACHAL PRADESH,2005,Retired Person,0,0,0,0,0,0,0,0,0,0,0,0,0
HIMACHAL PRADESH,2005,Others (Please Specify),2,16,15,7,0,40,0,15,11,1,2,29,69
HIMACHAL PRADESH,2005,Total,2,69,86,42,15,214,1,81,47,13,3,145,359
HIMACHAL PRADESH,2005,Total Salaried,0,12,28,9,1,50,0,2,1,0,0,3,53
HIMACHAL PRADESH,2005,Total Self-employed,0,23,33,25,14,95,0,4,6,4,1,15,110
HIMACHAL PRADESH,2006,House Wife,0,0,0,0,0,0,0,31,22,21,4,78,78
HIMACHAL PRADESH,2006,Service (Government),0,7,8,6,0,21,0,0,0,1,0,1,22
HIMACHAL PRADESH,2006,Service (Private),0,12,19,15,1,47,0,6,1,3,0,10,57
HIMACHAL PRADESH,2006,Public Sector Undertaking,0,10,24,4,2,40,0,1,0,0,0,1,41
HIMACHAL PRADESH,2006,Student,4,14,2,0,0,20,1,18,1,0,0,20,40
HIMACHAL PRADESH,2006,Unemployed,0,10,13,8,1,32,0,0,0,0,0,0,32
HIMACHAL PRADESH,2006,Self-employed (Business activity),0,3,7,3,4,17,0,0,0,0,0,0,17
HIMACHAL PRADESH,2006,Professional Activity,0,0,3,1,0,4,0,0,0,0,0,0,4
HIMACHAL PRADESH,2006,Farming/Agriculture Activity,0,7,11,3,1,22,0,0,0,0,0,0,22
HIMACHAL PRADESH,2006,Others (Please Specify),0,2,0,0,0,2,0,0,0,0,0,0,2
HIMACHAL PRADESH,2006,Retired Person,0,0,0,0,1,1,0,0,0,0,0,0,1
HIMACHAL PRADESH,2006,Others (Please Specify),0,25,34,25,11,95,0,11,19,12,4,46,141
HIMACHAL PRADESH,2006,Total,4,90,121,65,21,301,1,67,43,37,8,156,457
HIMACHAL PRADESH,2006,Total Salaried,0,29,51,25,3,108,0,7,1,4,0,12,120
HIMACHAL PRADESH,2006,Total Self-employed,0,12,21,7,5,45,0,0,0,0,0,0,45
HIMACHAL PRADESH,2007,House Wife,0,0,0,0,0,0,0,31,16,5,4,56,56
HIMACHAL PRADESH,2007,Service (Government),0,2,7,2,0,11,0,0,0,0,0,0,11
HIMACHAL PRADESH,2007,Service (Private),0,18,21,6,1,46,0,1,2,1,0,4,50
HIMACHAL PRADESH,2007,Public Sector Undertaking,0,4,3,4,1,12,0,1,2,0,0,3,15
HIMACHAL PRADESH,2007,Student,2,11,0,0,0,13,0,20,2,0,0,22,35
HIMACHAL PRADESH,2007,Unemployed,0,12,7,3,1,23,0,2,2,0,0,4,27
HIMACHAL PRADESH,2007,Self-employed (Business activity),0,6,10,7,2,25,0,1,2,0,0,3,28
HIMACHAL PRADESH,2007,Professional Activity,0,2,4,1,1,8,0,0,1,1,0,2,10
HIMACHAL PRADESH,2007,Farming/Agriculture Activity,0,0,11,3,0,14,0,0,1,0,0,1,15
HIMACHAL PRADESH,2007,Others (Please Specify),0,20,17,9,20,66,0,5,7,3,8,23,89
HIMACHAL PRADESH,2007,Retired Person,0,0,0,0,1,1,0,0,0,0,0,0,1
HIMACHAL PRADESH,2007,Others (Please Specify),0,17,18,3,1,39,0,11,11,1,3,26,65
HIMACHAL PRADESH,2007,Total,2,92,98,38,28,258,0,72,46,11,15,144,402
HIMACHAL PRADESH,2007,Total Salaried,0,24,31,12,2,69,0,2,4,1,0,7,76
HIMACHAL PRADESH,2007,Total Self-employed,0,28,42,20,23,113,0,6,11,4,8,29,142
HIMACHAL PRADESH,2008,House Wife,0,0,0,0,0,0,0,38,29,11,9,87,87
HIMACHAL PRADESH,2008,Service (Government),0,6,5,8,0,19,0,1,0,1,0,2,21
HIMACHAL PRADESH,2008,Service (Private),0,20,10,8,1,39,0,3,5,1,1,10,49
HIMACHAL PRADESH,2008,Public Sector Undertaking,0,6,5,4,1,16,0,4,1,2,0,7,23
HIMACHAL PRADESH,2008,Student,3,17,0,0,0,20,5,10,0,1,0,16,36
HIMACHAL PRADESH,2008,Unemployed,0,16,11,2,0,29,0,9,0,0,0,9,38
HIMACHAL PRADESH,2008,Self-employed (Business activity),0,5,13,8,5,31,0,0,1,0,0,1,32
HIMACHAL PRADESH,2008,Professional Activity,0,3,3,3,0,9,0,1,2,1,1,5,14
HIMACHAL PRADESH,2008,Farming/Agriculture Activity,3,36,42,46,23,150,3,14,10,4,7,38,188
HIMACHAL PRADESH,2008,Others (Please Specify),0,22,16,22,6,66,2,10,4,2,0,18,84
HIMACHAL PRADESH,2008,Retired Person,0,0,0,1,2,3,0,0,0,0,0,0,3
HIMACHAL PRADESH,2008,Others (Please Specify),0,9,10,14,2,35,0,13,5,2,0,20,55
HIMACHAL PRADESH,2008,Total,6,140,115,116,40,417,10,103,57,25,18,213,630
HIMACHAL PRADESH,2008,Total Salaried,0,32,20,20,2,74,0,8,6,4,1,19,93
HIMACHAL PRADESH,2008,Total Self-employed,3,66,74,79,34,256,5,25,17,7,8,62,318
HIMACHAL PRADESH,2009,House Wife,0,0,0,0,0,0,0,38,32,14,10,94,94
HIMACHAL PRADESH,2009,Service (Government),0,5,13,8,0,26,0,0,5,1,0,6,32
HIMACHAL PRADESH,2009,Service (Private),0,11,19,5,0,35,0,2,2,3,0,7,42
HIMACHAL PRADESH,2009,Public Sector Undertaking,0,7,3,5,3,18,0,2,0,3,1,6,24
HIMACHAL PRADESH,2009,Student,2,21,2,0,0,25,4,21,0,0,0,25,50
HIMACHAL PRADESH,2009,Unemployed,0,22,15,11,4,52,0,3,6,1,2,12,64
HIMACHAL PRADESH,2009,Self-employed (Business activity),0,1,9,3,3,16,0,0,1,0,0,1,17
HIMACHAL PRADESH,2009,Professional Activity,0,0,3,0,0,3,0,0,0,0,0,0,3
HIMACHAL PRADESH,2009,Farming/Agriculture Activity,0,1,8,10,5,24,0,0,0,0,0,0,24
HIMACHAL PRADESH,2009,Others (Please Specify),1,7,12,11,5,36,0,3,2,1,1,7,43
HIMACHAL PRADESH,2009,Retired Person,0,0,0,0,4,4,0,0,0,0,1,1,5
HIMACHAL PRADESH,2009,Others (Please Specify),2,51,44,19,11,127,7,15,7,3,3,35,162
HIMACHAL PRADESH,2009,Total,5,126,128,72,35,366,11,84,55,26,18,194,560
HIMACHAL PRADESH,2009,Total Salaried,0,23,35,18,3,79,0,4,7,7,1,19,98
HIMACHAL PRADESH,2009,Total Self-employed,1,9,32,24,13,79,0,3,3,1,1,8,87
HIMACHAL PRADESH,2010,House Wife,0,0,0,0,0,0,0,44,24,15,5,88,88
HIMACHAL PRADESH,2010,Service (Government),0,2,7,11,0,20,0,1,1,1,0,3,23
HIMACHAL PRADESH,2010,Service (Private),0,10,17,9,2,38,0,4,2,1,0,7,45
HIMACHAL PRADESH,2010,Public Sector Undertaking,0,3,6,2,1,12,0,2,1,2,1,6,18
HIMACHAL PRADESH,2010,Student,7,26,0,0,0,33,4,27,2,0,0,33,66
HIMACHAL PRADESH,2010,Unemployed,0,24,23,4,1,52,0,2,1,0,0,3,55
HIMACHAL PRADESH,2010,Self-employed (Business activity),0,4,5,7,3,19,0,1,2,1,1,5,24
HIMACHAL PRADESH,2010,Professional Activity,0,10,4,6,1,21,0,0,1,0,0,1,22
HIMACHAL PRADESH,2010,Farming/Agriculture Activity,0,12,24,15,8,59,0,2,0,0,0,2,61
HIMACHAL PRADESH,2010,Others (Please Specify),0,14,15,7,1,37,0,7,7,5,3,22,59
HIMACHAL PRADESH,2010,Retired Person,0,0,1,4,2,7,0,0,0,0,0,0,7
HIMACHAL PRADESH,2010,Others (Please Specify),1,12,23,8,6,50,0,7,10,6,1,24,74
HIMACHAL PRADESH,2010,Total,8,117,125,73,25,348,4,97,51,31,11,194,542
HIMACHAL PRADESH,2010,Total Salaried,0,15,30,22,3,70,0,7,4,4,1,16,86
HIMACHAL PRADESH,2010,Total Self-employed,0,40,48,35,13,136,0,10,10,6,4,30,166
HIMACHAL PRADESH,2011,House Wife,0,0,0,0,0,0,0,23,29,11,2,65,65
HIMACHAL PRADESH,2011,Service (Government),0,1,5,4,0,10,0,0,2,1,0,3,13
HIMACHAL PRADESH,2011,Service (Private),0,17,15,8,1,41,0,1,3,1,0,5,46
HIMACHAL PRADESH,2011,Public Sector Undertaking,0,6,10,4,1,21,0,2,2,2,1,7,28
HIMACHAL PRADESH,2011,Student,2,20,0,0,0,22,3,21,0,0,0,24,46
HIMACHAL PRADESH,2011,Unemployed,0,9,7,0,1,17,0,4,2,0,0,6,23
HIMACHAL PRADESH,2011,Self-employed (Business activity),0,3,7,7,2,19,0,0,3,1,1,5,24
HIMACHAL PRADESH,2011,Professional Activity,0,0,1,2,2,5,0,0,2,0,0,2,7
HIMACHAL PRADESH,2011,Farming/Agriculture Activity,0,8,14,10,10,42,0,3,0,1,0,4,46
HIMACHAL PRADESH,2011,Others (Please Specify),0,13,10,6,6,35,1,2,9,5,4,21,56
HIMACHAL PRADESH,2011,Retired Person,0,0,0,0,0,0,0,0,0,0,0,0,0
HIMACHAL PRADESH,2011,Others (Please Specify),3,21,19,5,9,57,1,10,10,8,3,32,89
HIMACHAL PRADESH,2011,Total,5,98,88,46,32,269,5,66,62,30,11,174,443
HIMACHAL PRADESH,2011,Total Salaried,0,24,30,16,2,72,0,3,7,4,1,15,87
HIMACHAL PRADESH,2011,Total Self-employed,0,24,32,25,20,101,1,5,14,7,5,32,133
HIMACHAL PRADESH,2012,House Wife,0,0,0,0,0,0,0,40,25,12,3,80,80
HIMACHAL PRADESH,2012,Service (Government),0,0,3,3,0,6,0,2,1,1,0,4,10
HIMACHAL PRADESH,2012,Service (Private),0,10,12,9,1,32,0,2,4,1,0,7,39
HIMACHAL PRADESH,2012,Public Sector Undertaking,0,6,9,4,1,20,0,3,2,2,1,8,28
HIMACHAL PRADESH,2012,Student,5,24,0,0,0,29,3,15,0,0,0,18,47
HIMACHAL PRADESH,2012,Unemployed,1,19,14,5,1,40,0,3,1,0,0,4,44
HIMACHAL PRADESH,2012,Self-employed (Business activity),0,10,10,8,4,32,0,1,2,1,0,4,36
HIMACHAL PRADESH,2012,Professional Activity,0,1,2,2,1,6,0,1,1,0,0,2,8
HIMACHAL PRADESH,2012,Farming/Agriculture Activity,0,4,12,8,3,27,0,0,1,1,0,2,29
HIMACHAL PRADESH,2012,Others (Please Specify),0,8,14,11,4,37,1,0,3,4,4,12,49
HIMACHAL PRADESH,2012,Retired Person,0,0,0,0,3,3,0,0,0,0,0,0,3
HIMACHAL PRADESH,2012,Others (Please Specify),4,30,43,22,23,122,2,8,12,4,7,33,155
HIMACHAL PRADESH,2012,Total,10,112,119,72,41,354,6,75,52,26,15,174,528
HIMACHAL PRADESH,2012,Total Salaried,0,16,24,16,2,58,0,7,7,4,1,19,77
HIMACHAL PRADESH,2012,Total Self-employed,0,23,38,29,12,102,1,2,7,6,4,20,122
JAMMU & KASHMIR,2001,House Wife,0,0,0,0,0,0,0,18,13,4,1,36,36
JAMMU & KASHMIR,2001,Service (Government),0,1,7,1,0,9,0,0,0,0,0,0,9
JAMMU & KASHMIR,2001,Service (Private),0,0,2,0,0,2,0,0,0,0,0,0,2
JAMMU & KASHMIR,2001,Public Sector Undertaking,0,0,1,0,0,1,0,0,0,0,0,0,1
JAMMU & KASHMIR,2001,Student,0,5,0,0,0,5,0,1,0,0,0,1,6
JAMMU & KASHMIR,2001,Unemployed,0,3,4,4,1,12,0,3,0,0,0,3,15
JAMMU & KASHMIR,2001,Self-employed (Business activity),0,1,1,0,0,2,0,0,0,0,0,0,2
JAMMU & KASHMIR,2001,Professional Activity,2,0,0,0,0,2,0,0,0,0,0,0,2
JAMMU & KASHMIR,2001,Farming/Agriculture Activity,0,5,4,3,0,12,1,0,1,1,0,3,15
JAMMU & KASHMIR,2001,Others (Please Specify),0,3,4,1,0,8,0,4,0,0,0,4,12
JAMMU & KASHMIR,2001,Retired Person,0,0,0,0,0,0,0,0,0,0,0,0,0
JAMMU & KASHMIR,2001,Others (Please Specify),0,11,8,9,10,38,1,5,7,0,2,15,53
JAMMU & KASHMIR,2001,Total,2,29,31,18,11,91,2,31,21,5,3,62,153
JAMMU & KASHMIR,2001,Total Salaried,0,1,10,1,0,12,0,0,0,0,0,0,12
JAMMU & KASHMIR,2001,Total Self-employed,2,9,9,4,0,24,1,4,1,1,0,7,31
JAMMU & KASHMIR,2002,House Wife,0,0,0,0,0,0,0,39,11,3,0,53,53
JAMMU & KASHMIR,2002,Service (Government),0,2,8,1,0,11,0,0,0,0,0,0,11
JAMMU & KASHMIR,2002,Service (Private),0,3,3,1,1,8,0,0,0,0,0,0,8
JAMMU & KASHMIR,2002,Public Sector Undertaking,0,1,1,0,0,2,0,0,0,0,0,0,2
JAMMU & KASHMIR,2002,Student,1,3,3,1,0,8,0,3,1,0,0,4,12
JAMMU & KASHMIR,2002,Unemployed,3,9,4,0,0,16,0,3,1,0,0,4,20
JAMMU & KASHMIR,2002,Self-employed (Business activity),0,0,0,0,0,0,0,0,0,0,0,0,0
JAMMU & KASHMIR,2002,Professional Activity,0,0,0,0,0,0,0,0,0,0,0,0,0
JAMMU & KASHMIR,2002,Farming/Agriculture Activity,0,9,4,1,1,15,0,1,0,0,0,1,16
JAMMU & KASHMIR,2002,Others (Please Specify),0,7,8,8,1,24,0,7,7,3,0,17,41
JAMMU & KASHMIR,2002,Retired Person,0,0,0,0,0,0,0,0,0,0,0,0,0
JAMMU & KASHMIR,2002,Others (Please Specify),0,4,5,2,1,12,0,8,1,0,0,9,21
JAMMU & KASHMIR,2002,Total,4,38,36,14,4,96,0,61,21,6,0,88,184
JAMMU & KASHMIR,2002,Total Salaried,0,6,12,2,1,21,0,0,0,0,0,0,21
JAMMU & KASHMIR,2002,Total Self-employed,0,16,12,9,2,39,0,8,7,3,0,18,57
JAMMU & KASHMIR,2003,House Wife,0,0,0,0,0,0,1,26,12,0,2,41,41
JAMMU & KASHMIR,2003,Service (Government),0,2,3,0,0,5,0,0,0,0,0,0,5
JAMMU & KASHMIR,2003,Service (Private),0,0,0,0,0,0,0,0,0,0,0,0,0
JAMMU & KASHMIR,2003,Public Sector Undertaking,0,0,0,0,0,0,0,0,0,0,0,0,0
JAMMU & KASHMIR,2003,Student,0,2,0,0,0,2,0,2,0,0,0,2,4
JAMMU & KASHMIR,2003,Unemployed,0,3,1,0,0,4,0,0,0,0,0,0,4
JAMMU & KASHMIR,2003,Self-employed (Business activity),0,0,0,0,0,0,0,0,0,0,0,0,0
JAMMU & KASHMIR,2003,Professional Activity,0,0,0,0,0,0,0,0,0,0,0,0,0
JAMMU & KASHMIR,2003,Farming/Agriculture Activity,0,4,0,1,0,5,1,0,2,0,0,3,8
JAMMU & KASHMIR,2003,Others (Please Specify),0,2,2,1,0,5,0,2,0,0,0,2,7
JAMMU & KASHMIR,2003,Retired Person,0,0,0,0,0,0,0,0,0,0,0,0,0
JAMMU & KASHMIR,2003,Others (Please Specify),1,17,13,7,4,42,3,13,7,3,1,27,69
JAMMU & KASHMIR,2003,Total,1,30,19,9,4,63,5,43,21,3,3,75,138
JAMMU & KASHMIR,2003,Total Salaried,0,2,3,0,0,5,0,0,0,0,0,0,5
JAMMU & KASHMIR,2003,Total Self-employed,0,6,2,2,0,10,1,2,2,0,0,5,15
JAMMU & KASHMIR,2004,House Wife,0,0,0,0,0,0,0,13,16,0,0,29,29
JAMMU & KASHMIR,2004,Service (Government),0,2,2,0,0,4,0,0,0,0,0,0,4
JAMMU & KASHMIR,2004,Service (Private),0,0,0,0,0,0,0,0,0,0,0,0,0
JAMMU & KASHMIR,2004,Public Sector Undertaking,0,0,0,0,0,0,0,1,0,0,0,1,1
JAMMU & KASHMIR,2004,Student,0,3,0,0,0,3,0,3,0,0,0,3,6
JAMMU & KASHMIR,2004,Unemployed,0,6,0,0,0,6,0,0,0,0,0,0,6
JAMMU & KASHMIR,2004,Self-employed (Business activity),0,0,0,0,0,0,0,0,0,0,0,0,0
JAMMU & KASHMIR,2004,Professional Activity,0,0,0,0,0,0,0,0,0,0,0,0,0
JAMMU & KASHMIR,2004,Farming/Agriculture Activity,0,0,0,1,0,1,0,0,0,0,0,0,1
JAMMU & KASHMIR,2004,Others (Please Specify),0,0,5,0,0,5,0,4,5,1,0,10,15
JAMMU & KASHMIR,2004,Retired Person,0,0,0,0,0,0,0,0,0,0,0,0,0
JAMMU & KASHMIR,2004,Others (Please Specify),0,16,9,7,0,32,0,8,8,2,0,18,50
JAMMU & KASHMIR,2004,Total,0,27,16,8,0,51,0,29,29,3,0,61,112
JAMMU & KASHMIR,2004,Total Salaried,0,2,2,0,0,4,0,1,0,0,0,1,5
JAMMU & KASHMIR,2004,Total Self-employed,0,0,5,1,0,6,0,4,5,1,0,10,16
JAMMU & KASHMIR,2005,House Wife,0,0,0,0,0,0,0,17,14,1,0,32,32
JAMMU & KASHMIR,2005,Service (Government),0,14,4,0,0,18,0,0,0,0,0,0,18
JAMMU & KASHMIR,2005,Service (Private),0,23,11,0,0,34,0,0,0,0,0,0,34
JAMMU & KASHMIR,2005,Public Sector Undertaking,0,0,0,0,0,0,0,0,0,0,0,0,0
JAMMU & KASHMIR,2005,Student,1,14,5,0,0,20,1,3,0,0,0,4,24
JAMMU & KASHMIR,2005,Unemployed,0,18,8,1,0,27,0,3,10,0,0,13,40
JAMMU & KASHMIR,2005,Self-employed (Business activity),0,0,0,0,0,0,0,0,0,0,0,0,0
JAMMU & KASHMIR,2005,Professional Activity,0,0,0,0,0,0,0,0,0,0,0,0,0
JAMMU & KASHMIR,2005,Farming/Agriculture Activity,0,1,0,0,0,1,0,1,0,0,0,1,2
JAMMU & KASHMIR,2005,Others (Please Specify),0,19,9,5,0,33,0,17,9,0,2,28,61
JAMMU & KASHMIR,2005,Retired Person,0,6,0,1,0,7,0,0,0,0,0,0,7
JAMMU & KASHMIR,2005,Others (Please Specify),2,18,22,10,4,56,3,13,3,0,1,20,76
JAMMU & KASHMIR,2005,Total,3,113,59,17,4,196,4,54,36,1,3,98,294
JAMMU & KASHMIR,2005,Total Salaried,0,37,15,0,0,52,0,0,0,0,0,0,52
JAMMU & KASHMIR,2005,Total Self-employed,0,20,9,5,0,34,0,18,9,0,2,29,63
JAMMU & KASHMIR,2006,House Wife,0,0,0,0,0,0,0,20,20,2,0,42,42
JAMMU & KASHMIR,2006,Service (Government),0,11,9,4,0,24,0,2,1,0,0,3,27
JAMMU & KASHMIR,2006,Service (Private),0,2,2,3,1,8,0,2,1,1,0,4,12
JAMMU & KASHMIR,2006,Public Sector Undertaking,0,1,0,1,0,2,0,0,0,0,0,0,2
JAMMU & KASHMIR,2006,Student,0,7,0,0,0,7,0,15,0,0,0,15,22
JAMMU & KASHMIR,2006,Unemployed,0,15,11,0,0,26,0,6,1,1,0,8,34
JAMMU & KASHMIR,2006,Self-employed (Business activity),0,1,1,0,0,2,0,0,0,0,0,0,2
JAMMU & KASHMIR,2006,Professional Activity,0,0,0,0,0,0,0,5,0,0,0,5,5
JAMMU & KASHMIR,2006,Farming/Agriculture Activity,1,10,12,6,1,30,0,2,1,1,0,4,34
JAMMU & KASHMIR,2006,Others (Please Specify),0,6,6,7,1,20,0,8,5,4,0,17,37
JAMMU & KASHMIR,2006,Retired Person,0,0,0,0,2,2,0,0,0,0,0,0,2
JAMMU & KASHMIR,2006,Others (Please Specify),0,11,15,4,1,31,0,8,4,0,0,12,43
JAMMU & KASHMIR,2006,Total,1,64,56,25,6,152,0,68,33,9,0,110,262
JAMMU & KASHMIR,2006,Total Salaried,0,14,11,8,1,34,0,4,2,1,0,7,41
JAMMU & KASHMIR,2006,Total Self-employed,1,17,19,13,2,52,0,15,6,5,0,26,78
JAMMU & KASHMIR,2007,House Wife,0,0,0,0,0,0,0,26,21,4,2,53,53
JAMMU & KASHMIR,2007,Service (Government),0,5,6,1,0,12,0,1,1,0,0,2,14
JAMMU & KASHMIR,2007,Service (Private),0,2,5,3,0,10,0,1,0,0,0,1,11
JAMMU & KASHMIR,2007,Public Sector Undertaking,0,4,1,0,0,5,0,2,0,0,0,2,7
JAMMU & KASHMIR,2007,Student,0,13,1,0,0,14,0,10,0,0,0,10,24
JAMMU & KASHMIR,2007,Unemployed,0,16,5,4,0,25,0,3,0,0,0,3,28
JAMMU & KASHMIR,2007,Self-employed (Business activity),0,1,1,1,0,3,0,0,0,0,0,0,3
JAMMU & KASHMIR,2007,Professional Activity,0,2,1,0,0,3,0,0,0,0,0,0,3
JAMMU & KASHMIR,2007,Farming/Agriculture Activity,0,9,10,9,3,31,0,1,1,0,0,2,33
JAMMU & KASHMIR,2007,Others (Please Specify),0,4,11,0,1,16,0,1,0,0,0,1,17
JAMMU & KASHMIR,2007,Retired Person,0,0,1,1,2,4,0,0,0,0,0,0,4
JAMMU & KASHMIR,2007,Others (Please Specify),0,9,15,4,2,30,0,6,1,0,0,7,37
JAMMU & KASHMIR,2007,Total,0,65,57,23,8,153,0,51,24,4,2,81,234
JAMMU & KASHMIR,2007,Total Salaried,0,11,12,4,0,27,0,4,1,0,0,5,32
JAMMU & KASHMIR,2007,Total Self-employed,0,16,23,10,4,53,0,2,1,0,0,3,56
JAMMU & KASHMIR,2008,House Wife,0,0,0,0,0,0,0,38,36,1,0,75,75
JAMMU & KASHMIR,2008,Service (Government),0,4,12,9,0,25,0,1,2,0,0,3,28
JAMMU & KASHMIR,2008,Service (Private),0,5,11,6,0,22,0,2,3,0,0,5,27
JAMMU & KASHMIR,2008,Public Sector Undertaking,0,1,5,13,1,20,0,1,0,0,0,1,21
JAMMU & KASHMIR,2008,Student,0,7,0,0,0,7,1,8,0,0,0,9,16
JAMMU & KASHMIR,2008,Unemployed,0,16,19,1,1,37,0,12,2,0,0,14,51
JAMMU & KASHMIR,2008,Self-employed (Business activity),0,0,3,2,1,6,0,0,0,0,0,0,6
JAMMU & KASHMIR,2008,Professional Activity,0,0,1,2,1,4,0,0,0,0,0,0,4
JAMMU & KASHMIR,2008,Farming/Agriculture Activity,0,2,1,1,0,4,0,2,0,0,0,2,6
JAMMU & KASHMIR,2008,Others (Please Specify),0,11,6,3,3,23,0,9,3,0,0,12,35
JAMMU & KASHMIR,2008,Retired Person,0,0,0,0,6,6,0,0,0,0,0,0,6
JAMMU & KASHMIR,2008,Others (Please Specify),1,10,5,4,3,23,0,7,5,0,0,12,35
JAMMU & KASHMIR,2008,Total,1,56,63,41,16,177,1,80,51,1,0,133,310
JAMMU & KASHMIR,2008,Total Salaried,0,10,28,28,1,67,0,4,5,0,0,9,76
JAMMU & KASHMIR,2008,Total Self-employed,0,13,11,8,5,37,0,11,3,0,0,14,51
JAMMU & KASHMIR,2009,House Wife,0,0,0,0,0,0,0,34,14,1,1,50,50
JAMMU & KASHMIR,2009,Service (Government),0,8,14,4,0,26,0,3,4,2,0,9,35
JAMMU & KASHMIR,2009,Service (Private),0,4,11,6,3,24,0,2,3,1,0,6,30
JAMMU & KASHMIR,2009,Public Sector Undertaking,0,1,2,1,2,6,0,0,1,0,0,1,7
JAMMU & KASHMIR,2009,Student,0,3,1,0,0,4,0,12,4,0,0,16,20
JAMMU & KASHMIR,2009,Unemployed,0,12,20,9,0,41,0,9,10,2,0,21,62
JAMMU & KASHMIR,2009,Self-employed (Business activity),0,1,5,7,4,17,0,1,0,0,0,1,18
JAMMU & KASHMIR,2009,Professional Activity,0,0,2,0,0,2,0,1,0,0,0,1,3
JAMMU & KASHMIR,2009,Farming/Agriculture Activity,0,6,1,0,1,8,0,0,0,0,0,0,8
JAMMU & KASHMIR,2009,Others (Please Specify),0,3,10,5,3,21,2,5,6,3,3,19,40
JAMMU & KASHMIR,2009,Retired Person,0,0,0,0,0,0,0,0,0,0,0,0,0
JAMMU & KASHMIR,2009,Others (Please Specify),0,6,8,2,3,19,0,14,12,1,2,29,48
JAMMU & KASHMIR,2009,Total,0,44,74,34,16,168,2,81,54,10,6,153,321
JAMMU & KASHMIR,2009,Total Salaried,0,13,27,11,5,56,0,5,8,3,0,16,72
JAMMU & KASHMIR,2009,Total Self-employed,0,10,18,12,8,48,2,7,6,3,3,21,69
JAMMU & KASHMIR,2010,House Wife,0,0,0,0,0,0,0,30,24,4,0,58,58
JAMMU & KASHMIR,2010,Service (Government),0,2,2,0,0,4,0,1,1,0,0,2,6
JAMMU & KASHMIR,2010,Service (Private),0,1,9,3,0,13,0,0,0,0,0,0,13
JAMMU & KASHMIR,2010,Public Sector Undertaking,0,1,1,0,0,2,0,0,0,0,0,0,2
JAMMU & KASHMIR,2010,Student,3,11,3,0,0,17,2,12,3,2,0,19,36
JAMMU & KASHMIR,2010,Unemployed,0,12,11,4,0,27,1,12,3,0,0,16,43
JAMMU & KASHMIR,2010,Self-employed (Business activity),0,1,2,4,2,9,0,0,0,0,0,0,9
JAMMU & KASHMIR,2010,Professional Activity,0,2,0,0,0,2,0,0,1,0,0,1,3
JAMMU & KASHMIR,2010,Farming/Agriculture Activity,0,3,8,4,1,16,0,2,0,0,0,2,18
JAMMU & KASHMIR,2010,Others (Please Specify),0,5,1,3,3,12,0,7,2,0,0,9,21
JAMMU & KASHMIR,2010,Retired Person,0,0,0,1,0,1,0,0,0,0,0,0,1
JAMMU & KASHMIR,2010,Others (Please Specify),0,8,3,7,1,19,0,22,5,2,1,30,49
JAMMU & KASHMIR,2010,Total,3,46,40,26,7,122,3,86,39,8,1,137,259
JAMMU & KASHMIR,2010,Total Salaried,0,4,12,3,0,19,0,1,1,0,0,2,21
JAMMU & KASHMIR,2010,Total Self-employed,0,11,11,11,6,39,0,9,3,0,0,12,51
JAMMU & KASHMIR,2011,House Wife,0,0,0,0,0,0,0,22,29,7,0,58,58
JAMMU & KASHMIR,2011,Service (Government),0,1,7,1,0,9,0,1,2,1,0,4,13
JAMMU & KASHMIR,2011,Service (Private),0,4,3,2,0,9,0,1,1,0,0,2,11
JAMMU & KASHMIR,2011,Public Sector Undertaking,0,0,2,2,0,4,0,0,0,0,0,0,4
JAMMU & KASHMIR,2011,Student,2,9,2,0,0,13,3,24,0,0,0,27,40
JAMMU & KASHMIR,2011,Unemployed,0,2,12,4,0,18,0,15,3,0,0,18,36
JAMMU & KASHMIR,2011,Self-employed (Business activity),0,2,6,4,1,13,0,2,0,0,0,2,15
JAMMU & KASHMIR,2011,Professional Activity,0,1,2,3,1,7,0,0,0,0,0,0,7
JAMMU & KASHMIR,2011,Farming/Agriculture Activity,0,0,3,6,2,11,0,2,0,1,0,3,14
JAMMU & KASHMIR,2011,Others (Please Specify),0,9,6,3,1,19,0,13,2,0,1,16,35
JAMMU & KASHMIR,2011,Retired Person,0,0,0,2,2,4,0,0,0,0,0,0,4
JAMMU & KASHMIR,2011,Others (Please Specify),2,12,10,12,1,37,2,7,2,2,0,13,50
JAMMU & KASHMIR,2011,Total,4,40,53,39,8,144,5,87,39,11,1,143,287
JAMMU & KASHMIR,2011,Total Salaried,0,5,12,5,0,22,0,2,3,1,0,6,28
JAMMU & KASHMIR,2011,Total Self-employed,0,12,17,16,5,50,0,17,2,1,1,21,71
JAMMU & KASHMIR,2012,House Wife,0,0,0,0,0,0,0,29,39,6,1,75,75
JAMMU & KASHMIR,2012,Service (Government),0,3,10,5,3,21,0,1,0,2,0,3,24
JAMMU & KASHMIR,2012,Service (Private),0,1,3,0,1,5,0,1,1,1,10,13,18
JAMMU & KASHMIR,2012,Public Sector Undertaking,0,0,0,0,0,0,0,0,0,0,0,0,0
JAMMU & KASHMIR,2012,Student,2,13,5,0,0,20,1,36,0,1,4,42,62
JAMMU & KASHMIR,2012,Unemployed,0,11,14,5,3,33,0,8,12,0,0,20,53
JAMMU & KASHMIR,2012,Self-employed (Business activity),0,5,3,2,0,10,0,0,0,0,0,0,10
JAMMU & KASHMIR,2012,Professional Activity,0,1,4,1,1,7,0,1,2,1,0,4,11
JAMMU & KASHMIR,2012,Farming/Agriculture Activity,0,3,5,2,0,10,0,0,0,0,0,0,10
JAMMU & KASHMIR,2012,Others (Please Specify),0,1,3,5,3,12,0,6,3,5,5,19,31
JAMMU & KASHMIR,2012,Retired Person,0,0,0,1,4,5,0,0,0,0,0,0,5
JAMMU & KASHMIR,2012,Others (Please Specify),0,18,27,19,5,69,1,19,11,3,12,46,115
JAMMU & KASHMIR,2012,Total,2,56,74,40,20,192,2,101,68,19,32,222,414
JAMMU & KASHMIR,2012,Total Salaried,0,4,13,5,4,26,0,2,1,3,10,16,42
JAMMU & KASHMIR,2012,Total Self-employed,0,10,15,10,4,39,0,7,5,6,5,23,62
JHARKHAND,2001,House Wife,0,0,0,0,0,0,1,29,21,8,0,59,59
JHARKHAND,2001,Service (Government),0,0,0,0,0,0,0,0,0,0,0,0,0
JHARKHAND,2001,Service (Private),0,0,3,1,0,4,0,0,2,0,0,2,6
JHARKHAND,2001,Public Sector Undertaking,0,0,3,0,0,3,0,0,2,0,0,2,5
JHARKHAND,2001,Student,3,3,0,0,0,6,0,1,0,0,0,1,7
JHARKHAND,2001,Unemployed,0,9,7,1,1,18,0,1,0,0,0,1,19
JHARKHAND,2001,Self-employed (Business activity),0,0,1,0,0,1,0,0,0,0,0,0,1
JHARKHAND,2001,Professional Activity,0,3,2,1,0,6,0,0,0,0,0,0,6
JHARKHAND,2001,Farming/Agriculture Activity,0,5,17,5,0,27,0,0,0,0,0,0,27
JHARKHAND,2001,Others (Please Specify),0,18,11,7,0,36,1,12,0,2,0,15,51
JHARKHAND,2001,Retired Person,0,0,0,0,0,0,0,0,0,0,0,0,0
JHARKHAND,2001,Others (Please Specify),1,7,12,11,9,40,3,7,6,13,0,29,69
JHARKHAND,2001,Total,4,45,56,26,10,141,5,50,31,23,0,109,250
JHARKHAND,2001,Total Salaried,0,0,6,1,0,7,0,0,4,0,0,4,11
JHARKHAND,2001,Total Self-employed,0,26,31,13,0,70,1,12,0,2,0,15,85
JHARKHAND,2002,House Wife,0,0,0,0,0,0,0,28,25,10,0,63,63
JHARKHAND,2002,Service (Government),0,0,0,0,0,0,0,0,0,0,0,0,0
JHARKHAND,2002,Service (Private),0,0,4,1,0,5,0,0,3,0,0,3,8
JHARKHAND,2002,Public Sector Undertaking,0,0,2,1,0,3,0,0,2,1,0,3,6
JHARKHAND,2002,Student,3,4,0,0,0,7,0,3,0,0,0,3,10
JHARKHAND,2002,Unemployed,0,8,8,11,0,27,0,1,1,0,0,2,29
JHARKHAND,2002,Self-employed (Business activity),0,0,2,1,0,3,0,0,1,0,0,1,4
JHARKHAND,2002,Professional Activity,0,4,1,2,2,9,0,0,0,0,0,0,9
JHARKHAND,2002,Farming/Agriculture Activity,0,4,14,3,0,21,0,0,0,0,0,0,21
JHARKHAND,2002,Others (Please Specify),0,18,10,6,0,34,0,10,0,2,0,12,46
JHARKHAND,2002,Retired Person,0,2,0,0,0,2,0,0,0,0,0,0,2
JHARKHAND,2002,Others (Please Specify),6,5,11,11,9,42,4,5,8,15,0,32,74
JHARKHAND,2002,Total,9,45,52,36,11,153,4,47,40,28,0,119,272
JHARKHAND,2002,Total Salaried,0,0,6,2,0,8,0,0,5,1,0,6,14
JHARKHAND,2002,Total Self-employed,0,26,27,12,2,67,0,10,1,2,0,13,80
JHARKHAND,2003,House Wife,0,0,0,0,0,0,0,28,25,10,0,63,63
JHARKHAND,2003,Service (Government),0,0,0,0,0,0,0,0,0,0,0,0,0
JHARKHAND,2003,Service (Private),0,0,4,1,0,5,0,0,3,0,0,3,8
JHARKHAND,2003,Public Sector Undertaking,0,0,2,1,0,3,0,0,2,1,0,3,6
JHARKHAND,2003,Student,3,4,0,0,0,7,0,3,0,0,0,3,10
JHARKHAND,2003,Unemployed,0,8,8,11,0,27,0,1,1,0,0,2,29
JHARKHAND,2003,Self-employed (Business activity),0,0,2,1,0,3,0,0,1,0,0,1,4
JHARKHAND,2003,Professional Activity,0,4,1,2,2,9,0,0,0,0,0,0,9
JHARKHAND,2003,Farming/Agriculture Activity,0,4,14,3,0,21,0,0,0,0,0,0,21
JHARKHAND,2003,Others (Please Specify),0,18,10,6,0,34,0,10,0,2,0,12,46
JHARKHAND,2003,Retired Person,0,2,0,0,0,2,0,0,0,0,0,0,2
JHARKHAND,2003,Others (Please Specify),6,5,11,11,9,42,4,5,8,15,0,32,74
JHARKHAND,2003,Total,9,45,52,36,11,153,4,47,40,28,0,119,272
JHARKHAND,2003,Total Salaried,0,0,6,2,0,8,0,0,5,1,0,6,14
JHARKHAND,2003,Total Self-employed,0,26,27,12,2,67,0,10,1,2,0,13,80
JHARKHAND,2004,House Wife,0,0,0,0,0,0,0,0,0,0,0,0,0
JHARKHAND,2004,Service (Government),0,0,0,0,0,0,0,0,0,0,0,0,0
JHARKHAND,2004,Service (Private),0,0,4,1,0,5,0,0,3,0,0,3,8
JHARKHAND,2004,Public Sector Undertaking,0,0,2,1,0,3,0,0,2,1,0,3,6
JHARKHAND,2004,Student,3,4,0,0,0,7,0,3,0,0,0,3,10
JHARKHAND,2004,Unemployed,0,8,8,11,0,27,0,1,1,0,0,2,29
JHARKHAND,2004,Self-employed (Business activity),0,0,2,1,0,3,0,0,1,0,0,1,4
JHARKHAND,2004,Professional Activity,0,4,1,2,2,9,0,0,0,0,0,0,9
JHARKHAND,2004,Farming/Agriculture Activity,0,4,14,3,0,21,0,0,0,0,0,0,21
JHARKHAND,2004,Others (Please Specify),0,18,10,6,0,34,0,10,0,2,0,12,46
JHARKHAND,2004,Retired Person,0,0,0,0,0,0,0,0,0,0,0,0,0
JHARKHAND,2004,Others (Please Specify),6,34,39,36,9,124,4,51,63,42,0,160,284
JHARKHAND,2004,Total,9,72,80,61,11,233,4,65,70,45,0,184,417
JHARKHAND,2004,Total Salaried,0,0,6,2,0,8,0,0,5,1,0,6,14
JHARKHAND,2004,Total Self-employed,0,26,27,12,2,67,0,10,1,2,0,13,80
JHARKHAND,2005,House Wife,0,0,0,0,0,0,0,57,76,22,3,158,158
JHARKHAND,2005,Service (Government),0,0,4,5,0,9,0,1,1,0,0,2,11
JHARKHAND,2005,Service (Private),0,14,13,6,0,33,0,0,9,0,0,9,42
JHARKHAND,2005,Public Sector Undertaking,0,2,3,0,0,5,0,1,0,0,0,1,6
JHARKHAND,2005,Student,2,53,14,0,0,69,6,14,9,0,0,29,98
JHARKHAND,2005,Unemployed,0,20,6,0,0,26,0,8,14,0,0,22,48
JHARKHAND,2005,Self-employed (Business activity),0,5,14,14,0,33,0,0,0,1,0,1,34
JHARKHAND,2005,Professional Activity,0,0,4,5,0,9,0,0,0,0,0,0,9
JHARKHAND,2005,Farming/Agriculture Activity,0,38,56,29,1,124,0,0,0,0,0,0,124
JHARKHAND,2005,Others (Please Specify),2,21,24,8,0,55,5,16,9,4,1,35,90
JHARKHAND,2005,Retired Person,0,0,0,0,3,3,0,0,0,0,0,0,3
JHARKHAND,2005,Others (Please Specify),4,28,49,66,10,157,2,15,10,1,0,28,185
JHARKHAND,2005,Total,8,181,187,133,14,523,13,112,128,28,4,285,808
JHARKHAND,2005,Total Salaried,0,16,20,11,0,47,0,2,10,0,0,12,59
JHARKHAND,2005,Total Self-employed,2,64,98,56,1,221,5,16,9,5,1,36,257
JHARKHAND,2006,House Wife,0,0,0,0,0,0,1,94,70,23,2,190,190
JHARKHAND,2006,Service (Government),0,5,5,10,0,20,0,0,6,0,0,6,26
JHARKHAND,2006,Service (Private),0,20,12,8,0,40,0,2,5,1,0,8,48
JHARKHAND,2006,Public Sector Undertaking,0,1,0,0,0,1,0,0,0,0,0,0,1
JHARKHAND,2006,Student,10,58,1,2,0,71,5,35,0,0,0,40,111
JHARKHAND,2006,Unemployed,0,31,37,12,1,81,1,6,7,0,0,14,95
JHARKHAND,2006,Self-employed (Business activity),0,12,4,2,0,18,0,1,0,1,0,2,20
JHARKHAND,2006,Professional Activity,0,5,24,5,0,34,0,0,0,0,0,0,34
JHARKHAND,2006,Farming/Agriculture Activity,0,19,53,30,1,103,0,0,0,0,0,0,103
JHARKHAND,2006,Others (Please Specify),4,21,18,7,3,53,2,2,0,0,0,4,57
JHARKHAND,2006,Retired Person,0,2,1,0,6,9,0,0,0,0,0,0,9
JHARKHAND,2006,Others (Please Specify),7,16,38,19,11,91,6,18,32,13,2,71,162
JHARKHAND,2006,Total,21,190,193,95,22,521,15,158,120,38,4,335,856
JHARKHAND,2006,Total Salaried,0,26,17,18,0,61,0,2,11,1,0,14,75
JHARKHAND,2006,Total Self-employed,4,57,99,44,4,208,2,3,0,1,0,6,214
JHARKHAND,2007,House Wife,0,0,0,0,0,0,3,87,77,30,8,205,205
JHARKHAND,2007,Service (Government),0,6,5,6,2,19,0,0,0,1,0,1,20
JHARKHAND,2007,Service (Private),4,28,36,9,3,80,0,0,4,0,0,4,84
JHARKHAND,2007,Public Sector Undertaking,0,0,0,0,0,0,0,0,0,0,0,0,0
JHARKHAND,2007,Student,24,33,10,0,0,67,10,23,2,0,0,35,102
JHARKHAND,2007,Unemployed,0,40,26,12,1,79,0,8,8,0,0,16,95
JHARKHAND,2007,Self-employed (Business activity),1,15,19,14,0,49,0,0,3,1,0,4,53
JHARKHAND,2007,Professional Activity,0,2,27,10,1,40,0,0,2,0,0,2,42
JHARKHAND,2007,Farming/Agriculture Activity,0,28,40,28,5,101,1,7,3,1,0,12,113
JHARKHAND,2007,Others (Please Specify),0,22,24,21,5,72,1,22,18,6,2,49,121
JHARKHAND,2007,Retired Person,0,0,1,0,18,19,0,0,0,0,0,0,19
JHARKHAND,2007,Others (Please Specify),17,87,128,97,25,354,7,31,18,15,10,81,435
JHARKHAND,2007,Total,46,261,316,197,60,880,22,178,135,54,20,409,1289
JHARKHAND,2007,Total Salaried,4,34,41,15,5,99,0,0,4,1,0,5,104
JHARKHAND,2007,Total Self-employed,1,67,110,73,11,262,2,29,26,8,2,67,329
JHARKHAND,2008,House Wife,0,0,0,0,0,0,1,58,67,41,3,170,170
JHARKHAND,2008,Service (Government),0,2,7,3,0,12,0,0,0,1,0,1,13
JHARKHAND,2008,Service (Private),0,8,19,4,0,31,0,0,4,0,0,4,35
JHARKHAND,2008,Public Sector Undertaking,0,5,7,2,0,14,0,0,0,0,0,0,14
JHARKHAND,2008,Student,8,52,1,0,0,61,13,26,1,0,0,40,101
JHARKHAND,2008,Unemployed,0,17,18,10,5,50,1,3,6,0,0,10,60
JHARKHAND,2008,Self-employed (Business activity),0,4,18,10,0,32,0,3,0,0,0,3,35
JHARKHAND,2008,Professional Activity,0,1,32,10,0,43,5,0,0,0,0,5,48
JHARKHAND,2008,Farming/Agriculture Activity,3,17,18,23,3,64,2,2,2,1,0,7,71
JHARKHAND,2008,Others (Please Specify),8,25,42,25,6,106,1,2,11,0,1,15,121
JHARKHAND,2008,Retired Person,0,0,0,0,4,4,0,0,0,0,0,0,4
JHARKHAND,2008,Others (Please Specify),1,40,76,47,21,185,8,19,17,7,3,54,239
JHARKHAND,2008,Total,20,171,238,134,39,602,31,113,108,50,7,309,911
JHARKHAND,2008,Total Salaried,0,15,33,9,0,57,0,0,4,1,0,5,62
JHARKHAND,2008,Total Self-employed,11,47,110,68,9,245,8,7,13,1,1,30,275
JHARKHAND,2009,House Wife,0,0,0,0,0,0,0,54,87,40,4,185,185
JHARKHAND,2009,Service (Government),0,1,14,2,0,17,0,5,2,0,0,7,24
JHARKHAND,2009,Service (Private),0,21,68,30,1,120,1,12,2,1,0,16,136
JHARKHAND,2009,Public Sector Undertaking,0,1,1,1,0,3,1,0,0,0,0,1,4
JHARKHAND,2009,Student,7,53,3,0,0,63,8,25,0,0,0,33,96
JHARKHAND,2009,Unemployed,0,23,39,15,10,87,0,7,6,0,0,13,100
JHARKHAND,2009,Self-employed (Business activity),0,7,15,11,0,33,0,2,2,0,0,4,37
JHARKHAND,2009,Professional Activity,0,6,9,5,0,20,0,1,1,0,0,2,22
JHARKHAND,2009,Farming/Agriculture Activity,0,35,84,34,6,159,0,0,4,1,0,5,164
JHARKHAND,2009,Others (Please Specify),1,34,20,16,6,77,1,7,10,5,0,23,100
JHARKHAND,2009,Retired Person,0,0,0,0,1,1,0,0,0,0,0,0,1
JHARKHAND,2009,Others (Please Specify),8,22,19,88,27,164,11,22,10,17,19,79,243
JHARKHAND,2009,Total,16,203,272,202,51,744,22,135,124,64,23,368,1112
JHARKHAND,2009,Total Salaried,0,23,83,33,1,140,2,17,4,1,0,24,164
JHARKHAND,2009,Total Self-employed,1,82,128,66,12,289,1,10,17,6,0,34,323
JHARKHAND,2010,House Wife,0,0,0,0,0,0,1,52,104,51,4,212,212
JHARKHAND,2010,Service (Government),0,1,3,4,0,8,0,0,1,1,0,2,10
JHARKHAND,2010,Service (Private),0,20,29,28,0,77,0,5,3,2,0,10,87
JHARKHAND,2010,Public Sector Undertaking,18,1,2,3,0,24,0,4,0,0,0,4,28
JHARKHAND,2010,Student,18,70,4,0,0,92,9,40,1,0,0,50,142
JHARKHAND,2010,Unemployed,0,34,41,13,0,88,0,8,4,0,0,12,100
JHARKHAND,2010,Self-employed (Business activity),0,8,13,6,0,27,0,2,2,0,0,4,31
JHARKHAND,2010,Professional Activity,0,3,4,2,0,9,0,0,0,0,0,0,9
JHARKHAND,2010,Farming/Agriculture Activity,10,47,58,30,5,150,0,13,6,4,0,23,173
JHARKHAND,2010,Others (Please Specify),2,33,64,31,2,132,0,33,9,15,5,62,194
JHARKHAND,2010,Retired Person,0,0,0,0,3,3,0,0,0,0,0,0,3
JHARKHAND,2010,Others (Please Specify),36,35,57,55,2,185,6,18,12,7,15,58,243
JHARKHAND,2010,Total,84,252,275,172,12,795,16,175,142,80,24,437,1232
JHARKHAND,2010,Total Salaried,18,22,34,35,0,109,0,9,4,3,0,16,125
JHARKHAND,2010,Total Self-employed,12,91,139,69,7,318,0,48,17,19,5,89,407
JHARKHAND,2011,House Wife,0,0,0,0,0,0,10,70,95,24,7,206,206
JHARKHAND,2011,Service (Government),0,4,8,3,0,15,0,2,3,2,0,7,22
JHARKHAND,2011,Service (Private),0,25,63,17,0,105,0,6,2,1,0,9,114
JHARKHAND,2011,Public Sector Undertaking,7,12,1,0,0,20,1,10,0,0,0,11,31
JHARKHAND,2011,Student,3,37,11,0,0,51,6,34,4,0,0,44,95
JHARKHAND,2011,Unemployed,0,23,44,17,1,85,0,2,1,2,1,6,91
JHARKHAND,2011,Self-employed (Business activity),0,5,11,5,0,21,0,0,0,0,0,0,21
JHARKHAND,2011,Professional Activity,0,15,16,17,1,49,0,3,3,0,0,6,55
JHARKHAND,2011,Farming/Agriculture Activity,0,19,44,24,3,90,0,2,1,1,0,4,94
JHARKHAND,2011,Others (Please Specify),0,35,12,11,4,62,0,8,10,6,0,24,86
JHARKHAND,2011,Retired Person,0,1,0,0,6,7,0,0,0,0,0,0,7
JHARKHAND,2011,Others (Please Specify),3,148,53,85,31,320,1,52,8,8,1,70,390
JHARKHAND,2011,Total,13,324,263,179,46,825,18,189,127,44,9,387,1212
JHARKHAND,2011,Total Salaried,7,41,72,20,0,140,1,18,5,3,0,27,167
JHARKHAND,2011,Total Self-employed,0,74,83,57,8,222,0,13,14,7,0,34,256
JHARKHAND,2012,House Wife,0,0,0,0,0,0,6,65,93,44,4,212,212
JHARKHAND,2012,Service (Government),0,2,7,3,5,17,0,1,0,1,0,2,19
JHARKHAND,2012,Service (Private),0,27,32,19,0,78,0,8,3,0,0,11,89
JHARKHAND,2012,Public Sector Undertaking,0,6,7,0,0,13,0,4,2,0,0,6,19
JHARKHAND,2012,Student,17,90,11,0,0,118,12,41,3,0,1,57,175
JHARKHAND,2012,Unemployed,0,41,53,32,0,126,2,24,5,1,0,32,158
JHARKHAND,2012,Self-employed (Business activity),3,9,18,11,7,48,3,6,3,5,0,17,65
JHARKHAND,2012,Professional Activity,0,5,7,10,0,22,0,0,0,0,0,0,22
JHARKHAND,2012,Farming/Agriculture Activity,0,24,37,29,3,93,0,7,11,6,2,26,119
JHARKHAND,2012,Others (Please Specify),1,36,32,32,6,107,1,17,2,2,0,22,129
JHARKHAND,2012,Retired Person,0,0,0,0,3,3,0,0,0,0,0,0,3
JHARKHAND,2012,Others (Please Specify),2,57,63,62,29,213,10,44,30,11,1,96,309
JHARKHAND,2012,Total,23,297,267,198,53,838,34,217,152,70,8,481,1319
JHARKHAND,2012,Total Salaried,0,35,46,22,5,108,0,13,5,1,0,19,127
JHARKHAND,2012,Total Self-employed,4,74,94,82,16,270,4,30,16,13,2,65,335
KARNATAKA,2001,House Wife,0,0,0,0,0,0,10,1008,707,334,138,2197,2197
KARNATAKA,2001,Service (Government),0,35,108,67,1,211,0,23,24,12,0,59,270
KARNATAKA,2001,Service (Private),3,241,352,190,79,865,6,111,40,31,12,200,1065
KARNATAKA,2001,Public Sector Undertaking,0,66,95,60,7,228,0,15,0,0,0,15,243
KARNATAKA,2001,Student,72,230,26,1,0,329,60,120,1,2,0,183,512
KARNATAKA,2001,Unemployed,6,225,207,103,17,558,5,48,23,5,4,85,643
KARNATAKA,2001,Self-employed (Business activity),5,195,221,133,37,591,2,22,7,3,0,34,625
KARNATAKA,2001,Professional Activity,1,69,71,41,13,195,1,6,1,0,0,8,203
KARNATAKA,2001,Farming/Agriculture Activity,25,551,811,579,187,2153,17,138,117,68,12,352,2505
KARNATAKA,2001,Others (Please Specify),48,441,708,484,266,1947,36,201,130,91,59,517,2464
KARNATAKA,2001,Retired Person,0,16,18,16,46,96,0,5,14,11,9,39,135
KARNATAKA,2001,Others (Please Specify),20,173,263,162,80,698,47,120,54,69,31,321,1019
KARNATAKA,2001,Total,180,2242,2880,1836,733,7871,184,1817,1118,626,265,4010,11881
KARNATAKA,2001,Total Salaried,3,342,555,317,87,1304,6,149,64,43,12,274,1578
KARNATAKA,2001,Total Self-employed,79,1256,1811,1237,503,4886,56,367,255,162,71,911,5797
KARNATAKA,2002,House Wife,0,0,0,0,0,0,6,914,776,347,182,2225,2225
KARNATAKA,2002,Service (Government),0,41,86,59,0,186,0,14,14,5,1,34,220
KARNATAKA,2002,Service (Private),2,272,325,228,61,888,9,80,59,28,3,179,1067
KARNATAKA,2002,Public Sector Undertaking,0,51,87,42,3,183,0,21,3,0,0,24,207
KARNATAKA,2002,Student,49,194,12,0,0,255,118,120,16,0,0,254,509
KARNATAKA,2002,Unemployed,8,203,191,101,40,543,7,82,13,2,4,108,651
KARNATAKA,2002,Self-employed (Business activity),2,186,323,176,68,755,1,24,13,1,0,39,794
KARNATAKA,2002,Professional Activity,0,32,46,10,4,92,0,6,1,0,0,7,99
KARNATAKA,2002,Farming/Agriculture Activity,5,515,799,498,191,2008,8,121,125,55,23,332,2340
KARNATAKA,2002,Others (Please Specify),27,621,948,514,316,2426,35,274,162,65,67,603,3029
KARNATAKA,2002,Retired Person,0,0,0,13,39,52,0,0,0,7,8,15,67
KARNATAKA,2002,Others (Please Specify),28,170,214,191,89,692,20,140,100,58,52,370,1062
KARNATAKA,2002,Total,121,2285,3031,1832,811,8080,204,1796,1282,568,340,4190,12270
KARNATAKA,2002,Total Salaried,2,364,498,329,64,1257,9,115,76,33,4,237,1494
KARNATAKA,2002,Total Self-employed,34,1354,2116,1198,579,5281,44,425,301,121,90,981,6262
KARNATAKA,2003,House Wife,0,0,0,0,0,0,6,703,658,309,188,1864,1864
KARNATAKA,2003,Service (Government),0,40,75,81,2,198,0,14,11,0,0,25,223
KARNATAKA,2003,Service (Private),5,194,266,161,62,688,0,71,51,34,8,164,852
KARNATAKA,2003,Public Sector Undertaking,0,57,91,56,8,212,2,17,6,8,1,34,246
KARNATAKA,2003,Student,54,154,16,2,1,227,62,127,4,2,0,195,422
KARNATAKA,2003,Unemployed,12,235,207,132,64,650,3,63,26,8,7,107,757
KARNATAKA,2003,Self-employed (Business activity),10,127,212,150,45,544,6,5,4,3,2,20,564
KARNATAKA,2003,Professional Activity,0,44,60,26,6,136,0,2,4,2,0,8,144
KARNATAKA,2003,Farming/Agriculture Activity,8,593,809,642,274,2326,21,119,107,85,20,352,2678
KARNATAKA,2003,Others (Please Specify),20,625,775,475,216,2111,28,258,208,90,46,630,2741
KARNATAKA,2003,Retired Person,0,0,0,9,37,46,0,0,0,0,6,6,52
KARNATAKA,2003,Others (Please Specify),33,357,384,268,195,1237,26,252,202,70,31,581,1818
KARNATAKA,2003,Total,142,2426,2895,2002,910,8375,154,1631,1281,611,309,3986,12361
KARNATAKA,2003,Total Salaried,5,291,432,298,72,1098,2,102,68,42,9,223,1321
KARNATAKA,2003,Total Self-employed,38,1389,1856,1293,541,5117,55,384,323,180,68,1010,6127
KARNATAKA,2004,House Wife,0,0,0,0,0,0,0,736,609,300,138,1783,1783
KARNATAKA,2004,Service (Government),0,38,65,58,4,165,0,21,10,3,0,34,199
KARNATAKA,2004,Service (Private),5,286,358,192,46,887,1,104,77,29,7,218,1105
KARNATAKA,2004,Public Sector Undertaking,0,55,78,29,7,169,0,30,10,9,0,49,218
KARNATAKA,2004,Student,45,162,25,0,0,232,48,162,6,0,0,216,448
KARNATAKA,2004,Unemployed,4,179,185,101,57,526,2,38,24,7,14,85,611
KARNATAKA,2004,Self-employed (Business activity),9,153,207,82,20,471,3,4,8,8,0,23,494
KARNATAKA,2004,Professional Activity,0,33,35,14,3,85,0,0,0,0,0,0,85
KARNATAKA,2004,Farming/Agriculture Activity,1,464,661,432,148,1706,5,84,112,48,8,257,1963
KARNATAKA,2004,Others (Please Specify),16,601,782,479,177,2055,44,221,244,86,42,637,2692
KARNATAKA,2004,Retired Person,0,0,8,17,50,75,0,0,0,0,0,0,75
KARNATAKA,2004,Others (Please Specify),79,358,524,458,228,1647,43,288,131,107,48,617,2264
KARNATAKA,2004,Total,159,2329,2928,1862,740,8018,146,1688,1231,597,257,3919,11937
KARNATAKA,2004,Total Salaried,5,379,501,279,57,1221,1,155,97,41,7,301,1522
KARNATAKA,2004,Total Self-employed,26,1251,1685,1007,348,4317,52,309,364,142,50,917,5234
KARNATAKA,2005,House Wife,0,0,0,0,0,0,4,816,658,280,116,1874,1874
KARNATAKA,2005,Service (Government),0,32,41,66,0,139,0,9,7,5,0,21,160
KARNATAKA,2005,Service (Private),1,342,295,235,16,889,1,54,35,24,10,124,1013
KARNATAKA,2005,Public Sector Undertaking,0,57,60,56,11,184,0,11,13,10,0,34,218
KARNATAKA,2005,Student,35,137,15,2,0,189,32,134,13,0,0,179,368
KARNATAKA,2005,Unemployed,3,192,117,68,23,403,0,34,20,8,4,66,469
KARNATAKA,2005,Self-employed (Business activity),1,118,168,101,14,402,0,9,23,14,0,46,448
KARNATAKA,2005,Professional Activity,1,59,96,69,17,242,2,3,3,21,7,36,278
KARNATAKA,2005,Farming/Agriculture Activity,4,350,691,422,196,1663,0,58,91,61,10,220,1883
KARNATAKA,2005,Others (Please Specify),12,511,605,440,214,1782,6,208,126,94,57,491,2273
KARNATAKA,2005,Retired Person,0,1,2,8,24,35,0,2,0,3,0,5,40
KARNATAKA,2005,Others (Please Specify),47,462,601,485,184,1779,42,276,237,131,68,754,2533
KARNATAKA,2005,Total,104,2261,2691,1952,699,7707,87,1614,1226,651,272,3850,11557
KARNATAKA,2005,Total Salaried,1,431,396,357,27,1212,1,74,55,39,10,179,1391
KARNATAKA,2005,Total Self-employed,18,1038,1560,1032,441,4089,8,278,243,190,74,793,4882
KARNATAKA,2006,House Wife,0,0,0,0,0,0,0,697,649,369,136,1851,1851
KARNATAKA,2006,Service (Government),0,68,71,75,0,214,0,11,6,7,0,24,238
KARNATAKA,2006,Service (Private),2,285,362,343,46,1038,0,65,48,28,3,144,1182
KARNATAKA,2006,Public Sector Undertaking,0,47,41,43,5,136,0,16,9,8,1,34,170
KARNATAKA,2006,Student,25,173,15,14,3,230,38,174,5,0,0,217,447
KARNATAKA,2006,Unemployed,0,162,146,59,31,398,0,53,14,16,7,90,488
KARNATAKA,2006,Self-employed (Business activity),2,133,140,101,20,396,1,15,22,4,2,44,440
KARNATAKA,2006,Professional Activity,12,64,76,44,14,210,1,4,4,2,2,13,223
KARNATAKA,2006,Farming/Agriculture Activity,2,348,576,395,129,1450,5,90,97,56,22,270,1720
KARNATAKA,2006,Others (Please Specify),14,377,622,480,206,1699,6,145,109,72,29,361,2060
KARNATAKA,2006,Retired Person,0,0,1,6,21,28,0,0,0,0,1,1,29
KARNATAKA,2006,Others (Please Specify),94,650,790,465,250,2249,80,483,362,128,62,1115,3364
KARNATAKA,2006,Total,151,2307,2840,2025,725,8048,131,1753,1325,690,265,4164,12212
KARNATAKA,2006,Total Salaried,2,400,474,461,51,1388,0,92,63,43,4,202,1590
KARNATAKA,2006,Total Self-employed,30,922,1414,1020,369,3755,13,254,232,134,55,688,4443
KARNATAKA,2007,House Wife,0,0,0,0,0,0,1,656,611,382,152,1802,1802
KARNATAKA,2007,Service (Government),0,58,53,67,1,179,0,11,9,5,3,28,207
KARNATAKA,2007,Service (Private),0,273,332,248,49,902,1,114,36,18,5,174,1076
KARNATAKA,2007,Public Sector Undertaking,0,54,68,36,18,176,0,9,9,9,0,27,203
KARNATAKA,2007,Student,51,177,18,0,0,246,58,193,10,0,0,261,507
KARNATAKA,2007,Unemployed,0,137,185,106,22,450,6,63,21,11,1,102,552
KARNATAKA,2007,Self-employed (Business activity),0,102,176,123,20,421,0,26,24,11,2,63,484
KARNATAKA,2007,Professional Activity,0,37,82,58,10,187,0,3,4,0,0,7,194
KARNATAKA,2007,Farming/Agriculture Activity,0,311,655,595,211,1772,7,112,125,91,28,363,2135
KARNATAKA,2007,Others (Please Specify),18,514,763,670,168,2133,16,158,220,133,14,541,2674
KARNATAKA,2007,Retired Person,0,0,1,10,36,47,0,0,0,0,4,4,51
KARNATAKA,2007,Others (Please Specify),40,491,651,506,191,1879,38,178,166,93,65,540,2419
KARNATAKA,2007,Total,109,2154,2984,2419,726,8392,127,1523,1235,753,274,3912,12304
KARNATAKA,2007,Total Salaried,0,385,453,351,68,1257,1,134,54,32,8,229,1486
KARNATAKA,2007,Total Self-employed,18,964,1676,1446,409,4513,23,299,373,235,44,974,5487
KARNATAKA,2008,House Wife,0,0,0,0,0,0,3,658,587,291,114,1653,1653
KARNATAKA,2008,Service (Government),0,53,57,84,2,196,0,21,19,7,6,53,249
KARNATAKA,2008,Service (Private),0,279,417,311,47,1054,5,120,50,15,22,212,1266
KARNATAKA,2008,Public Sector Undertaking,0,60,77,75,23,235,1,46,6,10,6,69,304
KARNATAKA,2008,Student,24,180,19,18,2,243,25,176,11,0,0,212,455
KARNATAKA,2008,Unemployed,0,146,153,78,24,401,2,45,35,11,0,93,494
KARNATAKA,2008,Self-employed (Business activity),0,149,248,115,32,544,0,13,14,9,4,40,584
KARNATAKA,2008,Professional Activity,0,30,31,52,5,118,0,16,3,2,1,22,140
KARNATAKA,2008,Farming/Agriculture Activity,0,255,570,435,179,1439,0,99,120,59,20,298,1737
KARNATAKA,2008,Others (Please Specify),11,395,664,577,267,1914,16,161,117,101,65,460,2374
KARNATAKA,2008,Retired Person,0,0,4,12,35,51,0,1,0,1,4,6,57
KARNATAKA,2008,Others (Please Specify),19,651,630,546,175,2021,28,301,299,184,76,888,2909
KARNATAKA,2008,Total,54,2198,2870,2303,791,8216,80,1657,1261,690,318,4006,12222
KARNATAKA,2008,Total Salaried,0,392,551,470,72,1485,6,187,75,32,34,334,1819
KARNATAKA,2008,Total Self-employed,11,829,1513,1179,483,4015,16,289,254,171,90,820,4835
KARNATAKA,2009,House Wife,0,0,0,0,0,0,12,526,608,378,172,1696,1696
KARNATAKA,2009,Service (Government),0,14,32,45,1,92,0,9,4,2,0,15,107
KARNATAKA,2009,Service (Private),0,230,296,139,68,733,1,66,31,11,13,122,855
KARNATAKA,2009,Public Sector Undertaking,0,115,72,42,15,244,0,18,16,12,2,48,292
KARNATAKA,2009,Student,39,206,29,0,0,274,19,207,7,0,0,233,507
KARNATAKA,2009,Unemployed,0,130,227,98,25,480,2,33,12,5,3,55,535
KARNATAKA,2009,Self-employed (Business activity),0,151,234,224,27,636,0,9,13,7,1,30,666
KARNATAKA,2009,Professional Activity,0,39,58,40,7,144,0,8,2,1,0,11,155
KARNATAKA,2009,Farming/Agriculture Activity,6,318,705,590,296,1915,0,112,163,70,22,367,2282
KARNATAKA,2009,Others (Please Specify),19,349,640,647,303,1958,98,178,207,217,65,765,2723
KARNATAKA,2009,Retired Person,0,0,5,3,41,49,0,4,1,0,1,6,55
KARNATAKA,2009,Others (Please Specify),139,267,605,503,170,1684,31,136,188,192,91,638,2322
KARNATAKA,2009,Total,203,1819,2903,2331,953,8209,163,1306,1252,895,370,3986,12195
KARNATAKA,2009,Total Salaried,0,359,400,226,84,1069,1,93,51,25,15,185,1254
KARNATAKA,2009,Total Self-employed,25,857,1637,1501,633,4653,98,307,385,295,88,1173,5826
KARNATAKA,2010,House Wife,0,0,0,0,0,0,2,703,664,361,159,1889,1889
KARNATAKA,2010,Service (Government),0,37,60,65,16,178,0,17,17,4,2,40,218
KARNATAKA,2010,Service (Private),0,244,377,204,64,889,0,124,71,23,9,227,1116
KARNATAKA,2010,Public Sector Undertaking,0,85,79,58,32,254,0,15,12,14,0,41,295
KARNATAKA,2010,Student,43,238,9,22,7,319,89,176,7,0,0,272,591
KARNATAKA,2010,Unemployed,0,125,122,95,20,362,0,35,21,2,0,58,420
KARNATAKA,2010,Self-employed (Business activity),0,234,303,227,81,845,0,13,15,11,4,43,888
KARNATAKA,2010,Professional Activity,2,30,34,38,6,110,0,5,7,3,0,15,125
KARNATAKA,2010,Farming/Agriculture Activity,3,381,723,751,270,2128,11,159,128,111,48,457,2585
KARNATAKA,2010,Others (Please Specify),20,505,761,544,199,2029,27,234,168,161,47,637,2666
KARNATAKA,2010,Retired Person,0,0,2,29,60,91,0,0,0,2,7,9,100
KARNATAKA,2010,Others (Please Specify),19,191,395,355,242,1202,39,121,138,143,115,556,1758
KARNATAKA,2010,Total,87,2070,2865,2388,997,8407,168,1602,1248,835,391,4244,12651
KARNATAKA,2010,Total Salaried,0,366,516,327,112,1321,0,156,100,41,11,308,1629
KARNATAKA,2010,Total Self-employed,25,1150,1821,1560,556,5112,38,411,318,286,99,1152,6264
KARNATAKA,2011,House Wife,0,0,0,0,0,0,0,585,635,417,139,1776,1776
KARNATAKA,2011,Service (Government),0,29,73,57,1,160,0,13,10,5,3,31,191
KARNATAKA,2011,Service (Private),0,180,377,159,45,761,1,107,68,35,22,233,994
KARNATAKA,2011,Public Sector Undertaking,0,125,114,98,25,362,0,37,22,17,1,77,439
KARNATAKA,2011,Student,68,343,10,4,0,425,19,235,21,8,3,286,711
KARNATAKA,2011,Unemployed,0,256,362,154,28,800,2,86,14,14,8,124,924
KARNATAKA,2011,Self-employed (Business activity),0,191,314,213,52,770,0,25,17,14,0,56,826
KARNATAKA,2011,Professional Activity,1,60,48,36,21,166,1,14,6,5,4,30,196
KARNATAKA,2011,Farming/Agriculture Activity,0,339,630,527,198,1694,0,127,137,126,16,406,2100
KARNATAKA,2011,Others (Please Specify),6,438,725,558,171,1898,3,183,122,104,36,448,2346
KARNATAKA,2011,Retired Person,0,0,0,9,46,55,0,0,2,3,3,8,63
KARNATAKA,2011,Others (Please Specify),145,365,391,284,196,1381,62,200,209,127,77,675,2056
KARNATAKA,2011,Total,220,2326,3044,2099,783,8472,88,1612,1263,875,312,4150,12622
KARNATAKA,2011,Total Salaried,0,334,564,314,71,1283,1,157,100,57,26,341,1624
KARNATAKA,2011,Total Self-employed,7,1028,1717,1334,442,4528,4,349,282,249,56,940,5468
KARNATAKA,2012,House Wife,0,0,0,0,0,0,0,717,601,373,159,1850,1850
KARNATAKA,2012,Service (Government),0,24,68,78,4,174,0,14,13,2,0,29,203
KARNATAKA,2012,Service (Private),0,392,338,233,37,1000,4,126,82,40,9,261,1261
KARNATAKA,2012,Public Sector Undertaking,0,71,98,70,15,254,0,19,47,21,1,88,342
KARNATAKA,2012,Student,33,257,6,0,0,296,51,198,9,5,1,264,560
KARNATAKA,2012,Unemployed,0,166,299,134,34,633,0,47,16,13,6,82,715
KARNATAKA,2012,Self-employed (Business activity),0,107,243,189,69,608,0,18,9,7,0,34,642
KARNATAKA,2012,Professional Activity,6,67,83,83,29,268,0,14,12,5,2,33,301
KARNATAKA,2012,Farming/Agriculture Activity,0,289,554,482,191,1516,0,113,124,100,22,359,1875
KARNATAKA,2012,Others (Please Specify),26,715,971,655,260,2627,7,319,185,79,24,614,3241
KARNATAKA,2012,Retired Person,0,0,1,28,31,60,0,0,0,1,8,9,69
KARNATAKA,2012,Others (Please Specify),13,270,496,288,93,1160,16,201,165,110,42,534,1694
KARNATAKA,2012,Total,78,2358,3157,2240,763,8596,78,1786,1263,756,274,4157,12753
KARNATAKA,2012,Total Salaried,0,487,504,381,56,1428,4,159,142,63,10,378,1806
KARNATAKA,2012,Total Self-employed,32,1178,1851,1409,549,5019,7,464,330,191,48,1040,6059
KERALA,2001,House Wife,0,0,0,0,0,0,0,290,475,394,247,1406,1406
KERALA,2001,Service (Government),0,10,53,111,2,176,0,7,15,9,0,31,207
KERALA,2001,Service (Private),0,73,145,139,92,449,0,25,33,24,35,117,566
KERALA,2001,Public Sector Undertaking,0,35,48,63,37,183,0,3,12,10,2,27,210
KERALA,2001,Student,37,90,1,0,0,128,33,119,1,0,0,153,281
KERALA,2001,Unemployed,0,312,550,560,334,1756,3,155,74,41,66,339,2095
KERALA,2001,Self-employed (Business activity),0,56,187,177,55,475,0,7,5,9,1,22,497
KERALA,2001,Professional Activity,0,30,77,74,21,202,0,2,9,8,2,21,223
KERALA,2001,Farming/Agriculture Activity,0,93,325,362,194,974,0,18,17,12,14,61,1035
KERALA,2001,Others (Please Specify),6,270,456,504,299,1535,3,80,64,83,62,292,1827
KERALA,2001,Retired Person,0,1,2,29,67,99,0,0,2,7,11,20,119
KERALA,2001,Others (Please Specify),0,139,263,221,187,810,9,88,91,69,39,296,1106
KERALA,2001,Total,43,1109,2107,2240,1288,6787,48,794,798,666,479,2785,9572
KERALA,2001,Total Salaried,0,118,246,313,131,808,0,35,60,43,37,175,983
KERALA,2001,Total Self-employed,6,449,1045,1117,569,3186,3,107,95,112,79,396,3582
KERALA,2002,House Wife,0,0,0,0,0,0,0,295,504,409,245,1453,1453
KERALA,2002,Service (Government),0,19,67,64,2,152,0,6,5,7,2,20,172
KERALA,2002,Service (Private),0,96,148,115,38,397,1,25,27,20,3,76,473
KERALA,2002,Public Sector Undertaking,0,13,35,39,9,96,0,6,10,3,2,21,117
KERALA,2002,Student,32,112,2,0,0,146,41,95,0,0,0,136,282
KERALA,2002,Unemployed,0,340,473,357,429,1599,0,137,94,65,44,340,1939
KERALA,2002,Self-employed (Business activity),0,94,231,222,84,631,0,0,7,6,3,16,647
KERALA,2002,Professional Activity,0,63,112,78,38,291,0,8,10,3,1,22,313
KERALA,2002,Farming/Agriculture Activity,0,134,426,614,259,1433,0,17,32,27,24,100,1533
KERALA,2002,Others (Please Specify),4,222,384,346,234,1190,0,46,73,51,42,212,1402
KERALA,2002,Retired Person,0,0,5,22,93,120,0,0,0,4,13,17,137
KERALA,2002,Others (Please Specify),18,171,313,320,288,1110,23,54,78,30,47,232,1342
KERALA,2002,Total,54,1264,2196,2177,1474,7165,65,689,840,625,426,2645,9810
KERALA,2002,Total Salaried,0,128,250,218,49,645,1,37,42,30,7,117,762
KERALA,2002,Total Self-employed,4,513,1153,1260,615,3545,0,71,122,87,70,350,3895
KERALA,2003,House Wife,0,0,0,0,0,0,0,294,467,373,297,1431,1431
KERALA,2003,Service (Government),0,4,35,47,0,86,0,7,5,7,0,19,105
KERALA,2003,Service (Private),0,54,142,105,24,325,0,16,17,5,3,41,366
KERALA,2003,Public Sector Undertaking,0,8,22,32,1,63,0,8,0,4,0,12,75
KERALA,2003,Student,43,109,8,0,0,160,33,109,12,0,0,154,314
KERALA,2003,Unemployed,0,249,195,207,232,883,1,118,28,24,45,216,1099
KERALA,2003,Self-employed (Business activity),0,51,133,141,64,389,0,4,3,0,0,7,396
KERALA,2003,Professional Activity,0,26,65,46,12,149,0,3,2,1,0,6,155
KERALA,2003,Farming/Agriculture Activity,0,141,407,600,372,1520,0,18,15,17,13,63,1583
KERALA,2003,Others (Please Specify),3,390,723,721,469,2306,4,156,78,101,78,417,2723
KERALA,2003,Retired Person,0,0,3,29,44,76,0,0,0,4,3,7,83
KERALA,2003,Others (Please Specify),4,168,299,288,219,978,11,41,20,8,50,130,1108
KERALA,2003,Total,50,1200,2032,2216,1437,6935,49,774,647,544,489,2503,9438
KERALA,2003,Total Salaried,0,66,199,184,25,474,0,31,22,16,3,72,546
KERALA,2003,Total Self-employed,3,608,1328,1508,917,4364,4,181,98,119,91,493,4857
KERALA,2004,House Wife,0,0,0,0,0,0,0,288,484,413,328,1513,1513
KERALA,2004,Service (Government),0,4,39,40,0,83,0,1,3,1,0,5,88
KERALA,2004,Service (Private),0,38,101,70,11,220,0,13,9,4,2,28,248
KERALA,2004,Public Sector Undertaking,0,6,17,8,0,31,0,1,3,3,1,8,39
KERALA,2004,Student,37,106,0,0,0,143,38,153,2,0,0,193,336
KERALA,2004,Unemployed,2,282,299,208,215,1006,0,123,47,32,56,258,1264
KERALA,2004,Self-employed (Business activity),0,48,150,153,34,385,0,0,0,1,0,1,386
KERALA,2004,Professional Activity,0,39,57,46,8,150,0,4,2,0,0,6,156
KERALA,2004,Farming/Agriculture Activity,0,73,240,330,217,860,0,7,13,17,6,43,903
KERALA,2004,Others (Please Specify),2,356,774,920,482,2534,7,91,43,37,49,227,2761
KERALA,2004,Retired Person,0,0,0,17,67,84,0,0,0,1,8,9,93
KERALA,2004,Others (Please Specify),7,155,390,318,232,1102,8,48,48,27,33,164,1266
KERALA,2004,Total,48,1107,2067,2110,1266,6598,53,729,654,536,483,2455,9053
KERALA,2004,Total Salaried,0,48,157,118,11,334,0,15,15,8,3,41,375
KERALA,2004,Total Self-employed,2,516,1221,1449,741,3929,7,102,58,55,55,277,4206
KERALA,2005,House Wife,0,0,0,0,0,0,0,305,421,390,297,1413,1413
KERALA,2005,Service (Government),0,1,30,36,0,67,0,4,6,8,0,18,85
KERALA,2005,Service (Private),0,45,131,82,15,273,0,24,14,9,2,49,322
KERALA,2005,Public Sector Undertaking,0,6,17,23,0,46,0,6,1,3,0,10,56
KERALA,2005,Student,40,100,0,0,0,140,40,100,1,0,0,141,281
KERALA,2005,Unemployed,0,268,355,228,129,980,1,114,58,33,35,241,1221
KERALA,2005,Self-employed (Business activity),0,37,148,172,38,395,0,3,1,1,0,5,400
KERALA,2005,Professional Activity,0,31,65,48,7,151,0,7,3,1,0,11,162
KERALA,2005,Farming/Agriculture Activity,0,89,337,383,264,1073,1,3,17,17,7,45,1118
KERALA,2005,Others (Please Specify),1,453,699,815,469,2437,2,77,75,86,72,312,2749
KERALA,2005,Retired Person,0,0,0,31,61,92,0,0,1,1,10,12,104
KERALA,2005,Others (Please Specify),5,208,337,389,237,1176,6,47,34,27,43,157,1333
KERALA,2005,Total,46,1238,2119,2207,1220,6830,50,690,632,576,466,2414,9244
KERALA,2005,Total Salaried,0,52,178,141,15,386,0,34,21,20,2,77,463
KERALA,2005,Total Self-employed,1,610,1249,1418,778,4056,3,90,96,105,79,373,4429
KERALA,2006,House Wife,0,0,0,0,0,0,0,289,404,388,269,1350,1350
KERALA,2006,Service (Government),0,3,31,41,0,75,0,2,5,7,0,14,89
KERALA,2006,Service (Private),0,75,148,134,13,370,0,27,27,7,1,62,432
KERALA,2006,Public Sector Undertaking,0,3,29,22,4,58,0,4,7,7,2,20,78
KERALA,2006,Student,45,71,0,0,0,116,53,102,0,0,0,155,271
KERALA,2006,Unemployed,1,210,348,283,157,999,0,101,54,29,34,218,1217
KERALA,2006,Self-employed (Business activity),0,41,138,156,38,373,0,3,0,1,0,4,377
KERALA,2006,Professional Activity,0,43,82,69,16,210,0,8,7,5,0,20,230
KERALA,2006,Farming/Agriculture Activity,0,86,273,420,249,1028,0,9,26,37,24,96,1124
KERALA,2006,Others (Please Specify),5,389,685,710,524,2313,6,103,86,79,83,357,2670
KERALA,2006,Retired Person,0,0,8,38,65,111,0,0,0,5,12,17,128
KERALA,2006,Others (Please Specify),3,145,249,326,207,930,1,34,24,37,34,130,1060
KERALA,2006,Total,54,1066,1991,2199,1273,6583,60,682,640,602,459,2443,9026
KERALA,2006,Total Salaried,0,81,208,197,17,503,0,33,39,21,3,96,599
KERALA,2006,Total Self-employed,5,559,1178,1355,827,3924,6,123,119,122,107,477,4401
KERALA,2007,House Wife,0,0,0,0,0,0,0,289,394,433,210,1326,1326
KERALA,2007,Service (Government),0,2,34,52,0,88,0,0,5,6,0,11,99
KERALA,2007,Service (Private),0,34,209,135,12,390,0,21,33,24,0,78,468
KERALA,2007,Public Sector Undertaking,0,3,32,50,6,91,0,2,5,6,0,13,104
KERALA,2007,Student,33,82,0,0,0,115,34,124,2,0,0,160,275
KERALA,2007,Unemployed,0,209,325,135,3,672,0,72,66,28,8,174,846
KERALA,2007,Self-employed (Business activity),0,51,136,200,39,426,0,0,1,6,0,7,433
KERALA,2007,Professional Activity,0,38,79,69,8,194,0,4,3,4,1,12,206
KERALA,2007,Farming/Agriculture Activity,0,102,290,508,258,1158,0,13,21,25,15,74,1232
KERALA,2007,Others (Please Specify),0,396,662,677,413,2148,4,65,95,76,85,325,2473
KERALA,2007,Retired Person,0,0,0,20,68,88,0,0,0,0,6,6,94
KERALA,2007,Others (Please Specify),15,180,302,427,294,1218,5,20,56,39,68,188,1406
KERALA,2007,Total,48,1097,2069,2273,1101,6588,43,610,681,647,393,2374,8962
KERALA,2007,Total Salaried,0,39,275,237,18,569,0,23,43,36,0,102,671
KERALA,2007,Total Self-employed,0,587,1167,1454,718,3926,4,82,120,111,101,418,4344
KERALA,2008,House Wife,0,0,0,0,0,0,0,258,435,376,251,1320,1320
KERALA,2008,Service (Government),0,3,27,36,1,67,0,1,7,5,0,13,80
KERALA,2008,Service (Private),0,52,176,147,14,389,0,23,28,25,1,77,466
KERALA,2008,Public Sector Undertaking,0,4,35,37,0,76,0,3,4,3,0,10,86
KERALA,2008,Student,25,66,0,0,0,91,38,157,0,0,0,195,286
KERALA,2008,Unemployed,0,180,294,131,63,668,0,71,46,35,11,163,831
KERALA,2008,Self-employed (Business activity),0,36,110,173,55,374,0,1,2,6,0,9,383
KERALA,2008,Professional Activity,0,32,57,48,11,148,0,2,5,3,0,10,158
KERALA,2008,Farming/Agriculture Activity,0,71,219,294,184,768,0,8,11,23,10,52,820
KERALA,2008,Others (Please Specify),0,328,574,607,320,1829,1,95,99,90,47,332,2161
KERALA,2008,Retired Person,0,0,1,23,76,100,0,0,0,1,8,9,109
KERALA,2008,Others (Please Specify),1,244,555,505,315,1620,3,47,55,70,74,249,1869
KERALA,2008,Total,26,1016,2048,2001,1039,6130,42,666,692,637,402,2439,8569
KERALA,2008,Total Salaried,0,59,238,220,15,532,0,27,39,33,1,100,632
KERALA,2008,Total Self-employed,0,467,960,1122,570,3119,1,106,117,122,57,403,3522
KERALA,2009,House Wife,0,0,0,0,0,0,0,258,375,422,261,1316,1316
KERALA,2009,Service (Government),0,7,24,25,1,57,0,3,6,6,0,15,72
KERALA,2009,Service (Private),1,72,162,103,16,354,0,28,28,18,6,80,434
KERALA,2009,Public Sector Undertaking,0,7,37,43,0,87,0,9,5,5,0,19,106
KERALA,2009,Student,32,75,0,0,0,107,30,137,0,0,0,167,274
KERALA,2009,Unemployed,0,130,220,134,136,620,0,55,57,22,49,183,803
KERALA,2009,Self-employed (Business activity),0,80,194,222,90,586,0,1,5,6,0,12,598
KERALA,2009,Professional Activity,0,48,73,68,24,213,0,3,5,7,0,15,228
KERALA,2009,Farming/Agriculture Activity,0,116,252,294,158,820,0,19,18,23,16,76,896
KERALA,2009,Others (Please Specify),4,290,456,479,234,1463,0,95,51,46,25,217,1680
KERALA,2009,Retired Person,0,0,5,16,62,83,0,0,0,2,10,12,95
KERALA,2009,Others (Please Specify),1,366,556,658,351,1932,0,97,66,76,82,321,2253
KERALA,2009,Total,38,1191,1979,2042,1072,6322,30,705,616,633,449,2433,8755
KERALA,2009,Total Salaried,1,86,223,171,17,498,0,40,39,29,6,114,612
KERALA,2009,Total Self-employed,4,534,975,1063,506,3082,0,118,79,82,41,320,3402
KERALA,2010,House Wife,0,0,0,0,0,0,0,270,370,349,230,1219,1219
KERALA,2010,Service (Government),0,7,28,27,0,62,0,1,5,3,0,9,71
KERALA,2010,Service (Private),0,66,149,158,7,380,0,28,33,13,0,74,454
KERALA,2010,Public Sector Undertaking,0,23,59,52,2,136,0,4,4,4,0,12,148
KERALA,2010,Student,56,72,1,0,0,129,44,140,0,0,0,184,313
KERALA,2010,Unemployed,1,162,248,214,207,832,1,52,55,32,70,210,1042
KERALA,2010,Self-employed (Business activity),0,57,148,163,96,464,0,1,3,9,2,15,479
KERALA,2010,Professional Activity,0,25,56,81,13,175,0,4,5,1,1,11,186
KERALA,2010,Farming/Agriculture Activity,0,98,242,264,193,797,0,28,26,14,30,98,895
KERALA,2010,Others (Please Specify),4,261,553,629,348,1795,1,43,70,47,31,192,1987
KERALA,2010,Retired Person,0,0,2,14,50,66,0,0,1,2,7,10,76
KERALA,2010,Others (Please Specify),3,269,487,569,182,1510,0,37,54,70,45,206,1716
KERALA,2010,Total,64,1040,1973,2171,1098,6346,46,608,626,544,416,2240,8586
KERALA,2010,Total Salaried,0,96,236,237,9,578,0,33,42,20,0,95,673
KERALA,2010,Total Self-employed,4,441,999,1137,650,3231,1,76,104,71,64,316,3547
KERALA,2011,House Wife,0,0,0,0,0,0,0,238,396,320,260,1214,1214
KERALA,2011,Service (Government),0,3,22,29,0,54,0,2,6,4,1,13,67
KERALA,2011,Service (Private),0,79,139,119,17,354,0,27,34,17,0,78,432
KERALA,2011,Public Sector Undertaking,0,6,20,25,0,51,0,0,1,1,0,2,53
KERALA,2011,Student,28,61,0,0,0,89,32,125,0,0,0,157,246
KERALA,2011,Unemployed,0,94,165,117,54,430,0,54,40,10,11,115,545
KERALA,2011,Self-employed (Business activity),0,42,119,141,51,353,0,0,1,6,0,7,360
KERALA,2011,Professional Activity,0,26,71,43,15,155,0,7,3,2,0,12,167
KERALA,2011,Farming/Agriculture Activity,0,101,215,230,186,732,0,21,25,34,18,98,830
KERALA,2011,Others (Please Specify),0,339,704,732,442,2217,2,73,103,75,40,293,2510
KERALA,2011,Retired Person,0,0,1,41,56,98,0,0,0,2,4,6,104
KERALA,2011,Others (Please Specify),1,176,444,732,326,1679,2,41,51,74,56,224,1903
KERALA,2011,Total,29,927,1900,2209,1147,6212,36,588,660,545,390,2219,8431
KERALA,2011,Total Salaried,0,88,181,173,17,459,0,29,41,22,1,93,552
KERALA,2011,Total Self-employed,0,508,1109,1146,694,3457,2,101,132,117,58,410,3867
KERALA,2012,House Wife,0,0,0,0,0,0,0,250,323,372,249,1194,1194
KERALA,2012,Service (Government),0,4,21,27,0,52,0,1,4,4,0,9,61
KERALA,2012,Service (Private),0,92,190,163,38,483,0,36,25,19,0,80,563
KERALA,2012,Public Sector Undertaking,0,9,33,31,2,75,0,1,2,3,1,7,82
KERALA,2012,Student,31,59,0,0,0,90,27,146,0,0,0,173,263
KERALA,2012,Unemployed,0,80,194,214,123,611,0,39,51,27,25,142,753
KERALA,2012,Self-employed (Business activity),0,52,145,203,68,468,0,0,5,4,2,11,479
KERALA,2012,Professional Activity,0,20,50,81,11,162,0,6,2,2,0,10,172
KERALA,2012,Farming/Agriculture Activity,0,71,293,360,258,982,0,25,30,26,18,99,1081
KERALA,2012,Others (Please Specify),0,364,622,515,360,1861,1,49,53,47,53,203,2064
KERALA,2012,Retired Person,0,0,0,28,51,79,0,0,0,3,8,11,90
KERALA,2012,Others (Please Specify),0,170,428,613,335,1546,2,21,35,49,35,142,1688
KERALA,2012,Total,31,921,1976,2235,1246,6409,30,574,530,556,391,2081,8490
KERALA,2012,Total Salaried,0,105,244,221,40,610,0,38,31,26,1,96,706
KERALA,2012,Total Self-employed,0,507,1110,1159,697,3473,1,80,90,79,73,323,3796
MADHYA PRADESH,2001,House Wife,0,0,0,0,0,0,14,1346,553,201,87,2201,2201
MADHYA PRADESH,2001,Service (Government),0,59,54,40,1,154,0,13,12,3,0,28,182
MADHYA PRADESH,2001,Service (Private),0,142,108,40,4,294,0,48,10,5,0,63,357
MADHYA PRADESH,2001,Public Sector Undertaking,0,43,10,9,0,62,0,36,6,2,0,44,106
MADHYA PRADESH,2001,Student,50,147,11,3,0,211,32,62,0,0,0,94,305
MADHYA PRADESH,2001,Unemployed,2,91,63,23,18,197,2,11,0,0,0,13,210
MADHYA PRADESH,2001,Self-employed (Business activity),0,71,83,40,23,217,0,28,21,11,11,71,288
MADHYA PRADESH,2001,Professional Activity,0,30,64,20,12,126,0,4,8,7,3,22,148
MADHYA PRADESH,2001,Farming/Agriculture Activity,5,397,384,198,94,1078,5,142,95,31,21,294,1372
MADHYA PRADESH,2001,Others (Please Specify),40,230,194,148,85,697,43,105,59,30,14,251,948
MADHYA PRADESH,2001,Retired Person,0,0,0,0,13,13,0,0,0,0,1,1,14
MADHYA PRADESH,2001,Others (Please Specify),33,207,158,49,40,487,19,123,48,28,24,242,729
MADHYA PRADESH,2001,Total,130,1417,1129,570,290,3536,115,1918,812,318,161,3324,6860
MADHYA PRADESH,2001,Total Salaried,0,244,172,89,5,510,0,97,28,10,0,135,645
MADHYA PRADESH,2001,Total Self-employed,45,728,725,406,214,2118,48,279,183,79,49,638,2756
MADHYA PRADESH,2002,House Wife,0,0,0,0,0,0,7,1362,577,225,116,2287,2287
MADHYA PRADESH,2002,Service (Government),0,80,67,37,6,190,0,12,13,3,0,28,218
MADHYA PRADESH,2002,Service (Private),0,184,129,58,5,376,0,30,25,4,0,59,435
MADHYA PRADESH,2002,Public Sector Undertaking,0,62,30,3,0,95,0,11,7,5,0,23,118
MADHYA PRADESH,2002,Student,52,151,12,0,0,215,35,87,0,0,0,122,337
MADHYA PRADESH,2002,Unemployed,3,163,84,25,0,275,0,24,15,4,0,43,318
MADHYA PRADESH,2002,Self-employed (Business activity),0,107,101,65,20,293,0,26,22,11,11,70,363
MADHYA PRADESH,2002,Professional Activity,0,28,48,21,11,108,0,0,9,11,4,24,132
MADHYA PRADESH,2002,Farming/Agriculture Activity,2,386,350,203,100,1041,4,163,86,35,11,299,1340
MADHYA PRADESH,2002,Others (Please Specify),26,232,240,192,98,788,36,117,82,39,17,291,1079
MADHYA PRADESH,2002,Retired Person,0,0,0,1,27,28,0,0,0,0,0,0,28
MADHYA PRADESH,2002,Others (Please Specify),9,62,57,28,14,170,8,33,25,5,3,74,244
MADHYA PRADESH,2002,Total,92,1455,1118,633,281,3579,90,1865,861,342,162,3320,6899
MADHYA PRADESH,2002,Total Salaried,0,326,226,98,11,661,0,53,45,12,0,110,771
MADHYA PRADESH,2002,Total Self-employed,28,753,739,481,229,2230,40,306,199,96,43,684,2914
MADHYA PRADESH,2003,House Wife,0,0,0,0,0,0,1,1185,576,188,79,2029,2029
MADHYA PRADESH,2003,Service (Government),0,88,88,27,1,204,1,34,22,5,0,62,266
MADHYA PRADESH,2003,Service (Private),0,148,125,43,9,325,0,51,21,2,0,74,399
MADHYA PRADESH,2003,Public Sector Undertaking,0,60,57,15,3,135,1,15,2,5,0,23,158
MADHYA PRADESH,2003,Student,46,136,2,0,0,184,40,98,0,0,0,138,322
MADHYA PRADESH,2003,Unemployed,0,119,68,19,13,219,0,5,7,0,0,12,231
MADHYA PRADESH,2003,Self-employed (Business activity),0,86,81,43,33,243,0,17,15,8,10,50,293
MADHYA PRADESH,2003,Professional Activity,0,52,68,46,23,189,0,5,8,4,5,22,211
MADHYA PRADESH,2003,Farming/Agriculture Activity,4,402,431,177,89,1103,6,183,115,29,9,342,1445
MADHYA PRADESH,2003,Others (Please Specify),27,175,201,108,53,564,26,268,82,27,19,422,986
MADHYA PRADESH,2003,Retired Person,0,0,0,0,23,23,0,0,0,0,0,0,23
MADHYA PRADESH,2003,Others (Please Specify),17,113,93,88,38,349,14,18,12,3,3,50,399
MADHYA PRADESH,2003,Total,94,1379,1214,566,285,3538,89,1879,860,271,125,3224,6762
MADHYA PRADESH,2003,Total Salaried,0,296,270,85,13,664,2,100,45,12,0,159,823
MADHYA PRADESH,2003,Total Self-employed,31,715,781,374,198,2099,32,473,220,68,43,836,2935
MADHYA PRADESH,2004,House Wife,0,0,0,0,0,0,0,1244,584,198,86,2112,2112
MADHYA PRADESH,2004,Service (Government),0,62,70,31,7,170,0,15,13,6,0,34,204
MADHYA PRADESH,2004,Service (Private),1,115,142,65,11,334,0,39,21,1,0,61,395
MADHYA PRADESH,2004,Public Sector Undertaking,0,33,42,15,9,99,0,29,21,1,0,51,150
MADHYA PRADESH,2004,Student,64,88,1,0,0,153,38,73,0,0,0,111,264
MADHYA PRADESH,2004,Unemployed,1,159,70,20,0,250,0,20,11,1,0,32,282
MADHYA PRADESH,2004,Self-employed (Business activity),0,85,97,55,30,267,0,31,15,8,4,58,325
MADHYA PRADESH,2004,Professional Activity,0,42,46,57,16,161,0,6,8,7,6,27,188
MADHYA PRADESH,2004,Farming/Agriculture Activity,1,564,441,202,139,1347,9,143,83,38,18,291,1638
MADHYA PRADESH,2004,Others (Please Specify),18,193,217,126,83,637,48,118,52,56,43,317,954
MADHYA PRADESH,2004,Retired Person,0,0,0,0,14,14,0,0,0,0,0,0,14
MADHYA PRADESH,2004,Others (Please Specify),24,67,76,24,11,202,15,35,11,5,1,67,269
MADHYA PRADESH,2004,Total,109,1408,1202,595,320,3634,110,1753,819,321,158,3161,6795
MADHYA PRADESH,2004,Total Salaried,1,210,254,111,27,603,0,83,55,8,0,146,749
MADHYA PRADESH,2004,Total Self-employed,19,884,801,440,268,2412,57,298,158,109,71,693,3105
MADHYA PRADESH,2005,House Wife,0,0,0,0,0,0,0,1114,523,178,77,1892,1892
MADHYA PRADESH,2005,Service (Government),0,7,19,17,0,43,0,6,4,1,0,11,54
MADHYA PRADESH,2005,Service (Private),0,73,64,26,5,168,0,40,5,1,1,47,215
MADHYA PRADESH,2005,Public Sector Undertaking,0,44,33,10,5,92,0,16,14,1,0,31,123
MADHYA PRADESH,2005,Student,34,95,1,0,0,130,18,51,0,0,0,69,199
MADHYA PRADESH,2005,Unemployed,0,108,62,36,6,212,0,17,8,2,0,27,239
MADHYA PRADESH,2005,Self-employed (Business activity),3,60,66,35,10,174,0,18,5,1,0,24,198
MADHYA PRADESH,2005,Professional Activity,2,30,77,19,3,131,0,17,4,6,3,30,161
MADHYA PRADESH,2005,Farming/Agriculture Activity,7,452,333,177,86,1055,4,108,64,12,5,193,1248
MADHYA PRADESH,2005,Others (Please Specify),15,193,236,104,68,616,26,96,36,9,9,176,792
MADHYA PRADESH,2005,Retired Person,0,0,0,0,8,8,0,0,0,0,0,0,8
MADHYA PRADESH,2005,Others (Please Specify),22,62,58,48,32,222,30,44,21,1,1,97,319
MADHYA PRADESH,2005,Total,83,1124,949,472,223,2851,78,1527,684,212,96,2597,5448
MADHYA PRADESH,2005,Total Salaried,0,124,116,53,10,303,0,62,23,3,1,89,392
MADHYA PRADESH,2005,Total Self-employed,27,735,712,335,167,1976,30,239,109,28,17,423,2399
MADHYA PRADESH,2006,House Wife,0,0,0,0,0,0,13,1026,595,184,83,1901,1901
MADHYA PRADESH,2006,Service (Government),1,18,22,27,0,68,0,20,8,0,0,28,96
MADHYA PRADESH,2006,Service (Private),2,64,72,51,9,198,0,49,15,4,1,69,267
MADHYA PRADESH,2006,Public Sector Undertaking,2,37,45,17,4,105,2,14,4,4,0,24,129
MADHYA PRADESH,2006,Student,36,140,12,5,5,198,36,111,15,5,0,167,365
MADHYA PRADESH,2006,Unemployed,2,124,76,52,20,274,0,9,6,7,0,22,296
MADHYA PRADESH,2006,Self-employed (Business activity),3,46,84,46,20,199,0,6,2,0,0,8,207
MADHYA PRADESH,2006,Professional Activity,0,62,58,25,8,153,0,3,5,2,2,12,165
MADHYA PRADESH,2006,Farming/Agriculture Activity,20,349,448,241,120,1178,5,110,62,18,2,197,1375
MADHYA PRADESH,2006,Others (Please Specify),14,198,244,148,71,675,12,103,61,18,14,208,883
MADHYA PRADESH,2006,Retired Person,0,0,0,1,8,9,0,0,0,0,0,0,9
MADHYA PRADESH,2006,Others (Please Specify),16,129,166,101,34,446,15,108,117,43,13,296,742
MADHYA PRADESH,2006,Total,96,1167,1227,714,299,3503,83,1559,890,285,115,2932,6435
MADHYA PRADESH,2006,Total Salaried,5,119,139,95,13,371,2,83,27,8,1,121,492
MADHYA PRADESH,2006,Total Self-employed,37,655,834,460,219,2205,17,222,130,38,18,425,2630
MADHYA PRADESH,2007,House Wife,0,0,0,0,0,0,17,1128,511,165,86,1907,1907
MADHYA PRADESH,2007,Service (Government),0,20,18,31,1,70,0,8,6,1,2,17,87
MADHYA PRADESH,2007,Service (Private),11,63,53,35,7,169,1,45,25,8,1,80,249
MADHYA PRADESH,2007,Public Sector Undertaking,0,65,47,26,1,139,1,44,11,9,0,65,204
MADHYA PRADESH,2007,Student,34,155,2,0,0,191,32,98,0,1,4,135,326
MADHYA PRADESH,2007,Unemployed,2,124,81,37,14,258,0,21,7,0,0,28,286
MADHYA PRADESH,2007,Self-employed (Business activity),0,110,116,73,13,312,0,33,17,2,1,53,365
MADHYA PRADESH,2007,Professional Activity,0,75,62,33,12,182,0,11,1,0,0,12,194
MADHYA PRADESH,2007,Farming/Agriculture Activity,26,335,376,223,105,1065,8,104,67,15,4,198,1263
MADHYA PRADESH,2007,Others (Please Specify),3,242,217,129,66,657,35,128,55,13,14,245,902
MADHYA PRADESH,2007,Retired Person,0,2,9,5,4,20,2,0,0,0,0,2,22
MADHYA PRADESH,2007,Others (Please Specify),17,122,145,84,39,407,16,53,26,15,7,117,524
MADHYA PRADESH,2007,Total,93,1313,1126,676,262,3470,112,1673,726,229,119,2859,6329
MADHYA PRADESH,2007,Total Salaried,11,148,118,92,9,378,2,97,42,18,3,162,540
MADHYA PRADESH,2007,Total Self-employed,29,762,771,458,196,2216,43,276,140,30,19,508,2724
MADHYA PRADESH,2008,House Wife,0,0,0,0,0,0,6,1204,593,215,55,2073,2073
MADHYA PRADESH,2008,Service (Government),0,60,66,56,0,182,0,22,26,0,0,48,230
MADHYA PRADESH,2008,Service (Private),2,132,142,55,6,337,0,26,69,5,0,100,437
MADHYA PRADESH,2008,Public Sector Undertaking,0,69,73,73,13,228,0,3,6,0,0,9,237
MADHYA PRADESH,2008,Student,29,180,26,6,0,241,50,128,1,0,0,179,420
MADHYA PRADESH,2008,Unemployed,1,146,78,48,5,278,0,38,15,0,0,53,331
MADHYA PRADESH,2008,Self-employed (Business activity),1,103,148,43,12,307,0,14,8,2,0,24,331
MADHYA PRADESH,2008,Professional Activity,2,62,86,48,4,202,0,19,10,4,0,33,235
MADHYA PRADESH,2008,Farming/Agriculture Activity,6,437,389,204,136,1172,2,106,68,21,10,207,1379
MADHYA PRADESH,2008,Others (Please Specify),21,250,308,206,160,945,10,154,87,37,23,311,1256
MADHYA PRADESH,2008,Retired Person,0,3,2,0,13,18,0,0,0,0,0,0,18
MADHYA PRADESH,2008,Others (Please Specify),13,150,183,76,33,455,12,119,62,21,13,227,682
MADHYA PRADESH,2008,Total,75,1592,1501,815,382,4365,80,1833,945,305,101,3264,7629
MADHYA PRADESH,2008,Total Salaried,2,261,281,184,19,747,0,51,101,5,0,157,904
MADHYA PRADESH,2008,Total Self-employed,30,852,931,501,312,2626,12,293,173,64,33,575,3201
MADHYA PRADESH,2009,House Wife,0,0,0,0,0,0,11,1334,652,220,69,2286,2286
MADHYA PRADESH,2009,Service (Government),0,13,15,16,0,44,0,1,4,8,0,13,57
MADHYA PRADESH,2009,Service (Private),1,136,230,144,27,538,0,73,14,11,2,100,638
MADHYA PRADESH,2009,Public Sector Undertaking,0,10,12,8,1,31,0,4,0,0,0,4,35
MADHYA PRADESH,2009,Student,75,213,41,10,0,339,68,169,20,1,0,258,597
MADHYA PRADESH,2009,Unemployed,6,160,94,34,7,301,0,16,5,1,0,22,323
MADHYA PRADESH,2009,Self-employed (Business activity),23,136,185,165,72,581,0,8,13,2,0,23,604
MADHYA PRADESH,2009,Professional Activity,20,96,111,97,32,356,0,11,4,3,0,18,374
MADHYA PRADESH,2009,Farming/Agriculture Activity,6,418,354,239,103,1120,6,127,102,25,15,275,1395
MADHYA PRADESH,2009,Others (Please Specify),15,297,251,143,80,786,63,85,72,18,11,249,1035
MADHYA PRADESH,2009,Retired Person,0,0,3,2,10,15,0,0,0,0,0,0,15
MADHYA PRADESH,2009,Others (Please Specify),120,279,288,230,72,989,94,268,256,87,60,765,1754
MADHYA PRADESH,2009,Total,266,1758,1584,1088,404,5100,242,2096,1142,376,157,4013,9113
MADHYA PRADESH,2009,Total Salaried,1,159,257,168,28,613,0,78,18,19,2,117,730
MADHYA PRADESH,2009,Total Self-employed,64,947,901,644,287,2843,69,231,191,48,26,565,3408
MADHYA PRADESH,2010,House Wife,0,0,0,0,0,0,18,1366,815,255,110,2564,2564
MADHYA PRADESH,2010,Service (Government),0,19,48,29,6,102,0,3,5,4,0,12,114
MADHYA PRADESH,2010,Service (Private),0,149,108,66,21,344,2,24,18,8,6,58,402
MADHYA PRADESH,2010,Public Sector Undertaking,0,39,64,15,13,131,0,6,3,2,4,15,146
MADHYA PRADESH,2010,Student,73,175,8,12,0,268,51,135,5,0,0,191,459
MADHYA PRADESH,2010,Unemployed,10,133,111,42,12,308,8,44,12,2,0,66,374
MADHYA PRADESH,2010,Self-employed (Business activity),0,112,145,89,25,371,0,0,0,0,0,0,371
MADHYA PRADESH,2010,Professional Activity,0,93,97,73,29,292,3,10,12,3,0,28,320
MADHYA PRADESH,2010,Farming/Agriculture Activity,17,282,357,208,109,973,14,132,74,27,17,264,1237
MADHYA PRADESH,2010,Others (Please Specify),49,524,464,272,116,1425,36,265,133,68,27,529,1954
MADHYA PRADESH,2010,Retired Person,0,0,1,4,6,11,0,5,0,0,0,5,16
MADHYA PRADESH,2010,Others (Please Specify),66,264,265,180,87,862,29,85,28,23,19,184,1046
MADHYA PRADESH,2010,Total,215,1790,1668,990,424,5087,161,2075,1105,392,183,3916,9003
MADHYA PRADESH,2010,Total Salaried,0,207,220,110,40,577,2,33,26,14,10,85,662
MADHYA PRADESH,2010,Total Self-employed,66,1011,1063,642,279,3061,53,407,219,98,44,821,3882
MADHYA PRADESH,2011,House Wife,0,0,0,0,0,0,14,1403,863,305,147,2732,2732
MADHYA PRADESH,2011,Service (Government),0,20,44,31,0,95,0,10,5,2,0,17,112
MADHYA PRADESH,2011,Service (Private),0,166,198,115,17,496,0,45,21,8,1,75,571
MADHYA PRADESH,2011,Public Sector Undertaking,0,37,57,23,8,125,2,15,16,3,1,37,162
MADHYA PRADESH,2011,Student,53,202,10,0,0,265,39,139,8,0,0,186,451
MADHYA PRADESH,2011,Unemployed,6,107,80,15,5,213,6,32,9,3,0,50,263
MADHYA PRADESH,2011,Self-employed (Business activity),0,156,177,90,32,455,0,5,1,3,0,9,464
MADHYA PRADESH,2011,Professional Activity,0,103,57,56,32,248,0,6,5,6,2,19,267
MADHYA PRADESH,2011,Farming/Agriculture Activity,10,366,446,184,126,1132,6,84,84,15,5,194,1326
MADHYA PRADESH,2011,Others (Please Specify),44,485,416,252,129,1326,58,194,142,54,20,468,1794
MADHYA PRADESH,2011,Retired Person,0,5,0,2,13,20,0,16,3,3,1,23,43
MADHYA PRADESH,2011,Others (Please Specify),43,330,274,148,70,865,38,107,30,27,7,209,1074
MADHYA PRADESH,2011,Total,156,1977,1759,916,432,5240,163,2056,1187,429,184,4019,9259
MADHYA PRADESH,2011,Total Salaried,0,223,299,169,25,716,2,70,42,13,2,129,845
MADHYA PRADESH,2011,Total Self-employed,54,1110,1096,582,319,3161,64,289,232,78,27,690,3851
MADHYA PRADESH,2012,House Wife,0,0,0,0,0,0,4,1463,824,314,135,2740,2740
MADHYA PRADESH,2012,Service (Government),0,21,42,18,2,83,1,5,11,0,0,17,100
MADHYA PRADESH,2012,Service (Private),2,236,251,103,19,611,0,38,35,14,0,87,698
MADHYA PRADESH,2012,Public Sector Undertaking,0,48,62,27,13,150,0,2,12,8,2,24,174
MADHYA PRADESH,2012,Student,85,235,11,0,0,331,74,187,2,1,0,264,595
MADHYA PRADESH,2012,Unemployed,6,177,118,42,8,351,4,23,31,29,4,91,442
MADHYA PRADESH,2012,Self-employed (Business activity),0,114,151,121,36,422,0,22,12,11,2,47,469
MADHYA PRADESH,2012,Professional Activity,0,129,145,90,38,402,0,24,17,14,6,61,463
MADHYA PRADESH,2012,Farming/Agriculture Activity,0,270,413,253,102,1038,3,70,39,18,4,134,1172
MADHYA PRADESH,2012,Others (Please Specify),34,478,513,300,162,1487,33,127,91,64,30,345,1832
MADHYA PRADESH,2012,Retired Person,0,0,0,1,26,27,0,0,0,0,2,2,29
MADHYA PRADESH,2012,Others (Please Specify),17,288,282,193,92,872,15,99,40,13,22,189,1061
MADHYA PRADESH,2012,Total,144,1996,1988,1148,498,5774,134,2060,1114,486,207,4001,9775
MADHYA PRADESH,2012,Total Salaried,2,305,355,148,34,844,1,45,58,22,2,128,972
MADHYA PRADESH,2012,Total Self-employed,34,991,1222,764,338,3349,36,243,159,107,42,587,3936
MAHARASHTRA,2001,House Wife,0,0,0,0,0,0,9,1663,1078,394,207,3351,3351
MAHARASHTRA,2001,Service (Government),0,51,111,57,3,222,0,19,15,3,0,37,259
MAHARASHTRA,2001,Service (Private),0,346,561,337,40,1284,0,74,48,21,2,145,1429
MAHARASHTRA,2001,Public Sector Undertaking,0,33,40,38,2,113,0,7,3,1,0,11,124
MAHARASHTRA,2001,Student,81,337,15,0,0,433,78,273,5,0,0,356,789
MAHARASHTRA,2001,Unemployed,0,386,357,162,51,956,0,60,19,17,5,101,1057
MAHARASHTRA,2001,Self-employed (Business activity),0,118,157,108,18,401,0,10,16,11,0,37,438
MAHARASHTRA,2001,Professional Activity,0,62,106,54,22,244,0,6,5,9,4,24,268
MAHARASHTRA,2001,Farming/Agriculture Activity,11,789,1263,643,239,2945,13,278,205,72,23,591,3536
MAHARASHTRA,2001,Others (Please Specify),33,640,984,471,277,2405,27,228,201,81,42,579,2984
MAHARASHTRA,2001,Retired Person,0,0,6,39,125,170,0,0,0,5,7,12,182
MAHARASHTRA,2001,Others (Please Specify),3,43,70,29,20,165,6,15,12,3,0,36,201
MAHARASHTRA,2001,Total,128,2805,3670,1938,797,9338,133,2633,1607,617,290,5280,14618
MAHARASHTRA,2001,Total Salaried,0,430,712,432,45,1619,0,100,66,25,2,193,1812
MAHARASHTRA,2001,Total Self-employed,44,1609,2510,1276,556,5995,40,522,427,173,69,1231,7226
MAHARASHTRA,2002,House Wife,0,0,0,0,0,0,0,1762,1091,362,200,3415,3415
MAHARASHTRA,2002,Service (Government),0,43,123,54,0,220,0,14,11,3,0,28,248
MAHARASHTRA,2002,Service (Private),0,319,554,256,37,1166,0,50,54,20,7,131,1297
MAHARASHTRA,2002,Public Sector Undertaking,0,32,41,30,0,103,0,3,3,1,0,7,110
MAHARASHTRA,2002,Student,77,367,4,0,0,448,86,286,6,0,0,378,826
MAHARASHTRA,2002,Unemployed,0,390,355,149,2,896,7,66,27,2,0,102,998
MAHARASHTRA,2002,Self-employed (Business activity),0,94,214,135,77,520,0,26,19,4,3,52,572
MAHARASHTRA,2002,Professional Activity,0,148,170,61,28,407,0,5,14,6,3,28,435
MAHARASHTRA,2002,Farming/Agriculture Activity,3,868,1229,669,386,3155,0,269,134,86,51,540,3695
MAHARASHTRA,2002,Others (Please Specify),21,538,881,439,278,2157,13,161,118,43,23,358,2515
MAHARASHTRA,2002,Retired Person,0,0,5,35,113,153,0,0,1,3,12,16,169
MAHARASHTRA,2002,Others (Please Specify),1,45,94,38,44,222,4,3,5,8,7,27,249
MAHARASHTRA,2002,Total,102,2844,3670,1866,965,9447,110,2645,1483,538,306,5082,14529
MAHARASHTRA,2002,Total Salaried,0,394,718,340,37,1489,0,67,68,24,7,166,1655
MAHARASHTRA,2002,Total Self-employed,24,1648,2494,1304,769,6239,13,461,285,139,80,978,7217
MAHARASHTRA,2003,House Wife,0,0,0,0,0,0,0,1701,1206,410,205,3522,3522
MAHARASHTRA,2003,Service (Government),0,43,126,77,0,246,0,14,13,3,0,30,276
MAHARASHTRA,2003,Service (Private),0,419,683,297,33,1432,0,86,72,13,0,171,1603
MAHARASHTRA,2003,Public Sector Undertaking,0,24,58,36,0,118,0,9,5,3,0,17,135
MAHARASHTRA,2003,Student,81,408,10,0,0,499,81,290,4,0,0,375,874
MAHARASHTRA,2003,Unemployed,1,414,350,105,17,887,1,42,25,13,0,81,968
MAHARASHTRA,2003,Self-employed (Business activity),0,152,223,122,22,519,0,11,11,4,0,26,545
MAHARASHTRA,2003,Professional Activity,0,74,116,62,18,270,0,10,4,1,1,16,286
MAHARASHTRA,2003,Farming/Agriculture Activity,8,899,1310,812,352,3381,4,202,148,73,28,455,3836
MAHARASHTRA,2003,Others (Please Specify),9,592,831,546,228,2206,6,117,62,37,17,239,2445
MAHARASHTRA,2003,Retired Person,0,0,1,33,110,144,0,0,0,0,6,6,150
MAHARASHTRA,2003,Others (Please Specify),0,41,39,16,12,108,0,4,2,4,2,12,120
MAHARASHTRA,2003,Total,99,3066,3747,2106,792,9810,92,2486,1552,561,259,4950,14760
MAHARASHTRA,2003,Total Salaried,0,486,867,410,33,1796,0,109,90,19,0,218,2014
MAHARASHTRA,2003,Total Self-employed,17,1717,2480,1542,620,6376,10,340,225,115,46,736,7112
MAHARASHTRA,2004,House Wife,0,0,0,0,0,0,0,1768,1096,422,215,3501,3501
MAHARASHTRA,2004,Service (Government),0,38,97,66,0,201,0,23,13,7,0,43,244
MAHARASHTRA,2004,Service (Private),0,403,599,300,43,1345,0,61,30,9,1,101,1446
MAHARASHTRA,2004,Public Sector Undertaking,0,46,62,40,6,154,0,4,2,3,0,9,163
MAHARASHTRA,2004,Student,77,427,12,0,0,516,81,357,5,0,0,443,959
MAHARASHTRA,2004,Unemployed,0,514,396,99,9,1018,2,46,11,1,0,60,1078
MAHARASHTRA,2004,Self-employed (Business activity),0,134,201,130,40,505,0,9,12,5,1,27,532
MAHARASHTRA,2004,Professional Activity,0,79,123,82,26,310,0,5,4,0,0,9,319
MAHARASHTRA,2004,Farming/Agriculture Activity,3,909,1504,940,443,3799,3,155,107,59,24,348,4147
MAHARASHTRA,2004,Others (Please Specify),7,517,715,456,168,1863,5,136,71,29,24,265,2128
MAHARASHTRA,2004,Retired Person,0,0,0,16,105,121,0,0,0,0,2,2,123
MAHARASHTRA,2004,Others (Please Specify),0,13,29,9,20,71,2,9,2,1,4,18,89
MAHARASHTRA,2004,Total,87,3080,3738,2138,860,9903,93,2573,1353,536,271,4826,14729
MAHARASHTRA,2004,Total Salaried,0,487,758,406,49,1700,0,88,45,19,1,153,1853
MAHARASHTRA,2004,Total Self-employed,10,1639,2543,1608,677,6477,8,305,194,93,49,649,7126
MAHARASHTRA,2005,House Wife,0,0,0,0,0,0,3,1857,1084,409,229,3582,3582
MAHARASHTRA,2005,Service (Government),0,36,122,102,0,260,0,18,18,4,0,40,300
MAHARASHTRA,2005,Service (Private),0,456,650,340,39,1485,1,78,34,6,2,121,1606
MAHARASHTRA,2005,Public Sector Undertaking,0,30,39,33,3,105,0,9,3,1,0,13,118
MAHARASHTRA,2005,Student,53,346,3,0,0,402,55,327,0,0,0,382,784
MAHARASHTRA,2005,Unemployed,0,459,368,121,2,950,0,63,13,3,0,79,1029
MAHARASHTRA,2005,Self-employed (Business activity),0,98,188,81,17,384,0,4,1,1,0,6,390
MAHARASHTRA,2005,Professional Activity,0,97,151,102,27,377,0,7,2,4,3,16,393
MAHARASHTRA,2005,Farming/Agriculture Activity,4,826,1433,908,467,3638,2,127,76,58,25,288,3926
MAHARASHTRA,2005,Others (Please Specify),17,501,625,373,251,1767,15,117,57,59,19,267,2034
MAHARASHTRA,2005,Retired Person,0,0,0,15,99,114,0,0,0,1,6,7,121
MAHARASHTRA,2005,Others (Please Specify),1,28,52,26,14,121,3,6,8,3,2,22,143
MAHARASHTRA,2005,Total,75,2877,3631,2101,919,9603,79,2613,1296,549,286,4823,14426
MAHARASHTRA,2005,Total Salaried,0,522,811,475,42,1850,1,105,55,11,2,174,2024
MAHARASHTRA,2005,Total Self-employed,21,1522,2397,1464,762,6166,17,255,136,122,47,577,6743
MAHARASHTRA,2006,House Wife,0,0,0,0,0,0,1,1911,1067,409,265,3653,3653
MAHARASHTRA,2006,Service (Government),0,95,202,135,0,432,0,19,25,6,0,50,482
MAHARASHTRA,2006,Service (Private),0,400,536,271,34,1241,0,64,27,11,2,104,1345
MAHARASHTRA,2006,Public Sector Undertaking,0,37,78,40,5,160,0,5,6,1,0,12,172
MAHARASHTRA,2006,Student,54,389,1,0,0,444,70,368,0,0,0,438,882
MAHARASHTRA,2006,Unemployed,4,388,341,108,31,872,2,52,12,6,0,72,944
MAHARASHTRA,2006,Self-employed (Business activity),0,148,203,98,23,472,0,8,10,0,1,19,491
MAHARASHTRA,2006,Professional Activity,0,156,287,159,51,653,0,25,23,7,1,56,709
MAHARASHTRA,2006,Farming/Agriculture Activity,7,942,1589,1032,541,4111,3,142,113,57,27,342,4453
MAHARASHTRA,2006,Others (Please Specify),3,463,712,409,170,1757,6,82,77,28,21,214,1971
MAHARASHTRA,2006,Retired Person,0,0,1,25,106,132,0,0,0,0,8,8,140
MAHARASHTRA,2006,Others (Please Specify),0,70,92,49,25,236,3,7,6,0,0,16,252
MAHARASHTRA,2006,Total,68,3088,4042,2326,986,10510,85,2683,1366,525,325,4984,15494
MAHARASHTRA,2006,Total Salaried,0,532,816,446,39,1833,0,88,58,18,2,166,1999
MAHARASHTRA,2006,Total Self-employed,10,1709,2791,1698,785,6993,9,257,223,92,50,631,7624
MAHARASHTRA,2007,House Wife,0,0,0,0,0,0,4,1880,1031,410,238,3563,3563
MAHARASHTRA,2007,Service (Government),0,41,90,78,2,211,0,11,3,1,0,15,226
MAHARASHTRA,2007,Service (Private),0,444,616,356,36,1452,0,80,47,11,0,138,1590
MAHARASHTRA,2007,Public Sector Undertaking,0,31,44,37,3,115,0,11,4,5,0,20,135
MAHARASHTRA,2007,Student,41,355,8,0,0,404,69,319,1,0,0,389,793
MAHARASHTRA,2007,Unemployed,0,429,355,162,32,978,0,51,7,2,1,61,1039
MAHARASHTRA,2007,Self-employed (Business activity),0,108,194,104,28,434,0,3,6,1,0,10,444
MAHARASHTRA,2007,Professional Activity,0,168,291,165,57,681,0,27,18,12,9,66,747
MAHARASHTRA,2007,Farming/Agriculture Activity,0,908,1498,1038,524,3968,0,131,73,37,29,270,4238
MAHARASHTRA,2007,Others (Please Specify),0,533,797,453,216,1999,1,103,63,32,12,211,2210
MAHARASHTRA,2007,Retired Person,0,0,1,27,118,146,0,0,7,3,7,17,163
MAHARASHTRA,2007,Others (Please Specify),1,5,14,5,7,32,0,2,1,1,0,4,36
MAHARASHTRA,2007,Total,42,3022,3908,2425,1023,10420,74,2618,1261,515,296,4764,15184
MAHARASHTRA,2007,Total Salaried,0,516,750,471,41,1778,0,102,54,17,0,173,1951
MAHARASHTRA,2007,Total Self-employed,0,1717,2780,1760,825,7082,1,264,160,82,50,557,7639
MAHARASHTRA,2008,House Wife,0,0,0,0,0,0,7,1744,1017,369,247,3384,3384
MAHARASHTRA,2008,Service (Government),0,28,61,58,0,147,0,6,4,0,0,10,157
MAHARASHTRA,2008,Service (Private),0,476,693,360,31,1560,0,65,23,5,0,93,1653
MAHARASHTRA,2008,Public Sector Undertaking,0,59,66,44,9,178,1,13,4,0,0,18,196
MAHARASHTRA,2008,Student,44,355,8,0,0,407,57,290,3,0,0,350,757
MAHARASHTRA,2008,Unemployed,2,353,284,134,23,796,0,56,19,1,1,77,873
MAHARASHTRA,2008,Self-employed (Business activity),0,111,191,125,31,458,0,8,3,0,0,11,469
MAHARASHTRA,2008,Professional Activity,0,136,183,111,51,481,0,27,24,6,2,59,540
MAHARASHTRA,2008,Farming/Agriculture Activity,0,856,1392,935,390,3573,2,89,92,31,15,229,3802
MAHARASHTRA,2008,Others (Please Specify),0,623,778,418,181,2000,1,105,56,43,14,219,2219
MAHARASHTRA,2008,Retired Person,0,0,0,20,100,120,0,0,1,2,10,13,133
MAHARASHTRA,2008,Others (Please Specify),1,39,69,42,18,169,6,9,5,1,1,22,191
MAHARASHTRA,2008,Total,47,3036,3725,2247,834,9889,74,2412,1251,458,290,4485,14374
MAHARASHTRA,2008,Total Salaried,0,563,820,462,40,1885,1,84,31,5,0,121,2006
MAHARASHTRA,2008,Total Self-employed,0,1726,2544,1589,653,6512,3,229,175,80,31,518,7030
MAHARASHTRA,2009,House Wife,0,0,0,0,0,0,0,1656,1097,399,231,3383,3383
MAHARASHTRA,2009,Service (Government),0,20,61,57,1,139,0,8,3,4,0,15,154
MAHARASHTRA,2009,Service (Private),0,496,724,345,45,1610,0,78,33,8,1,120,1730
MAHARASHTRA,2009,Public Sector Undertaking,0,37,74,38,2,151,0,7,3,2,0,12,163
MAHARASHTRA,2009,Student,42,358,3,0,0,403,48,353,8,0,0,409,812
MAHARASHTRA,2009,Unemployed,0,356,313,119,33,821,0,33,10,9,0,52,873
MAHARASHTRA,2009,Self-employed (Business activity),0,112,165,108,27,412,0,3,4,0,0,7,419
MAHARASHTRA,2009,Professional Activity,0,162,219,157,53,591,0,13,14,9,3,39,630
MAHARASHTRA,2009,Farming/Agriculture Activity,0,557,1062,728,345,2692,2,89,36,40,13,180,2872
MAHARASHTRA,2009,Others (Please Specify),2,723,930,576,280,2511,2,131,76,27,16,252,2763
MAHARASHTRA,2009,Retired Person,0,0,2,14,117,133,0,0,0,1,2,3,136
MAHARASHTRA,2009,Others (Please Specify),4,80,133,48,57,322,3,16,10,4,10,43,365
MAHARASHTRA,2009,Total,48,2901,3686,2190,960,9785,55,2387,1294,503,276,4515,14300
MAHARASHTRA,2009,Total Salaried,0,553,859,440,48,1900,0,93,39,14,1,147,2047
MAHARASHTRA,2009,Total Self-employed,2,1554,2376,1569,705,6206,4,236,130,76,32,478,6684
MAHARASHTRA,2010,House Wife,0,0,0,0,0,0,0,1882,1098,405,254,3639,3639
MAHARASHTRA,2010,Service (Government),0,35,78,59,1,173,0,8,1,1,0,10,183
MAHARASHTRA,2010,Service (Private),0,559,739,376,40,1714,1,93,34,15,0,143,1857
MAHARASHTRA,2010,Public Sector Undertaking,0,40,69,28,6,143,0,3,1,0,0,4,147
MAHARASHTRA,2010,Student,46,427,8,1,0,482,82,492,0,0,0,574,1056
MAHARASHTRA,2010,Unemployed,0,365,305,108,41,819,2,60,20,6,1,89,908
MAHARASHTRA,2010,Self-employed (Business activity),0,143,172,100,24,439,0,3,3,0,0,6,445
MAHARASHTRA,2010,Professional Activity,0,265,376,270,129,1040,0,42,22,15,4,83,1123
MAHARASHTRA,2010,Farming/Agriculture Activity,0,784,1094,743,326,2947,2,79,68,33,12,194,3141
MAHARASHTRA,2010,Others (Please Specify),0,792,1020,586,270,2668,3,134,79,44,23,283,2951
MAHARASHTRA,2010,Retired Person,0,0,1,13,99,113,0,0,1,0,3,4,117
MAHARASHTRA,2010,Others (Please Specify),3,75,110,79,53,320,5,8,7,5,4,29,349
MAHARASHTRA,2010,Total,49,3485,3972,2363,989,10858,95,2804,1334,524,301,5058,15916
MAHARASHTRA,2010,Total Salaried,0,634,886,463,47,2030,1,104,36,16,0,157,2187
MAHARASHTRA,2010,Total Self-employed,0,1984,2662,1699,749,7094,5,258,172,92,39,566,7660
MAHARASHTRA,2011,House Wife,0,0,0,0,0,0,10,1863,1152,429,262,3716,3716
MAHARASHTRA,2011,Service (Government),0,35,74,59,2,170,0,13,10,2,0,25,195
MAHARASHTRA,2011,Service (Private),1,633,738,363,62,1797,0,82,46,8,1,137,1934
MAHARASHTRA,2011,Public Sector Undertaking,0,19,33,21,3,76,0,5,4,1,0,10,86
MAHARASHTRA,2011,Student,33,441,7,0,0,481,60,437,10,0,0,507,988
MAHARASHTRA,2011,Unemployed,0,299,203,71,18,591,3,50,7,6,1,67,658
MAHARASHTRA,2011,Self-employed (Business activity),0,168,248,150,12,578,0,11,14,7,0,32,610
MAHARASHTRA,2011,Professional Activity,0,209,288,185,68,750,0,20,7,8,1,36,786
MAHARASHTRA,2011,Farming/Agriculture Activity,2,727,1186,808,370,3093,1,123,92,19,9,244,3337
MAHARASHTRA,2011,Others (Please Specify),7,808,995,565,346,2721,5,110,71,51,18,255,2976
MAHARASHTRA,2011,Retired Person,0,4,6,16,118,144,0,0,0,1,2,3,147
MAHARASHTRA,2011,Others (Please Specify),3,134,182,111,56,486,1,14,9,2,2,28,514
MAHARASHTRA,2011,Total,46,3477,3960,2349,1055,10887,80,2728,1422,534,296,5060,15947
MAHARASHTRA,2011,Total Salaried,1,687,845,443,67,2043,0,100,60,11,1,172,2215
MAHARASHTRA,2011,Total Self-employed,9,1912,2717,1708,796,7142,6,264,184,85,28,567,7709
MAHARASHTRA,2012,House Wife,0,0,0,0,0,0,3,1637,1010,438,262,3350,3350
MAHARASHTRA,2012,Service (Government),0,32,70,58,1,161,0,19,8,1,0,28,189
MAHARASHTRA,2012,Service (Private),0,721,826,477,77,2101,0,108,41,12,2,163,2264
MAHARASHTRA,2012,Public Sector Undertaking,0,60,77,66,6,209,0,8,4,1,0,13,222
MAHARASHTRA,2012,Student,64,376,9,0,0,449,68,401,3,0,0,472,921
MAHARASHTRA,2012,Unemployed,0,370,296,143,23,832,0,91,27,14,0,132,964
MAHARASHTRA,2012,Self-employed (Business activity),0,164,224,136,45,569,0,2,4,1,1,8,577
MAHARASHTRA,2012,Professional Activity,0,116,156,98,33,403,0,13,6,5,2,26,429
MAHARASHTRA,2012,Farming/Agriculture Activity,0,804,1267,980,432,3483,0,100,131,55,17,303,3786
MAHARASHTRA,2012,Others (Please Specify),6,607,758,517,245,2133,9,111,62,35,12,229,2362
MAHARASHTRA,2012,Retired Person,0,0,0,22,121,143,0,0,0,0,3,3,146
MAHARASHTRA,2012,Others (Please Specify),3,246,315,182,75,821,3,41,17,12,8,81,902
MAHARASHTRA,2012,Total,73,3496,3998,2679,1058,11304,83,2531,1313,574,307,4808,16112
MAHARASHTRA,2012,Total Salaried,0,813,973,601,84,2471,0,135,53,14,2,204,2675
MAHARASHTRA,2012,Total Self-employed,6,1691,2405,1731,755,6588,9,226,203,96,32,566,7154
MANIPUR,2001,House Wife,0,0,0,0,0,0,0,3,5,1,0,9,9
MANIPUR,2001,Service (Government),0,0,0,0,0,0,0,0,0,0,0,0,0
MANIPUR,2001,Service (Private),0,0,0,0,0,0,0,0,0,0,0,0,0
MANIPUR,2001,Public Sector Undertaking,0,3,0,0,0,3,0,0,0,0,0,0,3
MANIPUR,2001,Student,1,5,0,0,0,6,0,1,0,0,0,1,7
MANIPUR,2001,Unemployed,0,0,0,2,0,2,0,0,0,0,0,0,2
MANIPUR,2001,Self-employed (Business activity),0,0,0,0,0,0,0,0,0,0,0,0,0
MANIPUR,2001,Professional Activity,0,0,0,0,0,0,0,0,0,0,0,0,0
MANIPUR,2001,Farming/Agriculture Activity,0,0,0,0,0,0,0,0,0,0,0,0,0
MANIPUR,2001,Others (Please Specify),0,0,4,3,1,8,0,3,0,0,0,3,11
MANIPUR,2001,Retired Person,0,0,0,0,0,0,0,0,0,0,0,0,0
MANIPUR,2001,Others (Please Specify),0,4,1,0,0,5,0,4,0,0,0,4,9
MANIPUR,2001,Total,1,12,5,5,1,24,0,11,5,1,0,17,41
MANIPUR,2001,Total Salaried,0,3,0,0,0,3,0,0,0,0,0,0,3
MANIPUR,2001,Total Self-employed,0,0,4,3,1,8,0,3,0,0,0,3,11
MANIPUR,2002,House Wife,0,0,0,0,0,0,0,3,0,0,0,3,3
MANIPUR,2002,Service (Government),0,0,3,1,0,4,0,0,0,0,0,0,4
MANIPUR,2002,Service (Private),0,0,0,0,0,0,0,0,0,0,0,0,0
MANIPUR,2002,Public Sector Undertaking,0,0,2,1,1,4,0,0,0,0,0,0,4
MANIPUR,2002,Student,0,7,0,0,0,7,0,3,0,0,0,3,10
MANIPUR,2002,Unemployed,0,2,2,6,1,11,0,1,1,0,0,2,13
MANIPUR,2002,Self-employed (Business activity),0,0,0,0,0,0,0,0,0,0,0,0,0
MANIPUR,2002,Professional Activity,0,0,0,0,0,0,0,0,0,0,0,0,0
MANIPUR,2002,Farming/Agriculture Activity,0,0,1,0,2,3,0,0,0,0,0,0,3
MANIPUR,2002,Others (Please Specify),0,0,0,0,0,0,0,0,0,0,0,0,0
MANIPUR,2002,Retired Person,0,0,0,0,0,0,0,0,0,0,0,0,0
MANIPUR,2002,Others (Please Specify),0,0,0,1,0,1,0,0,0,1,0,1,2
MANIPUR,2002,Total,0,9,8,9,4,30,0,7,1,1,0,9,39
MANIPUR,2002,Total Salaried,0,0,5,2,1,8,0,0,0,0,0,0,8
MANIPUR,2002,Total Self-employed,0,0,1,0,2,3,0,0,0,0,0,0,3
MANIPUR,2003,House Wife,0,0,0,0,0,0,0,1,0,0,1,2,2
MANIPUR,2003,Service (Government),0,0,2,2,0,4,0,0,0,0,0,0,4
MANIPUR,2003,Service (Private),0,0,0,0,0,0,0,0,0,0,0,0,0
MANIPUR,2003,Public Sector Undertaking,0,0,0,0,0,0,0,0,0,0,0,0,0
MANIPUR,2003,Student,0,9,0,0,0,9,0,3,0,0,0,3,12
MANIPUR,2003,Unemployed,0,0,0,0,0,0,0,0,0,0,0,0,0
MANIPUR,2003,Self-employed (Business activity),0,0,4,0,0,4,0,0,0,0,0,0,4
MANIPUR,2003,Professional Activity,0,0,0,0,0,0,0,0,0,0,0,0,0
MANIPUR,2003,Farming/Agriculture Activity,0,0,0,1,3,4,0,0,0,0,0,0,4
MANIPUR,2003,Others (Please Specify),0,0,0,0,0,0,0,0,0,0,0,0,0
MANIPUR,2003,Retired Person,0,0,0,0,0,0,0,0,0,0,0,0,0
MANIPUR,2003,Others (Please Specify),0,0,0,0,0,0,0,0,0,0,0,0,0
MANIPUR,2003,Total,0,9,6,3,3,21,0,4,0,0,1,5,26
MANIPUR,2003,Total Salaried,0,0,2,2,0,4,0,0,0,0,0,0,4
MANIPUR,2003,Total Self-employed,0,0,4,1,3,8,0,0,0,0,0,0,8
MANIPUR,2004,House Wife,0,0,0,0,0,0,0,0,1,0,0,1,1
MANIPUR,2004,Service (Government),0,4,7,1,0,12,0,0,0,0,0,0,12
MANIPUR,2004,Service (Private),0,0,1,0,0,1,0,0,0,0,0,0,1
MANIPUR,2004,Public Sector Undertaking,0,0,0,0,0,0,0,0,0,0,0,0,0
MANIPUR,2004,Student,0,4,0,0,0,4,1,5,0,0,0,6,10
MANIPUR,2004,Unemployed,0,5,1,1,0,7,0,0,2,0,0,2,9
MANIPUR,2004,Self-employed (Business activity),0,2,1,0,0,3,0,0,0,0,0,0,3
MANIPUR,2004,Professional Activity,0,0,0,0,0,0,0,0,0,0,0,0,0
MANIPUR,2004,Farming/Agriculture Activity,0,0,1,1,0,2,0,0,0,0,0,0,2
MANIPUR,2004,Others (Please Specify),0,1,0,0,0,1,0,0,0,0,0,0,1
MANIPUR,2004,Retired Person,0,0,0,0,0,0,0,0,0,0,0,0,0
MANIPUR,2004,Others (Please Specify),0,1,1,0,0,2,0,0,0,0,0,0,2
MANIPUR,2004,Total,0,17,12,3,0,32,1,5,3,0,0,9,41
MANIPUR,2004,Total Salaried,0,4,8,1,0,13,0,0,0,0,0,0,13
MANIPUR,2004,Total Self-employed,0,3,2,1,0,6,0,0,0,0,0,0,6
MANIPUR,2005,House Wife,0,0,0,0,0,0,0,0,2,0,0,2,2
MANIPUR,2005,Service (Government),0,1,7,0,0,8,0,0,0,0,0,0,8
MANIPUR,2005,Service (Private),0,0,0,0,0,0,0,0,0,0,0,0,0
MANIPUR,2005,Public Sector Undertaking,0,0,0,0,0,0,0,0,0,0,0,0,0
MANIPUR,2005,Student,0,1,0,0,0,1,0,1,0,0,0,1,2
MANIPUR,2005,Unemployed,0,0,0,0,0,0,0,0,0,0,0,0,0
MANIPUR,2005,Self-employed (Business activity),0,1,2,1,0,4,0,0,0,0,0,0,4
MANIPUR,2005,Professional Activity,0,0,0,0,0,0,0,0,0,0,0,0,0
MANIPUR,2005,Farming/Agriculture Activity,0,0,2,0,0,2,0,0,0,0,0,0,2
MANIPUR,2005,Others (Please Specify),0,1,5,0,0,6,0,0,0,0,0,0,6
MANIPUR,2005,Retired Person,0,0,0,0,0,0,0,0,0,0,0,0,0
MANIPUR,2005,Others (Please Specify),0,1,1,0,0,2,0,1,0,0,0,1,3
MANIPUR,2005,Total,0,5,17,1,0,23,0,2,2,0,0,4,27
MANIPUR,2005,Total Salaried,0,1,7,0,0,8,0,0,0,0,0,0,8
MANIPUR,2005,Total Self-employed,0,2,9,1,0,12,0,0,0,0,0,0,12
MANIPUR,2006,House Wife,0,0,0,0,0,0,0,2,1,0,0,3,3
MANIPUR,2006,Service (Government),0,3,8,2,0,13,0,0,0,0,0,0,13
MANIPUR,2006,Service (Private),0,0,0,0,0,0,0,0,0,0,0,0,0
MANIPUR,2006,Public Sector Undertaking,0,0,0,0,0,0,0,0,0,0,0,0,0
MANIPUR,2006,Student,0,4,0,0,0,4,0,9,0,0,0,9,13
MANIPUR,2006,Unemployed,0,0,2,2,1,5,0,0,0,0,0,0,5
MANIPUR,2006,Self-employed (Business activity),0,0,0,0,0,0,0,0,0,0,0,0,0
MANIPUR,2006,Professional Activity,0,0,0,0,0,0,0,0,0,0,0,0,0
MANIPUR,2006,Farming/Agriculture Activity,0,0,0,0,0,0,0,0,0,0,0,0,0
MANIPUR,2006,Others (Please Specify),0,0,0,1,0,1,0,0,0,0,0,0,1
MANIPUR,2006,Retired Person,0,0,0,0,0,0,0,0,0,0,0,0,0
MANIPUR,2006,Others (Please Specify),0,0,1,0,0,1,0,0,0,0,0,0,1
MANIPUR,2006,Total,0,7,11,5,1,24,0,11,1,0,0,12,36
MANIPUR,2006,Total Salaried,0,3,8,2,0,13,0,0,0,0,0,0,13
MANIPUR,2006,Total Self-employed,0,0,0,1,0,1,0,0,0,0,0,0,1
MANIPUR,2007,House Wife,0,0,0,0,0,0,0,3,5,1,0,9,9
MANIPUR,2007,Service (Government),0,0,8,2,0,10,0,0,0,0,0,0,10
MANIPUR,2007,Service (Private),0,0,0,0,0,0,0,0,0,0,0,0,0
MANIPUR,2007,Public Sector Undertaking,0,0,0,0,0,0,0,0,0,0,0,0,0
MANIPUR,2007,Student,1,4,0,0,0,5,0,1,0,0,0,1,6
MANIPUR,2007,Unemployed,0,2,6,1,0,9,0,0,1,0,0,1,10
MANIPUR,2007,Self-employed (Business activity),0,0,0,0,0,0,0,0,0,0,0,0,0
MANIPUR,2007,Professional Activity,0,0,0,0,0,0,0,0,0,0,0,0,0
MANIPUR,2007,Farming/Agriculture Activity,0,0,0,0,0,0,0,0,0,0,0,0,0
MANIPUR,2007,Others (Please Specify),0,0,2,0,0,2,0,0,0,0,0,0,2
MANIPUR,2007,Retired Person,0,0,0,0,0,0,0,0,0,0,0,0,0
MANIPUR,2007,Others (Please Specify),0,1,1,0,0,2,0,0,0,0,0,0,2
MANIPUR,2007,Total,1,7,17,3,0,28,0,4,6,1,0,11,39
MANIPUR,2007,Total Salaried,0,0,8,2,0,10,0,0,0,0,0,0,10
MANIPUR,2007,Total Self-employed,0,0,2,0,0,2,0,0,0,0,0,0,2
MANIPUR,2008,House Wife,0,0,0,0,0,0,0,3,1,1,0,5,5
MANIPUR,2008,Service (Government),0,3,4,0,0,7,0,0,0,0,0,0,7
MANIPUR,2008,Service (Private),0,0,0,0,0,0,0,0,0,0,0,0,0
MANIPUR,2008,Public Sector Undertaking,0,0,0,0,0,0,0,0,0,0,0,0,0
MANIPUR,2008,Student,0,2,0,0,0,2,1,1,0,0,0,2,4
MANIPUR,2008,Unemployed,0,5,2,0,0,7,0,2,1,0,0,3,10
MANIPUR,2008,Self-employed (Business activity),0,0,0,0,0,0,0,0,0,0,0,0,0
MANIPUR,2008,Professional Activity,0,0,0,0,0,0,0,0,0,0,0,0,0
MANIPUR,2008,Farming/Agriculture Activity,0,0,2,0,0,2,0,0,0,0,0,0,2
MANIPUR,2008,Others (Please Specify),0,1,3,0,0,4,0,1,0,0,0,1,5
MANIPUR,2008,Retired Person,0,0,0,0,0,0,0,0,0,0,0,0,0
MANIPUR,2008,Others (Please Specify),0,0,1,0,0,1,0,0,0,0,0,0,1
MANIPUR,2008,Total,0,11,12,0,0,23,1,7,2,1,0,11,34
MANIPUR,2008,Total Salaried,0,3,4,0,0,7,0,0,0,0,0,0,7
MANIPUR,2008,Total Self-employed,0,1,5,0,0,6,0,1,0,0,0,1,7
MANIPUR,2009,House Wife,0,0,0,0,0,0,0,3,2,0,0,5,5
MANIPUR,2009,Service (Government),0,3,2,1,0,6,0,0,0,0,0,0,6
MANIPUR,2009,Service (Private),0,0,0,0,0,0,0,0,0,0,0,0,0
MANIPUR,2009,Public Sector Undertaking,0,0,0,0,0,0,0,0,0,0,0,0,0
MANIPUR,2009,Student,0,0,0,0,0,0,0,0,0,0,0,0,0
MANIPUR,2009,Unemployed,0,3,4,0,0,7,0,0,1,0,0,1,8
MANIPUR,2009,Self-employed (Business activity),0,0,0,0,0,0,0,0,0,0,0,0,0
MANIPUR,2009,Professional Activity,0,0,0,0,0,0,0,0,0,0,0,0,0
MANIPUR,2009,Farming/Agriculture Activity,0,0,0,0,0,0,0,1,0,0,0,1,1
MANIPUR,2009,Others (Please Specify),0,0,4,0,0,4,0,1,0,0,0,1,5
MANIPUR,2009,Retired Person,0,0,0,0,0,0,0,0,0,0,0,0,0
MANIPUR,2009,Others (Please Specify),0,0,1,0,0,1,0,1,0,0,0,1,2
MANIPUR,2009,Total,0,6,11,1,0,18,0,6,3,0,0,9,27
MANIPUR,2009,Total Salaried,0,3,2,1,0,6,0,0,0,0,0,0,6
MANIPUR,2009,Total Self-employed,0,0,4,0,0,4,0,2,0,0,0,2,6
MANIPUR,2010,House Wife,0,0,0,0,0,0,0,6,1,1,0,8,8
MANIPUR,2010,Service (Government),0,1,3,2,0,6,0,0,0,0,0,0,6
MANIPUR,2010,Service (Private),0,0,0,0,0,0,0,0,0,0,0,0,0
MANIPUR,2010,Public Sector Undertaking,0,0,0,0,0,0,0,0,0,0,0,0,0
MANIPUR,2010,Student,0,1,0,0,0,1,0,0,0,0,0,0,1
MANIPUR,2010,Unemployed,0,4,7,1,0,12,0,0,0,0,0,0,12
MANIPUR,2010,Self-employed (Business activity),0,0,0,0,0,0,0,0,0,0,0,0,0
MANIPUR,2010,Professional Activity,0,0,0,0,0,0,0,0,0,0,0,0,0
MANIPUR,2010,Farming/Agriculture Activity,0,0,0,0,0,0,0,1,3,0,0,4,4
MANIPUR,2010,Others (Please Specify),0,0,0,0,0,0,0,0,0,0,0,0,0
MANIPUR,2010,Retired Person,0,0,0,0,0,0,0,0,0,0,0,0,0
MANIPUR,2010,Others (Please Specify),0,1,3,1,0,5,0,1,0,0,0,1,6
MANIPUR,2010,Total,0,7,13,4,0,24,0,8,4,1,0,13,37
MANIPUR,2010,Total Salaried,0,1,3,2,0,6,0,0,0,0,0,0,6
MANIPUR,2010,Total Self-employed,0,0,0,0,0,0,0,1,3,0,0,4,4
MANIPUR,2011,House Wife,0,0,0,0,0,0,0,6,2,1,0,9,9
MANIPUR,2011,Service (Government),0,0,4,1,0,5,0,0,0,0,0,0,5
MANIPUR,2011,Service (Private),0,0,1,0,0,1,0,0,0,0,0,0,1
MANIPUR,2011,Public Sector Undertaking,0,0,0,0,0,0,0,0,0,0,0,0,0
MANIPUR,2011,Student,0,4,0,0,0,4,0,0,0,0,0,0,4
MANIPUR,2011,Unemployed,0,1,4,1,0,6,0,0,0,0,0,0,6
MANIPUR,2011,Self-employed (Business activity),0,0,0,0,0,0,0,0,0,0,0,0,0
MANIPUR,2011,Professional Activity,0,0,0,0,0,0,0,0,0,0,0,0,0
MANIPUR,2011,Farming/Agriculture Activity,0,0,0,0,0,0,0,0,0,0,0,0,0
MANIPUR,2011,Others (Please Specify),0,0,0,1,0,1,0,1,0,0,0,1,2
MANIPUR,2011,Retired Person,0,0,0,0,0,0,0,0,0,0,0,0,0
MANIPUR,2011,Others (Please Specify),0,1,0,0,0,1,0,5,0,0,0,5,6
MANIPUR,2011,Total,0,6,9,3,0,18,0,12,2,1,0,15,33
MANIPUR,2011,Total Salaried,0,0,5,1,0,6,0,0,0,0,0,0,6
MANIPUR,2011,Total Self-employed,0,0,0,1,0,1,0,1,0,0,0,1,2
MANIPUR,2012,House Wife,0,0,0,0,0,0,0,3,4,1,1,9,9
MANIPUR,2012,Service (Government),0,1,4,0,0,5,0,0,0,0,0,0,5
MANIPUR,2012,Service (Private),0,0,0,0,0,0,0,0,0,0,0,0,0
MANIPUR,2012,Public Sector Undertaking,0,0,0,0,0,0,0,0,0,0,0,0,0
MANIPUR,2012,Student,0,8,0,0,0,8,1,5,0,0,0,6,14
MANIPUR,2012,Unemployed,0,0,0,0,0,0,0,0,0,0,0,0,0
MANIPUR,2012,Self-employed (Business activity),0,0,0,0,0,0,0,0,0,0,0,0,0
MANIPUR,2012,Professional Activity,0,0,0,0,0,0,0,0,0,0,0,0,0
MANIPUR,2012,Farming/Agriculture Activity,0,0,0,0,0,0,0,0,0,0,0,0,0
MANIPUR,2012,Others (Please Specify),0,0,0,0,0,0,0,0,0,0,0,0,0
MANIPUR,2012,Retired Person,0,0,0,0,0,0,0,0,0,0,0,0,0
MANIPUR,2012,Others (Please Specify),0,5,5,0,0,10,0,3,0,0,0,3,13
MANIPUR,2012,Total,0,14,9,0,0,23,1,11,4,1,1,18,41
MANIPUR,2012,Total Salaried,0,1,4,0,0,5,0,0,0,0,0,0,5
MANIPUR,2012,Total Self-employed,0,0,0,0,0,0,0,0,0,0,0,0,0
MEGHALAYA,2001,House Wife,0,0,0,0,0,0,0,3,1,0,0,4,4
MEGHALAYA,2001,Service (Government),0,1,6,0,1,8,0,1,1,0,0,2,10
MEGHALAYA,2001,Service (Private),0,0,2,0,0,2,0,0,0,0,0,0,2
MEGHALAYA,2001,Public Sector Undertaking,0,0,0,0,0,0,0,0,0,0,0,0,0
MEGHALAYA,2001,Student,1,4,2,0,0,7,0,0,0,0,0,0,7
MEGHALAYA,2001,Unemployed,0,7,3,0,2,12,0,2,0,0,0,2,14
MEGHALAYA,2001,Self-employed (Business activity),0,2,2,0,0,4,0,0,0,0,0,0,4
MEGHALAYA,2001,Professional Activity,0,0,1,1,0,2,0,0,0,0,0,0,2
MEGHALAYA,2001,Farming/Agriculture Activity,0,0,2,0,0,2,0,2,0,0,0,2,4
MEGHALAYA,2001,Others (Please Specify),0,8,14,4,0,26,0,3,0,3,1,7,33
MEGHALAYA,2001,Retired Person,0,0,2,0,1,3,0,0,0,0,1,1,4
MEGHALAYA,2001,Others (Please Specify),0,0,2,0,1,3,0,0,0,0,0,0,3
MEGHALAYA,2001,Total,1,22,36,5,5,69,0,11,2,3,2,18,87
MEGHALAYA,2001,Total Salaried,0,1,8,0,1,10,0,1,1,0,0,2,12
MEGHALAYA,2001,Total Self-employed,0,10,19,5,0,34,0,5,0,3,1,9,43
MEGHALAYA,2002,House Wife,0,0,0,0,0,0,0,6,3,2,0,11,11
MEGHALAYA,2002,Service (Government),0,0,4,0,0,4,0,0,0,0,0,0,4
MEGHALAYA,2002,Service (Private),0,1,3,0,0,4,0,0,0,0,0,0,4
MEGHALAYA,2002,Public Sector Undertaking,0,0,0,0,0,0,0,0,0,0,0,0,0
MEGHALAYA,2002,Student,2,0,0,0,0,2,1,0,0,0,0,1,3
MEGHALAYA,2002,Unemployed,0,3,5,2,0,10,0,2,2,0,0,4,14
MEGHALAYA,2002,Self-employed (Business activity),0,1,0,2,0,3,0,0,0,0,0,0,3
MEGHALAYA,2002,Professional Activity,0,0,0,0,0,0,0,0,0,0,0,0,0
MEGHALAYA,2002,Farming/Agriculture Activity,1,2,2,3,0,8,0,0,0,0,0,0,8
MEGHALAYA,2002,Others (Please Specify),0,2,4,3,3,12,0,0,0,0,0,0,12
MEGHALAYA,2002,Retired Person,0,0,0,0,0,0,0,0,0,0,0,0,0
MEGHALAYA,2002,Others (Please Specify),0,0,3,3,0,6,1,0,1,0,0,2,8
MEGHALAYA,2002,Total,3,9,21,13,3,49,2,8,6,2,0,18,67
MEGHALAYA,2002,Total Salaried,0,1,7,0,0,8,0,0,0,0,0,0,8
MEGHALAYA,2002,Total Self-employed,1,5,6,8,3,23,0,0,0,0,0,0,23
MEGHALAYA,2003,House Wife,0,0,0,0,0,0,0,0,0,0,1,1,1
MEGHALAYA,2003,Service (Government),0,1,2,1,0,4,0,0,0,0,0,0,4
MEGHALAYA,2003,Service (Private),0,2,3,1,0,6,0,0,0,0,0,0,6
MEGHALAYA,2003,Public Sector Undertaking,0,0,0,0,0,0,0,0,0,0,0,0,0
MEGHALAYA,2003,Student,2,0,0,0,0,2,1,0,0,0,0,1,3
MEGHALAYA,2003,Unemployed,0,2,4,0,0,6,0,0,0,0,0,0,6
MEGHALAYA,2003,Self-employed (Business activity),0,0,0,0,0,0,0,1,0,0,0,1,1
MEGHALAYA,2003,Professional Activity,0,0,0,0,0,0,0,0,0,0,0,0,0
MEGHALAYA,2003,Farming/Agriculture Activity,0,0,0,3,1,4,0,0,0,0,0,0,4
MEGHALAYA,2003,Others (Please Specify),1,2,5,2,0,10,0,4,2,0,0,6,16
MEGHALAYA,2003,Retired Person,0,0,0,0,0,0,0,0,0,0,0,0,0
MEGHALAYA,2003,Others (Please Specify),0,0,0,0,0,0,0,0,0,0,0,0,0
MEGHALAYA,2003,Total,3,7,14,7,1,32,1,5,2,0,1,9,41
MEGHALAYA,2003,Total Salaried,0,3,5,2,0,10,0,0,0,0,0,0,10
MEGHALAYA,2003,Total Self-employed,1,2,5,5,1,14,0,5,2,0,0,7,21
MEGHALAYA,2004,House Wife,0,0,0,0,0,0,0,5,2,0,0,7,7
MEGHALAYA,2004,Service (Government),0,0,8,2,0,10,0,1,0,0,0,1,11
MEGHALAYA,2004,Service (Private),0,3,3,0,0,6,0,0,0,0,0,0,6
MEGHALAYA,2004,Public Sector Undertaking,0,1,1,0,0,2,0,0,0,0,0,0,2
MEGHALAYA,2004,Student,0,6,0,0,0,6,0,6,0,0,0,6,12
MEGHALAYA,2004,Unemployed,0,1,3,0,0,4,0,2,0,0,0,2,6
MEGHALAYA,2004,Self-employed (Business activity),0,0,0,0,0,0,0,0,0,0,0,0,0
MEGHALAYA,2004,Professional Activity,0,0,0,0,0,0,0,0,0,0,0,0,0
MEGHALAYA,2004,Farming/Agriculture Activity,0,0,3,6,2,11,0,0,0,0,0,0,11
MEGHALAYA,2004,Others (Please Specify),0,0,0,0,0,0,0,0,0,0,0,0,0
MEGHALAYA,2004,Retired Person,0,0,0,0,0,0,0,0,0,0,0,0,0
MEGHALAYA,2004,Others (Please Specify),0,0,0,0,0,0,0,0,0,0,0,0,0
MEGHALAYA,2004,Total,0,11,18,8,2,39,0,14,2,0,0,16,55
MEGHALAYA,2004,Total Salaried,0,4,12,2,0,18,0,1,0,0,0,1,19
MEGHALAYA,2004,Total Self-employed,0,0,3,6,2,11,0,0,0,0,0,0,11
MEGHALAYA,2005,House Wife,0,0,0,0,0,0,0,6,3,2,0,11,11
MEGHALAYA,2005,Service (Government),0,0,1,0,0,1,0,0,0,0,0,0,1
MEGHALAYA,2005,Service (Private),0,0,2,1,0,3,0,0,0,0,0,0,3
MEGHALAYA,2005,Public Sector Undertaking,0,0,0,1,0,1,0,0,0,0,0,0,1
MEGHALAYA,2005,Student,2,4,0,0,0,6,0,5,0,0,0,5,11
MEGHALAYA,2005,Unemployed,1,6,5,2,1,15,0,2,2,0,0,4,19
MEGHALAYA,2005,Self-employed (Business activity),0,2,1,0,0,3,0,0,0,0,0,0,3
MEGHALAYA,2005,Professional Activity,0,0,0,0,0,0,0,0,0,0,0,0,0
MEGHALAYA,2005,Farming/Agriculture Activity,0,1,2,0,1,4,0,0,0,0,0,0,4
MEGHALAYA,2005,Others (Please Specify),0,1,3,5,1,10,0,0,0,0,0,0,10
MEGHALAYA,2005,Retired Person,0,0,0,1,4,5,0,0,0,0,0,0,5
MEGHALAYA,2005,Others (Please Specify),0,2,0,0,0,2,0,0,0,0,1,1,3
MEGHALAYA,2005,Total,3,16,14,10,7,50,0,13,5,2,1,21,71
MEGHALAYA,2005,Total Salaried,0,0,3,2,0,5,0,0,0,0,0,0,5
MEGHALAYA,2005,Total Self-employed,0,4,6,5,2,17,0,0,0,0,0,0,17
MEGHALAYA,2006,House Wife,0,0,0,0,0,0,0,6,5,0,0,11,11
MEGHALAYA,2006,Service (Government),0,3,5,0,0,8,0,0,0,0,0,0,8
MEGHALAYA,2006,Service (Private),0,1,2,2,0,5,0,0,0,0,0,0,5
MEGHALAYA,2006,Public Sector Undertaking,0,0,1,0,0,1,0,0,0,0,0,0,1
MEGHALAYA,2006,Student,1,3,0,0,0,4,1,5,0,0,0,6,10
MEGHALAYA,2006,Unemployed,0,9,1,0,0,10,0,2,0,0,0,2,12
MEGHALAYA,2006,Self-employed (Business activity),0,15,3,0,0,18,0,0,0,0,0,0,18
MEGHALAYA,2006,Professional Activity,0,0,0,0,0,0,0,0,0,0,0,0,0
MEGHALAYA,2006,Farming/Agriculture Activity,0,1,1,1,0,3,0,0,0,0,0,0,3
MEGHALAYA,2006,Others (Please Specify),0,5,5,1,3,14,0,3,0,0,0,3,17
MEGHALAYA,2006,Retired Person,0,0,0,0,0,0,0,0,0,0,0,0,0
MEGHALAYA,2006,Others (Please Specify),0,3,1,1,1,6,0,1,0,0,0,1,7
MEGHALAYA,2006,Total,1,40,19,5,4,69,1,17,5,0,0,23,92
MEGHALAYA,2006,Total Salaried,0,4,8,2,0,14,0,0,0,0,0,0,14
MEGHALAYA,2006,Total Self-employed,0,21,9,2,3,35,0,3,0,0,0,3,38
MEGHALAYA,2007,House Wife,0,0,0,0,0,0,0,2,4,0,0,6,6
MEGHALAYA,2007,Service (Government),0,3,2,1,0,6,0,1,0,0,0,1,7
MEGHALAYA,2007,Service (Private),0,0,0,0,0,0,0,0,0,0,0,0,0
MEGHALAYA,2007,Public Sector Undertaking,0,0,0,1,0,1,0,0,0,0,0,0,1
MEGHALAYA,2007,Student,1,9,0,0,0,10,0,5,2,0,0,7,17
MEGHALAYA,2007,Unemployed,0,3,6,0,1,10,0,2,0,0,0,2,12
MEGHALAYA,2007,Self-employed (Business activity),0,4,4,1,0,9,0,0,0,0,0,0,9
MEGHALAYA,2007,Professional Activity,0,0,0,0,0,0,0,0,0,0,0,0,0
MEGHALAYA,2007,Farming/Agriculture Activity,0,7,4,1,2,14,0,2,2,0,0,4,18
MEGHALAYA,2007,Others (Please Specify),0,0,3,3,0,6,0,0,1,0,0,1,7
MEGHALAYA,2007,Retired Person,0,0,0,0,0,0,0,0,0,0,0,0,0
MEGHALAYA,2007,Others (Please Specify),0,2,2,0,0,4,0,3,3,0,0,6,10
MEGHALAYA,2007,Total,1,28,21,7,3,60,0,15,12,0,0,27,87
MEGHALAYA,2007,Total Salaried,0,3,2,2,0,7,0,1,0,0,0,1,8
MEGHALAYA,2007,Total Self-employed,0,11,11,5,2,29,0,2,3,0,0,5,34
MEGHALAYA,2008,House Wife,0,0,0,0,0,0,0,3,4,2,0,9,9
MEGHALAYA,2008,Service (Government),0,0,5,2,0,7,0,0,1,0,0,1,8
MEGHALAYA,2008,Service (Private),0,0,1,0,0,1,0,0,0,0,0,0,1
MEGHALAYA,2008,Public Sector Undertaking,0,0,0,0,0,0,0,0,0,0,0,0,0
MEGHALAYA,2008,Student,0,4,1,0,0,5,1,3,0,0,0,4,9
MEGHALAYA,2008,Unemployed,0,7,5,4,0,16,0,2,1,0,1,4,20
MEGHALAYA,2008,Self-employed (Business activity),0,0,0,0,0,0,0,0,0,0,0,0,0
MEGHALAYA,2008,Professional Activity,0,0,0,0,0,0,0,1,0,0,0,1,1
MEGHALAYA,2008,Farming/Agriculture Activity,0,4,3,2,0,9,0,0,0,0,0,0,9
MEGHALAYA,2008,Others (Please Specify),0,4,12,2,1,19,0,1,0,0,1,2,21
MEGHALAYA,2008,Retired Person,0,0,0,0,0,0,0,0,0,0,0,0,0
MEGHALAYA,2008,Others (Please Specify),0,0,0,0,0,0,0,1,6,0,0,7,7
MEGHALAYA,2008,Total,0,19,27,10,1,57,1,11,12,2,2,28,85
MEGHALAYA,2008,Total Salaried,0,0,6,2,0,8,0,0,1,0,0,1,9
MEGHALAYA,2008,Total Self-employed,0,8,15,4,1,28,0,2,0,0,1,3,31
MEGHALAYA,2009,House Wife,0,0,0,0,0,0,0,4,2,5,0,11,11
MEGHALAYA,2009,Service (Government),0,0,0,1,0,1,0,0,0,0,0,0,1
MEGHALAYA,2009,Service (Private),0,0,0,1,0,1,0,0,0,0,0,0,1
MEGHALAYA,2009,Public Sector Undertaking,0,0,1,0,1,2,0,0,0,0,0,0,2
MEGHALAYA,2009,Student,1,6,0,0,0,7,0,2,0,0,0,2,9
MEGHALAYA,2009,Unemployed,0,2,4,0,0,6,0,1,0,0,0,1,7
MEGHALAYA,2009,Self-employed (Business activity),0,1,1,1,0,3,0,0,0,0,0,0,3
MEGHALAYA,2009,Professional Activity,0,0,0,0,0,0,0,0,3,0,0,3,3
MEGHALAYA,2009,Farming/Agriculture Activity,0,3,2,10,1,16,0,5,0,0,0,5,21
MEGHALAYA,2009,Others (Please Specify),0,1,1,0,0,2,1,3,0,0,0,4,6
MEGHALAYA,2009,Retired Person,0,0,0,1,1,2,0,0,0,0,0,0,2
MEGHALAYA,2009,Others (Please Specify),0,11,2,13,1,27,0,3,1,12,3,19,46
MEGHALAYA,2009,Total,1,24,11,27,4,67,1,18,6,17,3,45,112
MEGHALAYA,2009,Total Salaried,0,0,1,2,1,4,0,0,0,0,0,0,4
MEGHALAYA,2009,Total Self-employed,0,5,4,11,1,21,1,8,3,0,0,12,33
MEGHALAYA,2010,House Wife,0,0,0,0,0,0,0,7,5,1,1,14,14
MEGHALAYA,2010,Service (Government),0,2,4,2,0,8,0,0,0,0,0,0,8
MEGHALAYA,2010,Service (Private),0,6,1,4,0,11,0,0,0,0,0,0,11
MEGHALAYA,2010,Public Sector Undertaking,0,1,0,0,0,1,0,0,0,0,0,0,1
MEGHALAYA,2010,Student,2,10,2,0,0,14,1,5,1,0,0,7,21
MEGHALAYA,2010,Unemployed,0,5,8,2,0,15,0,1,1,0,0,2,17
MEGHALAYA,2010,Self-employed (Business activity),0,0,0,0,0,0,0,0,0,0,0,0,0
MEGHALAYA,2010,Professional Activity,0,0,1,0,0,1,0,0,0,0,0,0,1
MEGHALAYA,2010,Farming/Agriculture Activity,0,5,5,3,2,15,0,0,0,1,0,1,16
MEGHALAYA,2010,Others (Please Specify),0,2,0,1,2,5,0,1,1,0,0,2,7
MEGHALAYA,2010,Retired Person,0,0,0,0,1,1,0,0,0,0,0,0,1
MEGHALAYA,2010,Others (Please Specify),0,6,2,1,0,9,0,1,1,0,0,2,11
MEGHALAYA,2010,Total,2,37,23,13,5,80,1,15,9,2,1,28,108
MEGHALAYA,2010,Total Salaried,0,9,5,6,0,20,0,0,0,0,0,0,20
MEGHALAYA,2010,Total Self-employed,0,7,6,4,4,21,0,1,1,1,0,3,24
MEGHALAYA,2011,House Wife,0,0,0,0,0,0,0,5,8,2,0,15,15
MEGHALAYA,2011,Service (Government),0,2,3,1,0,6,0,0,0,0,0,0,6
MEGHALAYA,2011,Service (Private),0,6,1,0,0,7,0,0,1,0,0,1,8
MEGHALAYA,2011,Public Sector Undertaking,0,0,1,0,1,2,0,0,0,0,0,0,2
MEGHALAYA,2011,Student,3,25,0,0,0,28,0,9,0,0,0,9,37
MEGHALAYA,2011,Unemployed,0,12,6,0,0,18,0,1,2,0,0,3,21
MEGHALAYA,2011,Self-employed (Business activity),0,3,2,5,0,10,0,0,0,0,0,0,10
MEGHALAYA,2011,Professional Activity,0,4,0,0,0,4,0,0,0,2,0,2,6
MEGHALAYA,2011,Farming/Agriculture Activity,0,6,6,3,1,16,0,4,2,0,0,6,22
MEGHALAYA,2011,Others (Please Specify),0,4,3,3,0,10,0,1,0,1,2,4,14
MEGHALAYA,2011,Retired Person,0,0,0,0,0,0,0,0,0,0,0,0,0
MEGHALAYA,2011,Others (Please Specify),1,5,3,1,0,10,1,1,0,0,0,2,12
MEGHALAYA,2011,Total,4,67,25,13,2,111,1,21,13,5,2,42,153
MEGHALAYA,2011,Total Salaried,0,8,5,1,1,15,0,0,1,0,0,1,16
MEGHALAYA,2011,Total Self-employed,0,17,11,11,1,40,0,5,2,3,2,12,52
MEGHALAYA,2012,House Wife,0,0,0,0,0,0,0,6,6,2,0,14,14
MEGHALAYA,2012,Service (Government),0,2,1,1,0,4,0,0,0,0,0,0,4
MEGHALAYA,2012,Service (Private),1,2,1,1,0,5,0,0,0,0,0,0,5
MEGHALAYA,2012,Public Sector Undertaking,0,0,1,0,0,1,0,0,0,0,0,0,1
MEGHALAYA,2012,Student,2,12,0,0,0,14,1,10,0,0,0,11,25
MEGHALAYA,2012,Unemployed,0,8,5,4,0,17,0,5,1,0,0,6,23
MEGHALAYA,2012,Self-employed (Business activity),0,9,6,3,0,18,0,0,0,0,0,0,18
MEGHALAYA,2012,Professional Activity,0,1,2,0,0,3,0,0,0,0,0,0,3
MEGHALAYA,2012,Farming/Agriculture Activity,0,3,3,3,0,9,0,1,0,0,0,1,10
MEGHALAYA,2012,Others (Please Specify),0,2,8,4,0,14,0,2,0,0,0,2,16
MEGHALAYA,2012,Retired Person,0,0,0,0,0,0,0,0,0,0,0,0,0
MEGHALAYA,2012,Others (Please Specify),0,1,3,0,1,5,1,3,0,0,0,4,9
MEGHALAYA,2012,Total,3,40,30,16,1,90,2,27,7,2,0,38,128
MEGHALAYA,2012,Total Salaried,1,4,3,2,0,10,0,0,0,0,0,0,10
MEGHALAYA,2012,Total Self-employed,0,15,19,10,0,44,0,3,0,0,0,3,47
MIZORAM,2001,House Wife,0,0,0,0,0,0,0,0,0,0,0,0,0
MIZORAM,2001,Service (Government),0,2,1,0,0,3,0,0,0,0,0,0,3
MIZORAM,2001,Service (Private),0,2,0,0,0,2,0,0,0,0,0,0,2
MIZORAM,2001,Public Sector Undertaking,0,0,0,0,0,0,0,0,0,0,0,0,0
MIZORAM,2001,Student,1,11,0,0,0,12,0,1,0,0,0,1,13
MIZORAM,2001,Unemployed,2,2,4,1,0,9,0,2,1,2,0,5,14
MIZORAM,2001,Self-employed (Business activity),0,0,0,0,0,0,0,0,0,0,0,0,0
MIZORAM,2001,Professional Activity,0,0,0,0,0,0,0,0,0,0,0,0,0
MIZORAM,2001,Farming/Agriculture Activity,0,0,0,0,0,0,0,0,0,0,0,0,0
MIZORAM,2001,Others (Please Specify),0,5,0,4,1,10,0,0,1,0,1,2,12
MIZORAM,2001,Retired Person,0,0,0,0,1,1,0,0,0,0,0,0,1
MIZORAM,2001,Others (Please Specify),4,0,5,0,0,9,0,0,0,0,0,0,9
MIZORAM,2001,Total,7,22,10,5,2,46,0,3,2,2,1,8,54
MIZORAM,2001,Total Salaried,0,4,1,0,0,5,0,0,0,0,0,0,5
MIZORAM,2001,Total Self-employed,0,5,0,4,1,10,0,0,1,0,1,2,12
MIZORAM,2002,House Wife,0,0,0,0,0,0,0,2,1,2,0,5,5
MIZORAM,2002,Service (Government),0,3,2,3,0,8,0,0,0,0,0,0,8
MIZORAM,2002,Service (Private),0,0,0,0,0,0,0,0,0,0,0,0,0
MIZORAM,2002,Public Sector Undertaking,0,0,3,1,0,4,0,0,0,0,0,0,4
MIZORAM,2002,Student,0,1,0,0,0,1,0,0,0,0,0,0,1
MIZORAM,2002,Unemployed,0,14,3,2,0,19,0,1,0,0,0,1,20
MIZORAM,2002,Self-employed (Business activity),0,0,0,0,0,0,0,0,0,0,0,0,0
MIZORAM,2002,Professional Activity,0,0,0,0,0,0,0,0,0,0,0,0,0
MIZORAM,2002,Farming/Agriculture Activity,0,0,2,1,0,3,0,0,0,0,0,0,3
MIZORAM,2002,Others (Please Specify),0,6,9,1,2,18,0,2,1,1,0,4,22
MIZORAM,2002,Retired Person,0,0,0,0,0,0,0,0,0,0,0,0,0
MIZORAM,2002,Others (Please Specify),0,3,0,0,0,3,0,0,0,0,0,0,3
MIZORAM,2002,Total,0,27,19,8,2,56,0,5,2,3,0,10,66
MIZORAM,2002,Total Salaried,0,3,5,4,0,12,0,0,0,0,0,0,12
MIZORAM,2002,Total Self-employed,0,6,11,2,2,21,0,2,1,1,0,4,25
MIZORAM,2003,House Wife,0,0,0,0,0,0,0,0,0,0,0,0,0
MIZORAM,2003,Service (Government),0,1,2,1,0,4,0,0,0,0,0,0,4
MIZORAM,2003,Service (Private),0,4,1,0,0,5,0,0,0,0,0,0,5
MIZORAM,2003,Public Sector Undertaking,0,0,0,0,0,0,0,0,0,0,0,0,0
MIZORAM,2003,Student,0,1,0,0,0,1,0,0,0,0,0,0,1
MIZORAM,2003,Unemployed,0,4,5,0,0,9,0,0,0,0,0,0,9
MIZORAM,2003,Self-employed (Business activity),0,1,0,2,0,3,0,0,0,0,0,0,3
MIZORAM,2003,Professional Activity,0,0,0,0,0,0,0,0,0,0,0,0,0
MIZORAM,2003,Farming/Agriculture Activity,0,0,0,0,0,0,0,0,0,0,0,0,0
MIZORAM,2003,Others (Please Specify),1,5,7,2,0,15,0,2,7,1,0,10,25
MIZORAM,2003,Retired Person,0,0,0,0,0,0,0,0,0,0,0,0,0
MIZORAM,2003,Others (Please Specify),0,2,1,1,0,4,0,1,0,0,0,1,5
MIZORAM,2003,Total,1,18,16,6,0,41,0,3,7,1,0,11,52
MIZORAM,2003,Total Salaried,0,5,3,1,0,9,0,0,0,0,0,0,9
MIZORAM,2003,Total Self-employed,1,6,7,4,0,18,0,2,7,1,0,10,28
MIZORAM,2004,House Wife,0,0,0,0,0,0,0,0,0,0,0,0,0
MIZORAM,2004,Service (Government),0,3,1,0,0,4,0,0,0,0,0,0,4
MIZORAM,2004,Service (Private),0,0,0,0,0,0,0,0,0,0,0,0,0
MIZORAM,2004,Public Sector Undertaking,0,0,4,1,0,5,0,0,0,0,0,0,5
MIZORAM,2004,Student,0,1,0,0,0,1,0,0,0,0,0,0,1
MIZORAM,2004,Unemployed,0,11,5,2,0,18,0,3,0,0,0,3,21
MIZORAM,2004,Self-employed (Business activity),0,0,0,0,0,0,0,0,0,0,0,0,0
MIZORAM,2004,Professional Activity,0,0,0,0,0,0,0,0,0,0,0,0,0
MIZORAM,2004,Farming/Agriculture Activity,0,0,1,1,0,2,0,0,0,0,0,0,2
MIZORAM,2004,Others (Please Specify),0,8,6,1,0,15,0,3,0,0,0,3,18
MIZORAM,2004,Retired Person,0,0,0,0,0,0,0,0,0,0,0,0,0
MIZORAM,2004,Others (Please Specify),0,6,0,2,0,8,0,0,1,0,0,1,9
MIZORAM,2004,Total,0,29,17,7,0,53,0,6,1,0,0,7,60
MIZORAM,2004,Total Salaried,0,3,5,1,0,9,0,0,0,0,0,0,9
MIZORAM,2004,Total Self-employed,0,8,7,2,0,17,0,3,0,0,0,3,20
MIZORAM,2005,House Wife,0,0,0,0,0,0,0,0,2,1,0,3,3
MIZORAM,2005,Service (Government),0,1,3,0,0,4,0,0,0,0,0,0,4
MIZORAM,2005,Service (Private),0,0,1,0,0,1,0,0,0,0,0,0,1
MIZORAM,2005,Public Sector Undertaking,0,0,0,0,0,0,0,0,0,0,0,0,0
MIZORAM,2005,Student,0,0,0,0,0,0,0,0,0,0,0,0,0
MIZORAM,2005,Unemployed,0,8,5,0,0,13,0,1,1,0,0,2,15
MIZORAM,2005,Self-employed (Business activity),0,0,0,0,0,0,0,0,0,0,0,0,0
MIZORAM,2005,Professional Activity,0,0,0,0,0,0,0,0,0,0,0,0,0
MIZORAM,2005,Farming/Agriculture Activity,0,0,0,0,0,0,0,0,0,0,0,0,0
MIZORAM,2005,Others (Please Specify),0,0,3,0,0,3,0,0,1,0,0,1,4
MIZORAM,2005,Retired Person,0,0,0,0,0,0,0,0,0,0,0,0,0
MIZORAM,2005,Others (Please Specify),2,10,8,4,2,26,0,2,0,0,0,2,28
MIZORAM,2005,Total,2,19,20,4,2,47,0,3,4,1,0,8,55
MIZORAM,2005,Total Salaried,0,1,4,0,0,5,0,0,0,0,0,0,5
MIZORAM,2005,Total Self-employed,0,0,3,0,0,3,0,0,1,0,0,1,4
MIZORAM,2006,House Wife,0,0,0,0,0,0,0,1,0,3,0,4,4
MIZORAM,2006,Service (Government),0,2,2,1,0,5,0,0,0,0,0,0,5
MIZORAM,2006,Service (Private),0,3,0,0,0,3,0,0,0,0,0,0,3
MIZORAM,2006,Public Sector Undertaking,0,3,0,0,0,3,0,0,0,0,0,0,3
MIZORAM,2006,Student,0,2,2,0,0,4,0,0,0,0,0,0,4
MIZORAM,2006,Unemployed,0,5,0,1,0,6,0,0,0,0,0,0,6
MIZORAM,2006,Self-employed (Business activity),0,0,0,0,0,0,0,0,0,0,0,0,0
MIZORAM,2006,Professional Activity,0,0,0,0,0,0,0,0,0,0,0,0,0
MIZORAM,2006,Farming/Agriculture Activity,0,0,1,0,0,1,0,0,0,0,0,0,1
MIZORAM,2006,Others (Please Specify),0,2,0,1,2,5,0,0,0,0,0,0,5
MIZORAM,2006,Retired Person,0,0,0,0,0,0,0,0,0,0,0,0,0
MIZORAM,2006,Others (Please Specify),0,14,17,0,2,33,0,4,2,0,0,6,39
MIZORAM,2006,Total,0,31,22,3,4,60,0,5,2,3,0,10,70
MIZORAM,2006,Total Salaried,0,8,2,1,0,11,0,0,0,0,0,0,11
MIZORAM,2006,Total Self-employed,0,2,1,1,2,6,0,0,0,0,0,0,6
MIZORAM,2007,House Wife,0,0,0,0,0,0,0,0,1,2,0,3,3
MIZORAM,2007,Service (Government),0,0,0,0,0,0,0,0,0,0,0,0,0
MIZORAM,2007,Service (Private),0,0,0,0,0,0,0,0,0,0,0,0,0
MIZORAM,2007,Public Sector Undertaking,0,0,0,0,0,0,0,0,0,0,0,0,0
MIZORAM,2007,Student,0,0,0,0,0,0,0,0,0,0,0,0,0
MIZORAM,2007,Unemployed,0,0,0,0,0,0,0,0,0,0,0,0,0
MIZORAM,2007,Self-employed (Business activity),0,0,0,0,0,0,0,0,0,0,0,0,0
MIZORAM,2007,Professional Activity,0,0,0,0,0,0,0,0,0,0,0,0,0
MIZORAM,2007,Farming/Agriculture Activity,0,0,0,0,0,0,0,0,0,0,0,0,0
MIZORAM,2007,Others (Please Specify),0,0,0,0,0,0,0,0,0,0,0,0,0
MIZORAM,2007,Retired Person,0,0,0,0,0,0,0,0,0,0,0,0,0
MIZORAM,2007,Others (Please Specify),1,9,8,2,2,22,0,1,2,0,0,3,25
MIZORAM,2007,Total,1,9,8,2,2,22,0,1,3,2,0,6,28
MIZORAM,2007,Total Salaried,0,0,0,0,0,0,0,0,0,0,0,0,0
MIZORAM,2007,Total Self-employed,0,0,0,0,0,0,0,0,0,0,0,0,0
MIZORAM,2008,House Wife,0,0,0,0,0,0,0,0,0,0,0,0,0
MIZORAM,2008,Service (Government),0,0,0,0,0,0,0,0,0,0,0,0,0
MIZORAM,2008,Service (Private),0,0,0,0,0,0,0,0,0,0,0,0,0
MIZORAM,2008,Public Sector Undertaking,0,0,0,0,0,0,0,0,0,0,0,0,0
MIZORAM,2008,Student,0,3,0,0,0,3,0,0,2,0,0,2,5
MIZORAM,2008,Unemployed,0,0,0,0,0,0,0,0,0,0,0,0,0
MIZORAM,2008,Self-employed (Business activity),0,0,3,0,0,3,0,0,0,0,0,0,3
MIZORAM,2008,Professional Activity,0,0,0,0,0,0,0,0,0,0,0,0,0
MIZORAM,2008,Farming/Agriculture Activity,0,0,0,0,0,0,0,0,0,0,0,0,0
MIZORAM,2008,Others (Please Specify),0,0,0,1,0,1,0,0,1,0,0,1,2
MIZORAM,2008,Retired Person,0,0,0,0,0,0,0,0,0,0,0,0,0
MIZORAM,2008,Others (Please Specify),0,9,13,6,0,28,0,2,0,1,0,3,31
MIZORAM,2008,Total,0,12,16,7,0,35,0,2,3,1,0,6,41
MIZORAM,2008,Total Salaried,0,0,0,0,0,0,0,0,0,0,0,0,0
MIZORAM,2008,Total Self-employed,0,0,3,1,0,4,0,0,1,0,0,1,5
MIZORAM,2009,House Wife,0,0,0,0,0,0,0,0,1,0,0,1,1
MIZORAM,2009,Service (Government),0,0,1,0,0,1,0,0,0,0,0,0,1
MIZORAM,2009,Service (Private),0,1,1,0,0,2,0,0,0,0,0,0,2
MIZORAM,2009,Public Sector Undertaking,0,0,0,0,0,0,0,0,0,0,0,0,0
MIZORAM,2009,Student,0,1,0,0,0,1,0,0,0,0,0,0,1
MIZORAM,2009,Unemployed,0,1,5,0,0,6,0,0,0,0,0,0,6
MIZORAM,2009,Self-employed (Business activity),0,0,0,0,0,0,0,0,0,0,0,0,0
MIZORAM,2009,Professional Activity,0,0,0,0,0,0,0,0,0,0,0,0,0
MIZORAM,2009,Farming/Agriculture Activity,1,16,14,1,1,33,0,2,1,2,0,5,38
MIZORAM,2009,Others (Please Specify),0,6,4,2,0,12,0,1,0,0,0,1,13
MIZORAM,2009,Retired Person,0,0,0,1,0,1,0,0,0,0,0,0,1
MIZORAM,2009,Others (Please Specify),0,6,0,0,0,6,0,0,0,0,0,0,6
MIZORAM,2009,Total,1,31,25,4,1,62,0,3,2,2,0,7,69
MIZORAM,2009,Total Salaried,0,1,2,0,0,3,0,0,0,0,0,0,3
MIZORAM,2009,Total Self-employed,1,22,18,3,1,45,0,3,1,2,0,6,51
MIZORAM,2010,House Wife,0,0,0,0,0,0,0,0,0,0,0,0,0
MIZORAM,2010,Service (Government),0,10,10,2,1,23,0,4,0,0,0,4,27
MIZORAM,2010,Service (Private),2,0,0,0,0,2,0,0,1,0,0,1,3
MIZORAM,2010,Public Sector Undertaking,0,0,0,0,0,0,0,0,0,0,0,0,0
MIZORAM,2010,Student,2,0,0,0,0,2,0,0,0,0,0,0,2
MIZORAM,2010,Unemployed,0,10,5,3,1,19,0,2,0,0,0,2,21
MIZORAM,2010,Self-employed (Business activity),0,0,0,0,0,0,0,0,0,0,0,0,0
MIZORAM,2010,Professional Activity,0,0,0,0,0,0,0,0,0,0,0,0,0
MIZORAM,2010,Farming/Agriculture Activity,0,4,0,1,0,5,0,0,0,0,0,0,5
MIZORAM,2010,Others (Please Specify),0,0,0,0,0,0,0,0,0,0,0,0,0
MIZORAM,2010,Retired Person,0,0,0,0,0,0,0,0,0,0,0,0,0
MIZORAM,2010,Others (Please Specify),0,6,10,0,0,16,0,2,0,0,0,2,18
MIZORAM,2010,Total,4,30,25,6,2,67,0,8,1,0,0,9,76
MIZORAM,2010,Total Salaried,2,10,10,2,1,25,0,4,1,0,0,5,30
MIZORAM,2010,Total Self-employed,0,4,0,1,0,5,0,0,0,0,0,0,5
MIZORAM,2011,House Wife,0,0,0,0,0,0,0,0,5,1,0,6,6
MIZORAM,2011,Service (Government),0,0,1,3,0,4,0,0,0,0,0,0,4
MIZORAM,2011,Service (Private),0,0,3,0,0,3,0,0,0,0,0,0,3
MIZORAM,2011,Public Sector Undertaking,0,0,0,0,0,0,0,1,0,0,0,1,1
MIZORAM,2011,Student,2,10,0,0,0,12,0,1,0,0,0,1,13
MIZORAM,2011,Unemployed,0,15,11,0,0,26,0,1,0,0,0,1,27
MIZORAM,2011,Self-employed (Business activity),0,0,0,0,0,0,0,0,0,0,0,0,0
MIZORAM,2011,Professional Activity,0,0,0,0,0,0,0,0,0,0,0,0,0
MIZORAM,2011,Farming/Agriculture Activity,0,3,5,4,1,13,0,0,1,0,0,1,14
MIZORAM,2011,Others (Please Specify),0,6,4,0,0,10,0,2,0,1,0,3,13
MIZORAM,2011,Retired Person,0,0,0,0,1,1,0,0,0,0,0,0,1
MIZORAM,2011,Others (Please Specify),0,3,5,0,0,8,0,0,0,0,0,0,8
MIZORAM,2011,Total,2,37,29,7,2,77,0,5,6,2,0,13,90
MIZORAM,2011,Total Salaried,0,0,4,3,0,7,0,1,0,0,0,1,8
MIZORAM,2011,Total Self-employed,0,9,9,4,1,23,0,2,1,1,0,4,27
MIZORAM,2012,House Wife,0,0,0,0,0,0,0,0,1,0,0,1,1
MIZORAM,2012,Service (Government),0,0,1,1,0,2,0,0,0,0,0,0,2
MIZORAM,2012,Service (Private),3,0,13,0,0,16,0,4,0,0,0,4,20
MIZORAM,2012,Public Sector Undertaking,0,0,0,0,0,0,0,0,0,0,0,0,0
MIZORAM,2012,Student,0,1,5,0,0,6,0,1,0,0,0,1,7
MIZORAM,2012,Unemployed,2,28,17,10,6,63,3,0,0,0,0,3,66
MIZORAM,2012,Self-employed (Business activity),1,22,13,3,0,39,0,0,0,0,0,0,39
MIZORAM,2012,Professional Activity,0,0,0,0,0,0,0,0,0,0,0,0,0
MIZORAM,2012,Farming/Agriculture Activity,0,3,5,1,0,9,0,0,0,1,0,1,10
MIZORAM,2012,Others (Please Specify),0,8,0,0,0,8,0,0,0,2,0,2,10
MIZORAM,2012,Retired Person,0,0,0,0,2,2,0,2,0,0,0,2,4
MIZORAM,2012,Others (Please Specify),1,8,3,0,0,12,0,0,0,1,1,2,14
MIZORAM,2012,Total,7,70,57,15,8,157,3,7,1,4,1,16,173
MIZORAM,2012,Total Salaried,3,0,14,1,0,18,0,4,0,0,0,4,22
MIZORAM,2012,Total Self-employed,1,33,18,4,0,56,0,0,0,3,0,3,59
NAGALAND,2001,House Wife,0,0,0,0,0,0,0,2,4,0,0,6,6
NAGALAND,2001,Service (Government),0,1,3,1,0,5,0,0,1,0,0,1,6
NAGALAND,2001,Service (Private),0,1,3,0,0,4,0,1,0,0,0,1,5
NAGALAND,2001,Public Sector Undertaking,0,0,0,0,0,0,0,0,0,0,0,0,0
NAGALAND,2001,Student,0,0,0,0,0,0,0,0,0,1,0,1,1
NAGALAND,2001,Unemployed,0,5,7,1,0,13,0,4,0,2,0,6,19
NAGALAND,2001,Self-employed (Business activity),0,0,2,0,0,2,0,0,0,0,0,0,2
NAGALAND,2001,Professional Activity,0,0,0,0,0,0,0,0,0,0,0,0,0
NAGALAND,2001,Farming/Agriculture Activity,0,0,0,0,0,0,0,0,0,0,0,0,0
NAGALAND,2001,Others (Please Specify),0,0,0,0,0,0,0,0,0,0,0,0,0
NAGALAND,2001,Retired Person,0,0,0,0,0,0,0,0,0,0,0,0,0
NAGALAND,2001,Others (Please Specify),0,1,0,0,0,1,0,0,0,0,0,0,1
NAGALAND,2001,Total,0,8,15,2,0,25,0,7,5,3,0,15,40
NAGALAND,2001,Total Salaried,0,2,6,1,0,9,0,1,1,0,0,2,11
NAGALAND,2001,Total Self-employed,0,0,2,0,0,2,0,0,0,0,0,0,2
NAGALAND,2002,House Wife,0,0,0,0,0,0,0,2,1,0,0,3,3
NAGALAND,2002,Service (Government),0,2,8,0,0,10,0,0,0,0,0,0,10
NAGALAND,2002,Service (Private),0,0,1,0,0,1,0,0,0,0,0,0,1
NAGALAND,2002,Public Sector Undertaking,0,0,0,0,0,0,0,0,0,0,0,0,0
NAGALAND,2002,Student,1,0,0,0,0,1,1,1,1,0,0,3,4
NAGALAND,2002,Unemployed,0,0,3,0,0,3,0,0,1,0,0,1,4
NAGALAND,2002,Self-employed (Business activity),0,0,1,0,0,1,0,0,0,0,0,0,1
NAGALAND,2002,Professional Activity,0,0,0,0,0,0,0,0,0,0,0,0,0
NAGALAND,2002,Farming/Agriculture Activity,0,0,0,0,0,0,0,0,0,0,0,0,0
NAGALAND,2002,Others (Please Specify),0,0,2,1,0,3,1,0,0,0,0,1,4
NAGALAND,2002,Retired Person,0,0,0,0,0,0,0,0,0,0,0,0,0
NAGALAND,2002,Others (Please Specify),0,0,0,0,0,0,0,0,0,0,0,0,0
NAGALAND,2002,Total,1,2,15,1,0,19,2,3,3,0,0,8,27
NAGALAND,2002,Total Salaried,0,2,9,0,0,11,0,0,0,0,0,0,11
NAGALAND,2002,Total Self-employed,0,0,3,1,0,4,1,0,0,0,0,1,5
NAGALAND,2003,House Wife,0,0,0,0,0,0,0,4,0,0,0,4,4
NAGALAND,2003,Service (Government),0,0,7,0,0,7,0,0,0,0,0,0,7
NAGALAND,2003,Service (Private),0,0,0,0,0,0,0,0,0,0,0,0,0
NAGALAND,2003,Public Sector Undertaking,0,0,0,0,0,0,0,0,0,0,0,0,0
NAGALAND,2003,Student,0,1,0,0,0,1,0,1,0,0,0,1,2
NAGALAND,2003,Unemployed,0,3,1,0,0,4,0,0,0,0,0,0,4
NAGALAND,2003,Self-employed (Business activity),0,0,1,0,0,1,0,0,0,0,0,0,1
NAGALAND,2003,Professional Activity,0,0,0,0,0,0,0,0,0,0,0,0,0
NAGALAND,2003,Farming/Agriculture Activity,0,0,0,0,0,0,0,0,0,0,0,0,0
NAGALAND,2003,Others (Please Specify),0,1,0,0,0,1,0,0,0,0,0,0,1
NAGALAND,2003,Retired Person,0,0,0,0,0,0,0,0,0,0,0,0,0
NAGALAND,2003,Others (Please Specify),0,1,2,0,0,3,0,0,0,0,0,0,3
NAGALAND,2003,Total,0,6,11,0,0,17,0,5,0,0,0,5,22
NAGALAND,2003,Total Salaried,0,0,7,0,0,7,0,0,0,0,0,0,7
NAGALAND,2003,Total Self-employed,0,1,1,0,0,2,0,0,0,0,0,0,2
NAGALAND,2004,House Wife,0,0,0,0,0,0,0,0,0,0,0,0,0
NAGALAND,2004,Service (Government),0,1,5,0,0,6,0,0,0,0,0,0,6
NAGALAND,2004,Service (Private),0,0,0,0,0,0,0,0,0,0,0,0,0
NAGALAND,2004,Public Sector Undertaking,0,2,0,0,0,2,0,0,0,0,0,0,2
NAGALAND,2004,Student,0,1,0,0,0,1,0,0,0,0,0,0,1
NAGALAND,2004,Unemployed,0,2,3,0,0,5,0,0,0,0,0,0,5
NAGALAND,2004,Self-employed (Business activity),0,0,0,0,0,0,0,0,0,0,0,0,0
NAGALAND,2004,Professional Activity,0,0,0,0,0,0,0,0,0,0,0,0,0
NAGALAND,2004,Farming/Agriculture Activity,0,0,0,0,0,0,0,0,0,0,0,0,0
NAGALAND,2004,Others (Please Specify),0,4,5,2,0,11,0,4,2,0,0,6,17
NAGALAND,2004,Retired Person,0,0,0,0,0,0,0,0,0,0,0,0,0
NAGALAND,2004,Others (Please Specify),0,0,0,0,0,0,0,0,0,0,0,0,0
NAGALAND,2004,Total,0,10,13,2,0,25,0,4,2,0,0,6,31
NAGALAND,2004,Total Salaried,0,3,5,0,0,8,0,0,0,0,0,0,8
NAGALAND,2004,Total Self-employed,0,4,5,2,0,11,0,4,2,0,0,6,17
NAGALAND,2005,House Wife,0,0,0,0,0,0,0,0,1,0,0,1,1
NAGALAND,2005,Service (Government),0,0,7,2,0,9,0,0,1,0,0,1,10
NAGALAND,2005,Service (Private),0,0,0,0,0,0,0,0,0,0,0,0,0
NAGALAND,2005,Public Sector Undertaking,0,0,0,0,0,0,0,0,0,0,0,0,0
NAGALAND,2005,Student,0,3,0,0,0,3,0,2,0,0,0,2,5
NAGALAND,2005,Unemployed,0,0,1,0,0,1,0,0,0,0,0,0,1
NAGALAND,2005,Self-employed (Business activity),0,0,1,0,0,1,0,0,0,0,0,0,1
NAGALAND,2005,Professional Activity,0,0,1,0,0,1,0,0,0,0,0,0,1
NAGALAND,2005,Farming/Agriculture Activity,0,0,0,0,0,0,0,0,0,0,0,0,0
NAGALAND,2005,Others (Please Specify),0,1,3,2,0,6,0,1,1,0,0,2,8
NAGALAND,2005,Retired Person,0,0,0,0,0,0,0,0,0,0,0,0,0
NAGALAND,2005,Others (Please Specify),0,0,0,0,0,0,0,0,0,0,0,0,0
NAGALAND,2005,Total,0,4,13,4,0,21,0,3,3,0,0,6,27
NAGALAND,2005,Total Salaried,0,0,7,2,0,9,0,0,1,0,0,1,10
NAGALAND,2005,Total Self-employed,0,1,5,2,0,8,0,1,1,0,0,2,10
NAGALAND,2006,House Wife,0,0,0,0,0,0,0,0,4,1,0,5,5
NAGALAND,2006,Service (Government),0,3,2,0,0,5,0,0,0,0,0,0,5
NAGALAND,2006,Service (Private),0,0,0,0,0,0,0,0,0,0,0,0,0
NAGALAND,2006,Public Sector Undertaking,0,0,0,0,0,0,0,0,0,0,0,0,0
NAGALAND,2006,Student,0,1,1,0,0,2,0,0,0,0,0,0,2
NAGALAND,2006,Unemployed,1,4,2,0,0,7,0,0,0,0,0,0,7
NAGALAND,2006,Self-employed (Business activity),0,0,0,1,0,1,0,0,0,0,0,0,1
NAGALAND,2006,Professional Activity,0,0,0,0,0,0,0,0,0,0,0,0,0
NAGALAND,2006,Farming/Agriculture Activity,0,0,0,1,0,1,0,1,0,0,0,1,2
NAGALAND,2006,Others (Please Specify),0,1,1,1,0,3,0,2,0,0,0,2,5
NAGALAND,2006,Retired Person,0,0,0,0,0,0,0,0,0,0,0,0,0
NAGALAND,2006,Others (Please Specify),0,0,0,0,0,0,0,1,0,0,0,1,1
NAGALAND,2006,Total,1,9,6,3,0,19,0,4,4,1,0,9,28
NAGALAND,2006,Total Salaried,0,3,2,0,0,5,0,0,0,0,0,0,5
NAGALAND,2006,Total Self-employed,0,1,1,3,0,5,0,3,0,0,0,3,8
NAGALAND,2007,House Wife,0,0,0,0,0,0,0,1,4,0,0,5,5
NAGALAND,2007,Service (Government),0,1,0,4,0,5,0,0,0,0,0,0,5
NAGALAND,2007,Service (Private),0,0,0,0,0,0,0,0,0,0,0,0,0
NAGALAND,2007,Public Sector Undertaking,0,0,0,0,0,0,0,0,0,0,0,0,0
NAGALAND,2007,Student,0,0,0,0,0,0,0,0,0,0,0,0,0
NAGALAND,2007,Unemployed,0,0,2,0,0,2,0,0,0,0,0,0,2
NAGALAND,2007,Self-employed (Business activity),0,0,0,0,0,0,0,0,0,0,0,0,0
NAGALAND,2007,Professional Activity,0,0,0,0,0,0,0,0,0,0,0,0,0
NAGALAND,2007,Farming/Agriculture Activity,0,0,0,0,0,0,0,0,0,0,0,0,0
NAGALAND,2007,Others (Please Specify),0,1,3,0,0,4,0,1,0,0,0,1,5
NAGALAND,2007,Retired Person,0,0,0,0,0,0,0,0,0,0,0,0,0
NAGALAND,2007,Others (Please Specify),0,2,3,1,0,6,0,1,0,0,0,1,7
NAGALAND,2007,Total,0,4,8,5,0,17,0,3,4,0,0,7,24
NAGALAND,2007,Total Salaried,0,1,0,4,0,5,0,0,0,0,0,0,5
NAGALAND,2007,Total Self-employed,0,1,3,0,0,4,0,1,0,0,0,1,5
NAGALAND,2008,House Wife,0,0,0,0,0,0,0,4,0,0,0,4,4
NAGALAND,2008,Service (Government),0,0,4,0,0,4,0,1,0,0,0,1,5
NAGALAND,2008,Service (Private),0,0,0,0,0,0,0,0,0,0,0,0,0
NAGALAND,2008,Public Sector Undertaking,0,0,0,0,0,0,0,0,0,0,0,0,0
NAGALAND,2008,Student,0,0,0,0,0,0,0,3,0,0,0,3,3
NAGALAND,2008,Unemployed,0,0,0,0,0,0,0,0,0,0,0,0,0
NAGALAND,2008,Self-employed (Business activity),0,0,0,0,0,0,0,0,0,0,0,0,0
NAGALAND,2008,Professional Activity,0,0,0,0,0,0,0,0,0,0,0,0,0
NAGALAND,2008,Farming/Agriculture Activity,0,0,0,2,0,2,0,0,0,0,0,0,2
NAGALAND,2008,Others (Please Specify),0,2,6,2,0,10,0,0,0,0,0,0,10
NAGALAND,2008,Retired Person,0,0,0,0,0,0,0,0,0,0,0,0,0
NAGALAND,2008,Others (Please Specify),0,0,10,6,0,16,0,0,2,0,0,2,18
NAGALAND,2008,Total,0,2,20,10,0,32,0,8,2,0,0,10,42
NAGALAND,2008,Total Salaried,0,0,4,0,0,4,0,1,0,0,0,1,5
NAGALAND,2008,Total Self-employed,0,2,6,4,0,12,0,0,0,0,0,0,12
NAGALAND,2009,House Wife,0,0,0,0,0,0,0,1,1,0,0,2,2
NAGALAND,2009,Service (Government),0,1,2,2,0,5,0,0,0,0,0,0,5
NAGALAND,2009,Service (Private),0,0,0,0,0,0,0,0,0,0,0,0,0
NAGALAND,2009,Public Sector Undertaking,0,0,0,0,0,0,0,0,0,0,0,0,0
NAGALAND,2009,Student,0,2,0,0,0,2,0,0,0,0,0,0,2
NAGALAND,2009,Unemployed,0,0,0,0,0,0,0,0,0,0,0,0,0
NAGALAND,2009,Self-employed (Business activity),0,0,1,0,0,1,0,0,0,0,0,0,1
NAGALAND,2009,Professional Activity,0,0,0,0,0,0,0,0,0,0,0,0,0
NAGALAND,2009,Farming/Agriculture Activity,0,0,0,0,0,0,0,1,0,0,0,1,1
NAGALAND,2009,Others (Please Specify),0,8,3,1,0,12,0,1,1,0,0,2,14
NAGALAND,2009,Retired Person,0,0,0,0,0,0,0,0,0,0,0,0,0
NAGALAND,2009,Others (Please Specify),2,1,1,1,0,5,0,1,0,0,0,1,6
NAGALAND,2009,Total,2,12,7,4,0,25,0,4,2,0,0,6,31
NAGALAND,2009,Total Salaried,0,1,2,2,0,5,0,0,0,0,0,0,5
NAGALAND,2009,Total Self-employed,0,8,4,1,0,13,0,2,1,0,0,3,16
NAGALAND,2010,House Wife,0,0,0,0,0,0,0,1,0,0,0,1,1
NAGALAND,2010,Service (Government),0,1,0,1,0,2,0,0,0,0,0,0,2
NAGALAND,2010,Service (Private),0,0,0,0,0,0,0,0,0,0,0,0,0
NAGALAND,2010,Public Sector Undertaking,0,0,0,0,0,0,0,0,0,0,0,0,0
NAGALAND,2010,Student,0,0,2,0,0,2,0,0,0,0,0,0,2
NAGALAND,2010,Unemployed,0,2,2,0,0,4,0,0,0,0,0,0,4
NAGALAND,2010,Self-employed (Business activity),0,0,0,0,0,0,0,0,0,0,0,0,0
NAGALAND,2010,Professional Activity,0,1,2,0,0,3,0,0,0,0,0,0,3
NAGALAND,2010,Farming/Agriculture Activity,0,0,0,0,0,0,0,0,0,0,0,0,0
NAGALAND,2010,Others (Please Specify),0,0,0,0,0,0,0,0,0,0,0,0,0
NAGALAND,2010,Retired Person,0,0,0,0,0,0,0,0,0,0,0,0,0
NAGALAND,2010,Others (Please Specify),0,0,0,0,0,0,0,0,0,0,0,0,0
NAGALAND,2010,Total,0,4,6,1,0,11,0,1,0,0,0,1,12
NAGALAND,2010,Total Salaried,0,1,0,1,0,2,0,0,0,0,0,0,2
NAGALAND,2010,Total Self-employed,0,1,2,0,0,3,0,0,0,0,0,0,3
NAGALAND,2011,House Wife,0,0,0,0,0,0,0,2,2,0,0,4,4
NAGALAND,2011,Service (Government),0,1,6,0,0,7,0,0,0,0,0,0,7
NAGALAND,2011,Service (Private),0,0,0,0,0,0,0,0,0,0,0,0,0
NAGALAND,2011,Public Sector Undertaking,0,0,0,0,0,0,0,0,0,0,0,0,0
NAGALAND,2011,Student,0,0,0,0,0,0,0,2,0,0,0,2,2
NAGALAND,2011,Unemployed,0,0,1,0,0,1,0,0,0,0,0,0,1
NAGALAND,2011,Self-employed (Business activity),0,0,1,0,0,1,0,0,0,0,0,0,1
NAGALAND,2011,Professional Activity,0,1,3,5,0,9,0,0,0,0,0,0,9
NAGALAND,2011,Farming/Agriculture Activity,0,1,0,1,0,2,0,0,0,0,0,0,2
NAGALAND,2011,Others (Please Specify),0,3,0,2,0,5,0,2,0,0,0,2,7
NAGALAND,2011,Retired Person,0,0,0,0,0,0,0,0,0,0,0,0,0
NAGALAND,2011,Others (Please Specify),0,0,0,0,0,0,0,0,0,0,0,0,0
NAGALAND,2011,Total,0,6,11,8,0,25,0,6,2,0,0,8,33
NAGALAND,2011,Total Salaried,0,1,6,0,0,7,0,0,0,0,0,0,7
NAGALAND,2011,Total Self-employed,0,5,4,8,0,17,0,2,0,0,0,2,19
NAGALAND,2012,House Wife,0,0,0,0,0,0,0,2,1,0,0,3,3
NAGALAND,2012,Service (Government),0,3,2,1,0,6,0,0,0,0,0,0,6
NAGALAND,2012,Service (Private),0,0,0,0,0,0,0,0,0,0,0,0,0
NAGALAND,2012,Public Sector Undertaking,0,0,0,0,0,0,0,0,0,0,0,0,0
NAGALAND,2012,Student,0,2,0,0,0,2,1,1,0,0,0,2,4
NAGALAND,2012,Unemployed,0,0,1,0,0,1,0,0,0,0,0,0,1
NAGALAND,2012,Self-employed (Business activity),0,1,1,1,0,3,0,0,0,0,0,0,3
NAGALAND,2012,Professional Activity,0,0,2,1,0,3,0,0,0,0,0,0,3
NAGALAND,2012,Farming/Agriculture Activity,0,4,2,2,0,8,0,1,0,0,0,1,9
NAGALAND,2012,Others (Please Specify),0,1,0,0,0,1,0,0,0,0,0,0,1
NAGALAND,2012,Retired Person,0,0,0,0,0,0,0,0,0,0,0,0,0
NAGALAND,2012,Others (Please Specify),0,0,0,0,0,0,0,0,0,0,0,0,0
NAGALAND,2012,Total,0,11,8,5,0,24,1,4,1,0,0,6,30
NAGALAND,2012,Total Salaried,0,3,2,1,0,6,0,0,0,0,0,0,6
NAGALAND,2012,Total Self-employed,0,6,5,4,0,15,0,1,0,0,0,1,16
ODISHA,2001,House Wife,0,0,0,0,0,0,2,347,330,135,26,840,840
ODISHA,2001,Service (Government),0,23,25,8,0,56,0,13,6,1,0,20,76
ODISHA,2001,Service (Private),0,58,52,32,8,150,0,49,27,7,0,83,233
ODISHA,2001,Public Sector Undertaking,0,16,20,5,0,41,0,13,17,2,2,34,75
ODISHA,2001,Student,24,111,9,0,0,144,27,94,0,1,2,124,268
ODISHA,2001,Unemployed,0,87,100,26,7,220,0,67,33,1,0,101,321
ODISHA,2001,Self-employed (Business activity),0,71,111,104,9,295,0,36,46,20,2,104,399
ODISHA,2001,Professional Activity,0,10,13,6,2,31,0,4,0,0,2,6,37
ODISHA,2001,Farming/Agriculture Activity,0,56,87,47,17,207,0,22,18,8,1,49,256
ODISHA,2001,Others (Please Specify),6,120,182,169,65,542,16,157,144,63,36,416,958
ODISHA,2001,Retired Person,0,2,0,13,11,26,0,0,0,0,2,2,28
ODISHA,2001,Others (Please Specify),6,154,110,82,25,377,17,79,58,22,8,184,561
ODISHA,2001,Total,36,708,709,492,144,2089,62,881,679,260,81,1963,4052
ODISHA,2001,Total Salaried,0,97,97,45,8,247,0,75,50,10,2,137,384
ODISHA,2001,Total Self-employed,6,257,393,326,93,1075,16,219,208,91,41,575,1650
ODISHA,2002,House Wife,0,0,0,0,0,0,0,328,274,125,43,770,770
ODISHA,2002,Service (Government),0,13,14,20,0,47,0,18,22,10,1,51,98
ODISHA,2002,Service (Private),6,105,123,93,16,343,0,24,19,8,0,51,394
ODISHA,2002,Public Sector Undertaking,0,21,44,55,4,124,0,10,16,14,0,40,164
ODISHA,2002,Student,19,112,20,8,0,159,27,90,2,1,0,120,279
ODISHA,2002,Unemployed,2,135,151,59,5,352,1,73,76,8,1,159,511
ODISHA,2002,Self-employed (Business activity),0,35,76,58,4,173,0,5,5,1,0,11,184
ODISHA,2002,Professional Activity,0,11,20,21,4,56,0,3,1,0,0,4,60
ODISHA,2002,Farming/Agriculture Activity,0,79,123,69,38,309,0,9,14,10,3,36,345
ODISHA,2002,Others (Please Specify),18,244,232,158,66,718,29,168,83,73,19,372,1090
ODISHA,2002,Retired Person,0,0,0,3,11,14,0,0,4,2,0,6,20
ODISHA,2002,Others (Please Specify),10,97,142,70,17,336,12,55,50,14,6,137,473
ODISHA,2002,Total,55,852,945,614,165,2631,69,783,566,266,73,1757,4388
ODISHA,2002,Total Salaried,6,139,181,168,20,514,0,52,57,32,1,142,656
ODISHA,2002,Total Self-employed,18,369,451,306,112,1256,29,185,103,84,22,423,1679
ODISHA,2003,House Wife,0,0,0,0,0,0,0,306,205,110,26,647,647
ODISHA,2003,Service (Government),1,20,17,24,0,62,0,43,36,12,0,91,153
ODISHA,2003,Service (Private),5,149,102,107,14,377,0,30,30,21,3,84,461
ODISHA,2003,Public Sector Undertaking,0,21,29,56,0,106,0,10,4,0,0,14,120
ODISHA,2003,Student,16,101,17,13,0,147,22,86,3,1,0,112,259
ODISHA,2003,Unemployed,0,145,116,33,3,297,2,75,47,8,0,132,429
ODISHA,2003,Self-employed (Business activity),0,65,69,48,2,184,1,15,8,6,0,30,214
ODISHA,2003,Professional Activity,0,26,17,12,0,55,0,6,9,7,0,22,77
ODISHA,2003,Farming/Agriculture Activity,1,101,136,69,17,324,0,21,10,10,0,41,365
ODISHA,2003,Others (Please Specify),16,204,270,214,70,774,6,128,76,62,27,299,1073
ODISHA,2003,Retired Person,0,3,1,0,37,41,0,0,4,4,1,9,50
ODISHA,2003,Others (Please Specify),28,91,135,85,34,373,15,82,51,40,11,199,572
ODISHA,2003,Total,67,926,909,661,177,2740,46,802,483,281,68,1680,4420
ODISHA,2003,Total Salaried,6,190,148,187,14,545,0,83,70,33,3,189,734
ODISHA,2003,Total Self-employed,17,396,492,343,89,1337,7,170,103,85,27,392,1729
ODISHA,2004,House Wife,0,0,0,0,0,0,0,291,214,103,12,620,620
ODISHA,2004,Service (Government),0,9,16,10,0,35,0,1,3,2,0,6,41
ODISHA,2004,Service (Private),0,30,75,52,5,162,0,25,20,4,10,59,221
ODISHA,2004,Public Sector Undertaking,0,22,24,24,0,70,0,9,9,3,0,21,91
ODISHA,2004,Student,36,91,18,0,0,145,28,87,6,0,0,121,266
ODISHA,2004,Unemployed,8,99,102,37,1,247,13,46,29,15,1,104,351
ODISHA,2004,Self-employed (Business activity),0,61,124,56,10,251,0,8,10,2,0,20,271
ODISHA,2004,Professional Activity,0,10,27,20,4,61,0,0,7,0,4,11,72
ODISHA,2004,Farming/Agriculture Activity,0,88,109,75,27,299,1,34,33,10,2,80,379
ODISHA,2004,Others (Please Specify),22,239,270,260,100,891,26,228,110,54,32,450,1341
ODISHA,2004,Retired Person,0,0,0,1,29,30,0,0,0,7,0,7,37
ODISHA,2004,Others (Please Specify),18,98,139,81,17,353,11,56,55,27,23,172,525
ODISHA,2004,Total,84,747,904,616,193,2544,79,785,496,227,84,1671,4215
ODISHA,2004,Total Salaried,0,61,115,86,5,267,0,35,32,9,10,86,353
ODISHA,2004,Total Self-employed,22,398,530,411,141,1502,27,270,160,66,38,561,2063
ODISHA,2005,House Wife,0,0,0,0,0,0,0,247,237,89,14,587,587
ODISHA,2005,Service (Government),0,16,26,12,0,54,0,7,18,1,0,26,80
ODISHA,2005,Service (Private),0,31,25,31,1,88,0,33,32,20,3,88,176
ODISHA,2005,Public Sector Undertaking,0,29,34,25,1,89,0,7,8,8,0,23,112
ODISHA,2005,Student,28,111,10,0,0,149,26,85,2,0,0,113,262
ODISHA,2005,Unemployed,0,101,136,35,6,278,2,44,49,9,6,110,388
ODISHA,2005,Self-employed (Business activity),0,59,167,73,21,320,0,20,9,11,2,42,362
ODISHA,2005,Professional Activity,0,19,27,32,2,80,0,8,8,7,2,25,105
ODISHA,2005,Farming/Agriculture Activity,0,38,86,61,19,204,0,13,22,15,0,50,254
ODISHA,2005,Others (Please Specify),26,182,283,247,154,892,13,140,107,69,35,364,1256
ODISHA,2005,Retired Person,0,0,0,0,10,10,0,0,0,0,2,2,12
ODISHA,2005,Others (Please Specify),4,140,125,102,19,390,19,82,80,34,9,224,614
ODISHA,2005,Total,58,726,919,618,233,2554,60,686,572,263,73,1654,4208
ODISHA,2005,Total Salaried,0,76,85,68,2,231,0,47,58,29,3,137,368
ODISHA,2005,Total Self-employed,26,298,563,413,196,1496,13,181,146,102,39,481,1977
ODISHA,2006,House Wife,0,0,0,0,0,0,0,254,191,64,22,531,531
ODISHA,2006,Service (Government),0,6,8,4,0,18,0,4,1,0,0,5,23
ODISHA,2006,Service (Private),0,45,51,30,7,133,0,37,32,23,0,92,225
ODISHA,2006,Public Sector Undertaking,0,8,16,8,0,32,0,8,9,0,0,17,49
ODISHA,2006,Student,18,80,14,0,0,112,29,98,32,0,0,159,271
ODISHA,2006,Unemployed,0,128,136,32,11,307,0,57,33,10,0,100,407
ODISHA,2006,Self-employed (Business activity),0,58,118,66,16,258,1,13,10,10,0,34,292
ODISHA,2006,Professional Activity,2,23,29,26,3,83,1,12,2,2,0,17,100
ODISHA,2006,Farming/Agriculture Activity,2,76,79,53,31,241,0,7,12,15,8,42,283
ODISHA,2006,Others (Please Specify),11,202,270,184,85,752,19,147,156,84,29,435,1187
ODISHA,2006,Retired Person,0,0,0,2,16,18,0,0,0,0,1,1,19
ODISHA,2006,Others (Please Specify),10,115,149,88,57,419,9,110,87,39,14,259,678
ODISHA,2006,Total,43,741,870,493,226,2373,59,747,565,247,74,1692,4065
ODISHA,2006,Total Salaried,0,59,75,42,7,183,0,49,42,23,0,114,297
ODISHA,2006,Total Self-employed,15,359,496,329,135,1334,21,179,180,111,37,528,1862
ODISHA,2007,House Wife,0,0,0,0,0,0,0,322,212,66,14,614,614
ODISHA,2007,Service (Government),0,6,8,12,0,26,0,1,5,0,0,6,32
ODISHA,2007,Service (Private),0,82,82,48,2,214,0,26,31,29,3,89,303
ODISHA,2007,Public Sector Undertaking,0,34,48,26,4,112,0,17,3,8,0,28,140
ODISHA,2007,Student,26,109,0,0,0,135,24,75,0,0,0,99,234
ODISHA,2007,Unemployed,12,98,62,40,12,224,5,93,73,5,1,177,401
ODISHA,2007,Self-employed (Business activity),0,75,161,77,23,336,0,6,4,2,0,12,348
ODISHA,2007,Professional Activity,0,29,29,21,3,82,0,6,16,3,0,25,107
ODISHA,2007,Farming/Agriculture Activity,2,42,61,48,17,170,3,17,21,16,13,70,240
ODISHA,2007,Others (Please Specify),26,209,226,142,81,684,30,201,97,46,18,392,1076
ODISHA,2007,Retired Person,0,0,0,6,25,31,0,0,0,0,5,5,36
ODISHA,2007,Others (Please Specify),11,92,171,121,79,474,8,114,94,68,19,303,777
ODISHA,2007,Total,77,776,848,541,246,2488,70,878,556,243,73,1820,4308
ODISHA,2007,Total Salaried,0,122,138,86,6,352,0,44,39,37,3,123,475
ODISHA,2007,Total Self-employed,28,355,477,288,124,1272,33,230,138,67,31,499,1771
ODISHA,2008,House Wife,0,0,0,0,0,0,0,250,259,113,57,679,679
ODISHA,2008,Service (Government),0,0,2,7,0,9,0,9,2,2,0,13,22
ODISHA,2008,Service (Private),2,77,117,68,8,272,3,43,35,4,2,87,359
ODISHA,2008,Public Sector Undertaking,0,53,42,11,2,108,0,19,9,0,0,28,136
ODISHA,2008,Student,27,95,9,0,0,131,23,60,3,0,0,86,217
ODISHA,2008,Unemployed,26,201,124,91,8,450,3,71,28,8,0,110,560
ODISHA,2008,Self-employed (Business activity),0,50,121,77,27,275,0,7,2,4,0,13,288
ODISHA,2008,Professional Activity,1,19,84,19,8,131,0,8,6,2,2,18,149
ODISHA,2008,Farming/Agriculture Activity,7,77,101,41,19,245,0,1,10,3,1,15,260
ODISHA,2008,Others (Please Specify),23,367,231,246,114,981,9,134,125,63,29,360,1341
ODISHA,2008,Retired Person,0,0,0,13,23,36,0,0,0,1,6,7,43
ODISHA,2008,Others (Please Specify),28,105,190,140,54,517,17,118,117,59,22,333,850
ODISHA,2008,Total,114,1044,1021,713,263,3155,55,720,596,259,119,1749,4904
ODISHA,2008,Total Salaried,2,130,161,86,10,389,3,71,46,6,2,128,517
ODISHA,2008,Total Self-employed,31,513,537,383,168,1632,9,150,143,72,32,406,2038
ODISHA,2009,House Wife,0,0,0,0,0,0,0,254,261,92,20,627,627
ODISHA,2009,Service (Government),0,9,6,17,1,33,0,8,2,1,0,11,44
ODISHA,2009,Service (Private),0,83,93,45,17,238,0,53,35,13,0,101,339
ODISHA,2009,Public Sector Undertaking,0,52,39,17,11,119,0,12,27,17,0,56,175
ODISHA,2009,Student,20,140,1,0,0,161,26,105,1,0,0,132,293
ODISHA,2009,Unemployed,16,133,139,75,11,374,10,66,19,17,2,114,488
ODISHA,2009,Self-employed (Business activity),0,71,112,59,13,255,0,2,13,4,0,19,274
ODISHA,2009,Professional Activity,0,11,17,9,0,37,0,5,3,0,3,11,48
ODISHA,2009,Farming/Agriculture Activity,0,35,56,40,12,143,0,6,1,4,0,11,154
ODISHA,2009,Others (Please Specify),20,229,288,180,70,787,18,205,187,101,40,551,1338
ODISHA,2009,Retired Person,0,0,0,17,28,45,0,0,0,0,12,12,57
ODISHA,2009,Others (Please Specify),13,83,163,69,47,375,13,67,48,16,9,153,528
ODISHA,2009,Total,69,846,914,528,210,2567,67,783,597,265,86,1798,4365
ODISHA,2009,Total Salaried,0,144,138,79,29,390,0,73,64,31,0,168,558
ODISHA,2009,Total Self-employed,20,346,473,288,95,1222,18,218,204,109,43,592,1814
ODISHA,2010,House Wife,0,0,0,0,0,0,1,362,232,111,24,730,730
ODISHA,2010,Service (Government),0,2,7,2,0,11,0,2,1,1,0,4,15
ODISHA,2010,Service (Private),0,74,114,70,11,269,0,30,25,4,4,63,332
ODISHA,2010,Public Sector Undertaking,0,57,39,14,0,110,0,13,16,6,0,35,145
ODISHA,2010,Student,30,138,5,0,0,173,22,104,2,0,0,128,301
ODISHA,2010,Unemployed,11,142,103,36,2,294,7,47,25,7,4,90,384
ODISHA,2010,Self-employed (Business activity),0,52,115,70,7,244,0,3,14,2,0,19,263
ODISHA,2010,Professional Activity,0,15,34,15,10,74,0,2,3,2,2,9,83
ODISHA,2010,Farming/Agriculture Activity,0,17,77,36,15,145,0,0,12,5,0,17,162
ODISHA,2010,Others (Please Specify),41,211,244,212,54,762,39,186,154,99,24,502,1264
ODISHA,2010,Retired Person,0,0,0,1,23,24,0,0,0,1,2,3,27
ODISHA,2010,Others (Please Specify),17,89,104,77,37,324,8,104,70,36,7,225,549
ODISHA,2010,Total,99,797,842,533,159,2430,77,853,554,274,67,1825,4255
ODISHA,2010,Total Salaried,0,133,160,86,11,390,0,45,42,11,4,102,492
ODISHA,2010,Total Self-employed,41,295,470,333,86,1225,39,191,183,108,26,547,1772
ODISHA,2011,House Wife,0,0,0,0,0,0,0,352,314,132,31,829,829
ODISHA,2011,Service (Government),0,5,13,16,0,34,0,2,3,3,0,8,42
ODISHA,2011,Service (Private),4,96,154,69,11,334,0,37,41,14,3,95,429
ODISHA,2011,Public Sector Undertaking,0,54,65,23,1,143,0,15,13,5,0,33,176
ODISHA,2011,Student,36,163,9,0,0,208,37,117,6,0,0,160,368
ODISHA,2011,Unemployed,32,149,149,49,2,381,11,65,48,19,6,149,530
ODISHA,2011,Self-employed (Business activity),1,56,110,98,10,275,0,21,21,6,1,49,324
ODISHA,2011,Professional Activity,0,29,64,17,2,112,0,5,4,0,0,9,121
ODISHA,2011,Farming/Agriculture Activity,0,35,44,52,7,138,0,0,3,3,0,6,144
ODISHA,2011,Others (Please Specify),58,325,309,236,126,1054,56,141,163,119,63,542,1596
ODISHA,2011,Retired Person,0,0,0,4,31,35,0,0,0,4,6,10,45
ODISHA,2011,Others (Please Specify),13,104,109,83,37,346,17,117,89,51,17,291,637
ODISHA,2011,Total,144,1016,1026,647,227,3060,121,872,705,356,127,2181,5241
ODISHA,2011,Total Salaried,4,155,232,108,12,511,0,54,57,22,3,136,647
ODISHA,2011,Total Self-employed,59,445,527,403,145,1579,56,167,191,128,64,606,2185
ODISHA,2012,House Wife,0,0,0,0,0,0,0,363,362,124,21,870,870
ODISHA,2012,Service (Government),0,12,11,4,1,28,1,8,18,6,3,36,64
ODISHA,2012,Service (Private),5,109,141,84,7,346,2,43,69,22,5,141,487
ODISHA,2012,Public Sector Undertaking,0,34,34,21,0,89,8,7,13,10,0,38,127
ODISHA,2012,Student,28,165,24,16,0,233,49,115,26,0,0,190,423
ODISHA,2012,Unemployed,10,158,186,68,2,424,7,49,50,22,2,130,554
ODISHA,2012,Self-employed (Business activity),6,63,166,121,21,377,1,17,9,11,1,39,416
ODISHA,2012,Professional Activity,0,8,97,35,10,150,0,2,9,2,0,13,163
ODISHA,2012,Farming/Agriculture Activity,0,14,45,53,9,121,1,10,6,8,0,25,146
ODISHA,2012,Others (Please Specify),34,132,139,142,91,538,28,122,84,69,31,334,872
ODISHA,2012,Retired Person,0,5,5,16,19,45,2,4,0,3,6,15,60
ODISHA,2012,Others (Please Specify),61,167,116,119,82,545,44,89,75,52,40,300,845
ODISHA,2012,Total,144,867,964,679,242,2896,143,829,721,329,109,2131,5027
ODISHA,2012,Total Salaried,5,155,186,109,8,463,11,58,100,38,8,215,678
ODISHA,2012,Total Self-employed,40,217,447,351,131,1186,30,151,108,90,32,411,1597
PUNJAB,2001,House Wife,0,0,0,0,0,0,0,55,28,6,9,98,98
PUNJAB,2001,Service (Government),0,5,5,3,1,14,0,3,0,0,0,3,17
PUNJAB,2001,Service (Private),0,17,9,4,2,32,0,3,2,1,0,6,38
PUNJAB,2001,Public Sector Undertaking,0,4,2,1,1,8,0,2,1,0,0,3,11
PUNJAB,2001,Student,0,5,0,0,0,5,0,3,0,0,0,3,8
PUNJAB,2001,Unemployed,0,24,15,3,19,61,0,6,4,0,0,10,71
PUNJAB,2001,Self-employed (Business activity),0,9,0,6,1,16,0,0,0,1,0,1,17
PUNJAB,2001,Professional Activity,1,3,0,1,2,7,0,0,0,0,0,0,7
PUNJAB,2001,Farming/Agriculture Activity,0,14,0,9,19,42,0,3,0,0,0,3,45
PUNJAB,2001,Others (Please Specify),0,17,0,4,4,25,0,2,1,0,0,3,28
PUNJAB,2001,Retired Person,0,0,0,0,6,6,0,0,0,0,0,0,6
PUNJAB,2001,Others (Please Specify),0,31,33,104,12,180,0,72,30,11,9,122,302
PUNJAB,2001,Total,1,129,64,135,67,396,0,149,66,19,18,252,648
PUNJAB,2001,Total Salaried,0,26,16,8,4,54,0,8,3,1,0,12,66
PUNJAB,2001,Total Self-employed,1,43,0,20,26,90,0,5,1,1,0,7,97
PUNJAB,2002,House Wife,0,0,0,0,0,0,0,49,30,6,2,87,87
PUNJAB,2002,Service (Government),0,8,8,3,0,19,0,0,0,0,0,0,19
PUNJAB,2002,Service (Private),0,10,8,5,0,23,0,1,0,0,0,1,24
PUNJAB,2002,Public Sector Undertaking,0,0,7,4,0,11,0,0,0,0,0,0,11
PUNJAB,2002,Student,1,10,0,0,0,11,2,6,0,0,0,8,19
PUNJAB,2002,Unemployed,0,19,13,8,1,41,0,4,0,0,0,4,45
PUNJAB,2002,Self-employed (Business activity),0,12,18,8,2,40,0,2,0,0,0,2,42
PUNJAB,2002,Professional Activity,0,10,11,1,0,22,0,0,0,0,0,0,22
PUNJAB,2002,Farming/Agriculture Activity,0,16,14,1,9,40,0,0,0,0,0,0,40
PUNJAB,2002,Others (Please Specify),0,34,33,28,15,110,0,0,2,0,0,2,112
PUNJAB,2002,Retired Person,0,0,0,1,2,3,0,0,0,0,0,0,3
PUNJAB,2002,Others (Please Specify),16,31,17,13,0,77,0,2,3,0,1,6,83
PUNJAB,2002,Total,17,150,129,72,29,397,2,64,35,6,3,110,507
PUNJAB,2002,Total Salaried,0,18,23,12,0,53,0,1,0,0,0,1,54
PUNJAB,2002,Total Self-employed,0,72,76,38,26,212,0,2,2,0,0,4,216
PUNJAB,2003,House Wife,0,0,0,0,0,0,0,33,34,5,2,74,74
PUNJAB,2003,Service (Government),0,3,4,3,0,10,0,0,1,1,0,2,12
PUNJAB,2003,Service (Private),0,16,13,2,3,34,0,2,2,0,1,5,39
PUNJAB,2003,Public Sector Undertaking,0,0,2,0,0,2,0,0,0,0,0,0,2
PUNJAB,2003,Student,0,13,1,0,0,14,3,6,0,0,0,9,23
PUNJAB,2003,Unemployed,0,26,17,11,1,55,1,1,1,0,0,3,58
PUNJAB,2003,Self-employed (Business activity),0,19,13,13,1,46,0,1,0,0,0,1,47
PUNJAB,2003,Professional Activity,0,1,1,0,0,2,0,0,0,0,0,0,2
PUNJAB,2003,Farming/Agriculture Activity,0,11,8,6,0,25,0,0,0,1,0,1,26
PUNJAB,2003,Others (Please Specify),2,39,43,31,4,119,0,2,2,0,0,4,123
PUNJAB,2003,Retired Person,0,0,0,1,6,7,0,0,0,0,0,0,7
PUNJAB,2003,Others (Please Specify),1,86,54,25,26,192,1,11,10,3,1,26,218
PUNJAB,2003,Total,3,214,156,92,41,506,5,56,50,10,4,125,631
PUNJAB,2003,Total Salaried,0,19,19,5,3,46,0,2,3,1,1,7,53
PUNJAB,2003,Total Self-employed,2,70,65,50,5,192,0,3,2,1,0,6,198
PUNJAB,2004,House Wife,0,0,0,0,0,0,0,29,25,3,5,62,62
PUNJAB,2004,Service (Government),0,4,11,1,0,16,0,0,0,0,0,0,16
PUNJAB,2004,Service (Private),0,14,11,6,0,31,2,6,2,0,0,10,41
PUNJAB,2004,Public Sector Undertaking,0,4,12,2,0,18,0,3,0,0,0,3,21
PUNJAB,2004,Student,4,5,0,0,0,9,11,6,0,0,0,17,26
PUNJAB,2004,Unemployed,0,13,10,23,0,46,0,6,4,0,0,10,56
PUNJAB,2004,Self-employed (Business activity),0,7,9,12,0,28,0,0,0,0,0,0,28
PUNJAB,2004,Professional Activity,0,11,8,5,2,26,0,0,0,0,0,0,26
PUNJAB,2004,Farming/Agriculture Activity,0,21,29,18,5,73,0,1,0,0,0,1,74
PUNJAB,2004,Others (Please Specify),0,54,61,21,16,152,0,2,2,0,0,4,156
PUNJAB,2004,Retired Person,0,0,0,5,3,8,0,0,0,0,0,0,8
PUNJAB,2004,Others (Please Specify),0,53,32,11,13,109,1,5,6,10,0,22,131
PUNJAB,2004,Total,4,186,183,104,39,516,14,58,39,13,5,129,645
PUNJAB,2004,Total Salaried,0,22,34,9,0,65,2,9,2,0,0,13,78
PUNJAB,2004,Total Self-employed,0,93,107,56,23,279,0,3,2,0,0,5,284
PUNJAB,2005,House Wife,0,0,0,0,0,0,0,33,28,15,1,77,77
PUNJAB,2005,Service (Government),0,2,6,6,1,15,0,1,0,0,0,1,16
PUNJAB,2005,Service (Private),0,19,16,0,0,35,0,0,0,0,0,0,35
PUNJAB,2005,Public Sector Undertaking,0,0,2,0,0,2,0,0,0,0,0,0,2
PUNJAB,2005,Student,0,16,0,1,0,17,0,4,0,0,0,4,21
PUNJAB,2005,Unemployed,0,25,13,8,1,47,1,1,3,0,0,5,52
PUNJAB,2005,Self-employed (Business activity),0,14,24,17,3,58,0,2,2,1,0,5,63
PUNJAB,2005,Professional Activity,0,4,4,5,1,14,0,0,0,0,0,0,14
PUNJAB,2005,Farming/Agriculture Activity,0,24,0,17,6,47,0,0,0,0,0,0,47
PUNJAB,2005,Others (Please Specify),0,55,55,28,10,148,0,1,2,0,0,3,151
PUNJAB,2005,Retired Person,0,0,0,3,5,8,0,0,0,0,0,0,8
PUNJAB,2005,Others (Please Specify),0,5,47,27,12,91,1,0,5,4,1,11,102
PUNJAB,2005,Total,0,164,167,112,39,482,2,42,40,20,2,106,588
PUNJAB,2005,Total Salaried,0,21,24,6,1,52,0,1,0,0,0,1,53
PUNJAB,2005,Total Self-employed,0,97,83,67,20,267,0,3,4,1,0,8,275
PUNJAB,2006,House Wife,0,0,0,0,0,0,1,49,45,15,0,110,110
PUNJAB,2006,Service (Government),0,5,7,4,0,16,0,0,0,0,0,0,16
PUNJAB,2006,Service (Private),0,23,25,7,1,56,0,3,1,0,0,4,60
PUNJAB,2006,Public Sector Undertaking,0,1,2,2,0,5,0,1,0,0,0,1,6
PUNJAB,2006,Student,2,15,1,0,0,18,2,11,0,0,0,13,31
PUNJAB,2006,Unemployed,0,29,22,8,7,66,0,2,0,0,0,2,68
PUNJAB,2006,Self-employed (Business activity),0,6,10,6,1,23,0,0,0,0,0,0,23
PUNJAB,2006,Professional Activity,0,18,10,12,7,47,0,0,0,0,0,0,47
PUNJAB,2006,Farming/Agriculture Activity,0,27,28,22,8,85,0,0,0,0,0,0,85
PUNJAB,2006,Others (Please Specify),3,38,47,28,5,121,1,6,2,0,0,9,130
PUNJAB,2006,Retired Person,0,0,0,0,1,1,0,0,0,0,0,0,1
PUNJAB,2006,Others (Please Specify),6,54,59,35,18,172,12,7,1,1,2,23,195
PUNJAB,2006,Total,11,216,211,124,48,610,16,79,49,16,2,162,772
PUNJAB,2006,Total Salaried,0,29,34,13,1,77,0,4,1,0,0,5,82
PUNJAB,2006,Total Self-employed,3,89,95,68,21,276,1,6,2,0,0,9,285
PUNJAB,2007,House Wife,0,0,0,0,0,0,0,62,53,13,4,132,132
PUNJAB,2007,Service (Government),0,9,9,9,0,27,0,1,1,1,0,3,30
PUNJAB,2007,Service (Private),0,22,28,13,0,63,0,3,0,0,0,3,66
PUNJAB,2007,Public Sector Undertaking,0,0,0,0,0,0,0,0,0,0,0,0,0
PUNJAB,2007,Student,2,12,1,0,0,15,6,9,0,0,0,15,30
PUNJAB,2007,Unemployed,0,22,7,7,6,42,0,7,2,0,0,9,51
PUNJAB,2007,Self-employed (Business activity),0,9,17,12,4,42,0,0,0,0,0,0,42
PUNJAB,2007,Professional Activity,0,9,9,4,1,23,0,1,0,0,0,1,24
PUNJAB,2007,Farming/Agriculture Activity,0,21,32,19,14,86,0,0,1,1,0,2,88
PUNJAB,2007,Others (Please Specify),0,68,53,32,17,170,2,12,0,0,0,14,184
PUNJAB,2007,Retired Person,0,0,0,4,2,6,0,0,0,0,0,0,6
PUNJAB,2007,Others (Please Specify),3,64,60,17,14,158,5,17,12,2,0,36,194
PUNJAB,2007,Total,5,236,216,117,58,632,13,112,69,17,4,215,847
PUNJAB,2007,Total Salaried,0,31,37,22,0,90,0,4,1,1,0,6,96
PUNJAB,2007,Total Self-employed,0,107,111,67,36,321,2,13,1,1,0,17,338
PUNJAB,2008,House Wife,0,0,0,0,0,0,1,66,66,15,8,156,156
PUNJAB,2008,Service (Government),0,4,16,9,0,29,0,0,0,0,0,0,29
PUNJAB,2008,Service (Private),0,35,36,12,0,83,0,2,3,0,0,5,88
PUNJAB,2008,Public Sector Undertaking,0,1,1,0,0,2,0,0,0,0,0,0,2
PUNJAB,2008,Student,2,23,0,1,0,26,3,19,0,0,0,22,48
PUNJAB,2008,Unemployed,0,24,20,7,3,54,0,1,0,0,0,1,55
PUNJAB,2008,Self-employed (Business activity),0,26,45,21,13,105,0,0,0,0,0,0,105
PUNJAB,2008,Professional Activity,0,4,4,3,2,13,0,0,0,0,0,0,13
PUNJAB,2008,Farming/Agriculture Activity,1,18,32,9,6,66,0,0,0,0,0,0,66
PUNJAB,2008,Others (Please Specify),3,37,41,36,7,124,1,14,12,3,1,31,155
PUNJAB,2008,Retired Person,0,0,0,0,2,2,0,0,0,0,0,0,2
PUNJAB,2008,Others (Please Specify),2,32,54,32,19,139,5,4,2,0,0,11,150
PUNJAB,2008,Total,8,204,249,130,52,643,10,106,83,18,9,226,869
PUNJAB,2008,Total Salaried,0,40,53,21,0,114,0,2,3,0,0,5,119
PUNJAB,2008,Total Self-employed,4,85,122,69,28,308,1,14,12,3,1,31,339
PUNJAB,2009,House Wife,0,0,0,0,0,0,0,64,49,12,5,130,130
PUNJAB,2009,Service (Government),0,1,13,1,0,15,0,0,0,0,0,0,15
PUNJAB,2009,Service (Private),1,20,22,5,6,54,0,3,4,0,0,7,61
PUNJAB,2009,Public Sector Undertaking,0,1,3,0,2,6,0,0,2,0,0,2,8
PUNJAB,2009,Student,7,18,4,0,0,29,4,22,0,0,0,26,55
PUNJAB,2009,Unemployed,0,20,20,2,1,43,0,3,2,0,0,5,48
PUNJAB,2009,Self-employed (Business activity),1,12,22,13,3,51,0,0,0,0,2,2,53
PUNJAB,2009,Professional Activity,0,5,11,15,0,31,0,0,1,0,0,1,32
PUNJAB,2009,Farming/Agriculture Activity,0,38,35,14,6,93,0,2,0,2,0,4,97
PUNJAB,2009,Others (Please Specify),2,73,52,35,14,176,0,4,2,2,1,9,185
PUNJAB,2009,Retired Person,0,2,5,4,1,12,0,0,0,4,4,8,20
PUNJAB,2009,Others (Please Specify),0,40,33,33,19,125,1,9,1,4,3,18,143
PUNJAB,2009,Total,11,230,220,122,52,635,5,107,61,24,15,212,847
PUNJAB,2009,Total Salaried,1,22,38,6,8,75,0,3,6,0,0,9,84
PUNJAB,2009,Total Self-employed,3,128,120,77,23,351,0,6,3,4,3,16,367
PUNJAB,2010,House Wife,0,0,0,0,0,0,1,60,48,16,5,130,130
PUNJAB,2010,Service (Government),0,5,13,3,0,21,0,2,0,0,0,2,23
PUNJAB,2010,Service (Private),2,27,44,7,2,82,0,0,1,0,0,1,83
PUNJAB,2010,Public Sector Undertaking,0,0,0,0,0,0,0,0,0,0,0,0,0
PUNJAB,2010,Student,4,21,6,0,0,31,1,23,0,0,0,24,55
PUNJAB,2010,Unemployed,3,25,23,5,3,59,0,3,1,0,4,8,67
PUNJAB,2010,Self-employed (Business activity),0,20,16,4,1,41,0,0,0,0,0,0,41
PUNJAB,2010,Professional Activity,0,13,5,3,0,21,0,0,0,0,0,0,21
PUNJAB,2010,Farming/Agriculture Activity,0,27,31,12,10,80,0,0,0,0,0,0,80
PUNJAB,2010,Others (Please Specify),0,77,77,59,26,239,1,5,3,2,3,14,253
PUNJAB,2010,Retired Person,0,0,0,1,7,8,0,0,0,0,0,0,8
PUNJAB,2010,Others (Please Specify),1,44,44,33,15,137,0,11,8,3,0,22,159
PUNJAB,2010,Total,10,259,259,127,64,719,3,104,61,21,12,201,920
PUNJAB,2010,Total Salaried,2,32,57,10,2,103,0,2,1,0,0,3,106
PUNJAB,2010,Total Self-employed,0,137,129,78,37,381,1,5,3,2,3,14,395
PUNJAB,2011,House Wife,0,0,0,0,0,0,0,72,61,10,5,148,148
PUNJAB,2011,Service (Government),0,13,20,10,0,43,0,0,0,0,0,0,43
PUNJAB,2011,Service (Private),0,52,58,31,7,148,0,6,0,0,0,6,154
PUNJAB,2011,Public Sector Undertaking,0,5,2,1,0,8,0,6,2,0,0,8,16
PUNJAB,2011,Student,0,20,1,0,0,21,0,17,0,0,0,17,38
PUNJAB,2011,Unemployed,0,48,26,12,8,94,0,4,2,0,0,6,100
PUNJAB,2011,Self-employed (Business activity),0,10,16,4,1,31,0,0,0,0,0,0,31
PUNJAB,2011,Professional Activity,0,3,11,2,1,17,0,0,0,0,0,0,17
PUNJAB,2011,Farming/Agriculture Activity,0,33,34,14,13,94,0,0,1,3,0,4,98
PUNJAB,2011,Others (Please Specify),0,43,54,27,20,144,0,6,4,2,0,12,156
PUNJAB,2011,Retired Person,0,0,2,2,5,9,0,0,0,0,0,0,9
PUNJAB,2011,Others (Please Specify),0,47,67,22,10,146,0,5,5,0,0,10,156
PUNJAB,2011,Total,0,274,291,125,65,755,0,116,75,15,5,211,966
PUNJAB,2011,Total Salaried,0,70,80,42,7,199,0,12,2,0,0,14,213
PUNJAB,2011,Total Self-employed,0,89,115,47,35,286,0,6,5,5,0,16,302
PUNJAB,2012,House Wife,0,0,0,0,0,0,1,71,84,15,2,173,173
PUNJAB,2012,Service (Government),0,6,5,2,0,13,0,1,0,0,0,1,14
PUNJAB,2012,Service (Private),0,68,69,26,6,169,0,2,8,2,0,12,181
PUNJAB,2012,Public Sector Undertaking,0,6,6,1,0,13,0,4,0,0,0,4,17
PUNJAB,2012,Student,5,25,0,0,0,30,1,26,0,0,0,27,57
PUNJAB,2012,Unemployed,0,50,19,10,4,83,0,4,1,2,0,7,90
PUNJAB,2012,Self-employed (Business activity),0,10,18,8,3,39,0,0,0,0,0,0,39
PUNJAB,2012,Professional Activity,0,6,15,4,0,25,0,0,0,0,0,0,25
PUNJAB,2012,Farming/Agriculture Activity,0,23,34,8,10,75,0,0,0,0,0,0,75
PUNJAB,2012,Others (Please Specify),0,80,96,47,20,243,0,9,3,1,0,13,256
PUNJAB,2012,Retired Person,0,0,1,2,4,7,0,0,0,1,0,1,8
PUNJAB,2012,Others (Please Specify),2,25,36,17,7,87,0,4,4,0,0,8,95
PUNJAB,2012,Total,7,299,299,125,54,784,2,121,100,21,2,246,1030
PUNJAB,2012,Total Salaried,0,80,80,29,6,195,0,7,8,2,0,17,212
PUNJAB,2012,Total Self-employed,0,119,163,67,33,382,0,9,3,1,0,13,395
RAJASTHAN,2001,House Wife,0,0,0,0,0,0,2,391,265,101,24,783,783
RAJASTHAN,2001,Service (Government),0,14,33,12,0,59,0,2,0,1,0,3,62
RAJASTHAN,2001,Service (Private),0,88,84,36,10,218,0,14,11,2,0,27,245
RAJASTHAN,2001,Public Sector Undertaking,0,24,41,7,0,72,0,4,6,1,0,11,83
RAJASTHAN,2001,Student,34,68,14,5,0,121,30,53,0,0,0,83,204
RAJASTHAN,2001,Unemployed,0,89,70,18,2,179,0,19,2,0,0,21,200
RAJASTHAN,2001,Self-employed (Business activity),0,56,49,29,9,143,0,8,3,0,0,11,154
RAJASTHAN,2001,Professional Activity,1,13,14,11,1,40,0,0,0,0,0,0,40
RAJASTHAN,2001,Farming/Agriculture Activity,1,156,173,78,16,424,1,38,33,5,4,81,505
RAJASTHAN,2001,Others (Please Specify),45,88,127,92,29,381,21,65,28,5,12,131,512
RAJASTHAN,2001,Retired Person,0,0,0,0,8,8,0,0,0,0,0,0,8
RAJASTHAN,2001,Others (Please Specify),5,81,108,75,45,314,7,30,39,7,2,85,399
RAJASTHAN,2001,Total,86,677,713,363,120,1959,61,624,387,122,42,1236,3195
RAJASTHAN,2001,Total Salaried,0,126,158,55,10,349,0,20,17,4,0,41,390
RAJASTHAN,2001,Total Self-employed,47,313,363,210,55,988,22,111,64,10,16,223,1211
RAJASTHAN,2002,House Wife,0,0,0,0,0,0,1,387,248,113,18,767,767
RAJASTHAN,2002,Service (Government),0,12,36,14,0,62,0,0,2,0,0,2,64
RAJASTHAN,2002,Service (Private),0,75,73,71,2,221,0,15,13,2,0,30,251
RAJASTHAN,2002,Public Sector Undertaking,0,20,26,11,2,59,0,1,3,4,0,8,67
RAJASTHAN,2002,Student,22,56,9,0,0,87,6,46,0,0,0,52,139
RAJASTHAN,2002,Unemployed,1,58,41,26,2,128,0,9,6,1,0,16,144
RAJASTHAN,2002,Self-employed (Business activity),0,44,43,29,4,120,0,0,5,0,0,5,125
RAJASTHAN,2002,Professional Activity,0,10,9,5,1,25,0,1,0,0,0,1,26
RAJASTHAN,2002,Farming/Agriculture Activity,1,154,174,128,36,493,0,35,39,17,3,94,587
RAJASTHAN,2002,Others (Please Specify),36,155,146,86,20,443,16,42,20,10,3,91,534
RAJASTHAN,2002,Retired Person,0,0,0,8,9,17,0,0,0,0,2,2,19
RAJASTHAN,2002,Others (Please Specify),5,133,206,64,29,437,7,44,37,0,0,88,525
RAJASTHAN,2002,Total,65,717,763,442,105,2092,30,580,373,147,26,1156,3248
RAJASTHAN,2002,Total Salaried,0,107,135,96,4,342,0,16,18,6,0,40,382
RAJASTHAN,2002,Total Self-employed,37,363,372,248,61,1081,16,78,64,27,6,191,1272
RAJASTHAN,2003,House Wife,0,0,0,0,0,0,2,417,336,137,46,938,938
RAJASTHAN,2003,Service (Government),0,3,25,14,0,42,0,2,1,0,0,3,45
RAJASTHAN,2003,Service (Private),0,63,124,61,10,258,0,14,11,2,0,27,285
RAJASTHAN,2003,Public Sector Undertaking,0,22,35,16,0,73,0,11,6,1,0,18,91
RAJASTHAN,2003,Student,24,110,4,0,0,138,13,51,3,0,0,67,205
RAJASTHAN,2003,Unemployed,0,70,66,22,0,158,0,3,0,0,0,3,161
RAJASTHAN,2003,Self-employed (Business activity),0,33,72,30,5,140,0,0,0,0,0,0,140
RAJASTHAN,2003,Professional Activity,0,12,22,10,2,46,0,0,0,0,0,0,46
RAJASTHAN,2003,Farming/Agriculture Activity,0,195,218,111,38,562,0,34,27,12,1,74,636
RAJASTHAN,2003,Others (Please Specify),11,185,190,123,90,599,8,41,16,5,3,73,672
RAJASTHAN,2003,Retired Person,0,0,0,10,8,18,0,0,0,0,0,0,18
RAJASTHAN,2003,Others (Please Specify),31,131,123,53,17,355,13,28,10,11,7,69,424
RAJASTHAN,2003,Total,66,824,879,450,170,2389,36,601,410,168,57,1272,3661
RAJASTHAN,2003,Total Salaried,0,88,184,91,10,373,0,27,18,3,0,48,421
RAJASTHAN,2003,Total Self-employed,11,425,502,274,135,1347,8,75,43,17,4,147,1494
RAJASTHAN,2004,House Wife,0,0,0,0,0,0,10,370,333,123,32,868,868
RAJASTHAN,2004,Service (Government),0,4,13,7,0,24,0,1,1,0,0,2,26
RAJASTHAN,2004,Service (Private),0,103,126,47,2,278,0,12,6,6,0,24,302
RAJASTHAN,2004,Public Sector Undertaking,0,19,13,5,0,37,0,2,2,0,0,4,41
RAJASTHAN,2004,Student,30,60,8,0,0,98,10,36,3,0,0,49,147
RAJASTHAN,2004,Unemployed,0,85,79,14,4,182,0,3,1,1,0,5,187
RAJASTHAN,2004,Self-employed (Business activity),0,29,48,22,10,109,0,1,1,2,0,4,113
RAJASTHAN,2004,Professional Activity,0,11,11,7,3,32,0,0,0,0,0,0,32
RAJASTHAN,2004,Farming/Agriculture Activity,1,207,286,154,27,675,0,27,29,14,4,74,749
RAJASTHAN,2004,Others (Please Specify),5,162,157,113,34,471,3,43,19,17,2,84,555
RAJASTHAN,2004,Retired Person,0,0,0,2,0,2,0,0,0,0,0,0,2
RAJASTHAN,2004,Others (Please Specify),30,171,190,128,59,578,20,47,32,12,14,125,703
RAJASTHAN,2004,Total,66,851,931,499,139,2486,43,542,427,175,52,1239,3725
RAJASTHAN,2004,Total Salaried,0,126,152,59,2,339,0,15,9,6,0,30,369
RAJASTHAN,2004,Total Self-employed,6,409,502,296,74,1287,3,71,49,33,6,162,1449
RAJASTHAN,2005,House Wife,0,0,0,0,0,0,13,459,408,201,19,1100,1100
RAJASTHAN,2005,Service (Government),0,9,19,10,0,38,0,0,0,0,0,0,38
RAJASTHAN,2005,Service (Private),0,108,107,58,2,275,0,8,3,0,0,11,286
RAJASTHAN,2005,Public Sector Undertaking,0,15,9,6,0,30,0,2,2,0,0,4,34
RAJASTHAN,2005,Student,19,56,0,0,0,75,13,22,2,0,0,37,112
RAJASTHAN,2005,Unemployed,3,57,32,6,2,100,0,2,0,0,0,2,102
RAJASTHAN,2005,Self-employed (Business activity),0,46,51,20,3,120,0,0,0,0,0,0,120
RAJASTHAN,2005,Professional Activity,0,12,13,2,0,27,0,0,0,0,0,0,27
RAJASTHAN,2005,Farming/Agriculture Activity,11,138,210,65,12,436,0,6,14,5,0,25,461
RAJASTHAN,2005,Others (Please Specify),17,199,215,90,17,538,6,28,10,4,1,49,587
RAJASTHAN,2005,Retired Person,0,0,0,2,2,4,0,0,0,0,0,0,4
RAJASTHAN,2005,Others (Please Specify),38,292,469,317,99,1215,18,47,24,2,1,92,1307
RAJASTHAN,2005,Total,88,932,1125,576,137,2858,50,574,463,212,21,1320,4178
RAJASTHAN,2005,Total Salaried,0,132,135,74,2,343,0,10,5,0,0,15,358
RAJASTHAN,2005,Total Self-employed,28,395,489,177,32,1121,6,34,24,9,1,74,1195
RAJASTHAN,2006,House Wife,0,0,0,0,0,0,9,487,415,151,31,1093,1093
RAJASTHAN,2006,Service (Government),0,5,21,14,0,40,0,0,0,0,0,0,40
RAJASTHAN,2006,Service (Private),0,119,153,65,1,338,0,6,5,0,0,11,349
RAJASTHAN,2006,Public Sector Undertaking,0,13,11,5,0,29,0,2,2,0,0,4,33
RAJASTHAN,2006,Student,15,53,2,0,0,70,15,49,0,0,0,64,134
RAJASTHAN,2006,Unemployed,0,59,23,14,1,97,0,0,0,0,0,0,97
RAJASTHAN,2006,Self-employed (Business activity),0,58,78,32,3,171,0,5,0,0,0,5,176
RAJASTHAN,2006,Professional Activity,0,8,8,3,0,19,0,0,0,0,0,0,19
RAJASTHAN,2006,Farming/Agriculture Activity,2,85,147,101,21,356,0,16,18,4,1,39,395
RAJASTHAN,2006,Others (Please Specify),2,228,306,136,33,705,6,26,13,9,1,55,760
RAJASTHAN,2006,Retired Person,0,0,0,2,0,2,0,0,1,0,0,1,3
RAJASTHAN,2006,Others (Please Specify),40,288,423,257,75,1083,16,18,15,22,10,81,1164
RAJASTHAN,2006,Total,59,916,1172,629,134,2910,46,609,469,186,43,1353,4263
RAJASTHAN,2006,Total Salaried,0,137,185,84,1,407,0,8,7,0,0,15,422
RAJASTHAN,2006,Total Self-employed,4,379,539,272,57,1251,6,47,31,13,2,99,1350
RAJASTHAN,2007,House Wife,0,0,0,0,0,0,9,398,410,177,29,1023,1023
RAJASTHAN,2007,Service (Government),0,5,22,12,0,39,0,10,17,1,1,29,68
RAJASTHAN,2007,Service (Private),6,102,150,82,1,341,0,9,1,0,0,10,351
RAJASTHAN,2007,Public Sector Undertaking,0,11,7,6,0,24,0,5,0,0,0,5,29
RAJASTHAN,2007,Student,28,86,1,0,0,115,13,47,10,0,0,70,185
RAJASTHAN,2007,Unemployed,1,48,86,20,2,157,0,1,2,2,0,5,162
RAJASTHAN,2007,Self-employed (Business activity),0,72,120,84,3,279,0,0,0,0,0,0,279
RAJASTHAN,2007,Professional Activity,0,18,16,2,0,36,0,0,3,0,0,3,39
RAJASTHAN,2007,Farming/Agriculture Activity,2,153,229,176,29,589,0,9,9,10,1,29,618
RAJASTHAN,2007,Others (Please Specify),5,254,334,128,36,757,0,25,9,7,0,41,798
RAJASTHAN,2007,Retired Person,0,0,0,0,0,0,0,0,0,0,0,0,0
RAJASTHAN,2007,Others (Please Specify),36,314,216,195,56,817,14,40,5,5,4,68,885
RAJASTHAN,2007,Total,78,1063,1181,705,127,3154,36,544,466,202,35,1283,4437
RAJASTHAN,2007,Total Salaried,6,118,179,100,1,404,0,24,18,1,1,44,448
RAJASTHAN,2007,Total Self-employed,7,497,699,390,68,1661,0,34,21,17,1,73,1734
RAJASTHAN,2008,House Wife,0,0,0,0,0,0,18,360,389,147,44,958,958
RAJASTHAN,2008,Service (Government),0,13,31,18,1,63,0,13,7,6,0,26,89
RAJASTHAN,2008,Service (Private),0,136,206,86,3,431,0,27,5,3,0,35,466
RAJASTHAN,2008,Public Sector Undertaking,0,6,6,4,1,17,0,1,1,0,0,2,19
RAJASTHAN,2008,Student,29,101,43,0,0,173,13,53,3,0,0,69,242
RAJASTHAN,2008,Unemployed,0,81,65,22,8,176,0,15,12,4,0,31,207
RAJASTHAN,2008,Self-employed (Business activity),0,57,109,66,2,234,0,2,3,5,0,10,244
RAJASTHAN,2008,Professional Activity,0,18,24,8,3,53,0,0,0,0,0,0,53
RAJASTHAN,2008,Farming/Agriculture Activity,0,156,287,212,40,695,2,33,56,7,3,101,796
RAJASTHAN,2008,Others (Please Specify),38,336,392,161,45,972,9,80,33,38,4,164,1136
RAJASTHAN,2008,Retired Person,0,5,5,2,1,13,0,0,0,0,0,0,13
RAJASTHAN,2008,Others (Please Specify),51,253,247,169,55,775,26,74,40,20,8,168,943
RAJASTHAN,2008,Total,118,1162,1415,748,159,3602,68,658,549,230,59,1564,5166
RAJASTHAN,2008,Total Salaried,0,155,243,108,5,511,0,41,13,9,0,63,574
RAJASTHAN,2008,Total Self-employed,38,567,812,447,90,1954,11,115,92,50,7,275,2229
RAJASTHAN,2009,House Wife,0,0,0,0,0,0,23,466,410,142,29,1070,1070
RAJASTHAN,2009,Service (Government),0,5,19,11,1,36,0,7,3,0,0,10,46
RAJASTHAN,2009,Service (Private),0,188,217,91,26,522,0,12,2,0,0,14,536
RAJASTHAN,2009,Public Sector Undertaking,0,2,5,9,4,20,0,1,1,1,0,3,23
RAJASTHAN,2009,Student,37,108,1,0,0,146,20,55,2,0,0,77,223
RAJASTHAN,2009,Unemployed,0,77,47,14,1,139,0,5,3,8,1,17,156
RAJASTHAN,2009,Self-employed (Business activity),0,61,158,54,4,277,0,2,2,2,0,6,283
RAJASTHAN,2009,Professional Activity,0,8,35,9,0,52,0,0,1,0,0,1,53
RAJASTHAN,2009,Farming/Agriculture Activity,7,196,337,190,45,775,0,33,28,12,3,76,851
RAJASTHAN,2009,Others (Please Specify),17,301,343,206,35,902,13,67,53,10,3,146,1048
RAJASTHAN,2009,Retired Person,0,0,1,1,3,5,0,0,0,0,1,1,6
RAJASTHAN,2009,Others (Please Specify),38,214,179,140,66,637,6,62,43,18,4,133,770
RAJASTHAN,2009,Total,99,1160,1342,725,185,3511,62,710,548,193,41,1554,5065
RAJASTHAN,2009,Total Salaried,0,195,241,111,31,578,0,20,6,1,0,27,605
RAJASTHAN,2009,Total Self-employed,24,566,873,459,84,2006,13,102,84,24,6,229,2235
RAJASTHAN,2010,House Wife,0,0,0,0,0,0,19,426,403,161,25,1034,1034
RAJASTHAN,2010,Service (Government),0,5,20,11,0,36,0,0,6,0,0,6,42
RAJASTHAN,2010,Service (Private),0,135,149,97,22,403,0,16,7,5,0,28,431
RAJASTHAN,2010,Public Sector Undertaking,0,8,10,13,3,34,0,3,3,0,0,6,40
RAJASTHAN,2010,Student,19,118,7,0,0,144,12,75,1,1,0,89,233
RAJASTHAN,2010,Unemployed,0,78,66,24,4,172,0,9,11,7,0,27,199
RAJASTHAN,2010,Self-employed (Business activity),0,55,89,26,6,176,0,2,2,1,0,5,181
RAJASTHAN,2010,Professional Activity,0,14,39,2,6,61,0,2,1,1,0,4,65
RAJASTHAN,2010,Farming/Agriculture Activity,2,114,146,66,23,351,0,20,13,6,0,39,390
RAJASTHAN,2010,Others (Please Specify),2,226,386,261,41,916,5,56,20,11,3,95,1011
RAJASTHAN,2010,Retired Person,0,14,7,9,5,35,0,6,0,0,0,6,41
RAJASTHAN,2010,Others (Please Specify),67,326,369,229,46,1037,31,86,63,28,8,216,1253
RAJASTHAN,2010,Total,90,1093,1288,738,156,3365,67,701,530,221,36,1555,4920
RAJASTHAN,2010,Total Salaried,0,148,179,121,25,473,0,19,16,5,0,40,513
RAJASTHAN,2010,Total Self-employed,4,409,660,355,76,1504,5,80,36,19,3,143,1647
RAJASTHAN,2011,House Wife,0,0,0,0,0,0,9,341,306,101,27,784,784
RAJASTHAN,2011,Service (Government),0,5,16,13,1,35,0,1,6,1,0,8,43
RAJASTHAN,2011,Service (Private),0,196,142,68,7,413,0,21,17,5,2,45,458
RAJASTHAN,2011,Public Sector Undertaking,0,7,8,8,2,25,0,2,3,0,0,5,30
RAJASTHAN,2011,Student,23,128,6,0,0,157,8,68,3,0,0,79,236
RAJASTHAN,2011,Unemployed,0,63,42,9,0,114,0,9,4,1,0,14,128
RAJASTHAN,2011,Self-employed (Business activity),0,53,71,34,3,161,0,6,7,1,0,14,175
RAJASTHAN,2011,Professional Activity,0,31,51,20,2,104,0,1,0,0,0,1,105
RAJASTHAN,2011,Farming/Agriculture Activity,0,77,77,59,11,224,0,20,15,8,1,44,268
RAJASTHAN,2011,Others (Please Specify),6,252,318,133,29,738,2,66,29,11,3,111,849
RAJASTHAN,2011,Retired Person,0,0,1,3,4,8,0,0,0,0,0,0,8
RAJASTHAN,2011,Others (Please Specify),34,337,324,292,50,1037,8,102,73,32,12,227,1264
RAJASTHAN,2011,Total,63,1149,1056,639,109,3016,27,637,463,160,45,1332,4348
RAJASTHAN,2011,Total Salaried,0,208,166,89,10,473,0,24,26,6,2,58,531
RAJASTHAN,2011,Total Self-employed,6,413,517,246,45,1227,2,93,51,20,4,170,1397
RAJASTHAN,2012,House Wife,0,0,0,0,0,0,1,413,337,106,37,894,894
RAJASTHAN,2012,Service (Government),0,12,19,16,1,48,0,2,3,0,0,5,53
RAJASTHAN,2012,Service (Private),0,153,148,62,7,370,0,12,12,2,2,28,398
RAJASTHAN,2012,Public Sector Undertaking,0,7,8,20,6,41,0,1,2,0,0,3,44
RAJASTHAN,2012,Student,15,119,4,0,0,138,14,84,3,0,1,102,240
RAJASTHAN,2012,Unemployed,0,56,47,21,8,132,1,9,27,6,0,43,175
RAJASTHAN,2012,Self-employed (Business activity),0,49,78,31,7,165,0,1,11,1,0,13,178
RAJASTHAN,2012,Professional Activity,0,23,47,26,0,96,0,0,0,1,0,1,97
RAJASTHAN,2012,Farming/Agriculture Activity,0,68,88,66,20,242,1,16,7,4,0,28,270
RAJASTHAN,2012,Others (Please Specify),10,232,287,142,27,698,4,36,23,12,3,78,776
RAJASTHAN,2012,Retired Person,0,0,1,2,8,11,0,0,0,0,0,0,11
RAJASTHAN,2012,Others (Please Specify),43,367,433,373,70,1286,19,167,137,59,17,399,1685
RAJASTHAN,2012,Total,68,1086,1160,759,154,3227,40,741,562,191,60,1594,4821
RAJASTHAN,2012,Total Salaried,0,172,175,98,14,459,0,15,17,2,2,36,495
RAJASTHAN,2012,Total Self-employed,10,372,500,265,54,1201,5,53,41,18,3,120,1321
SIKKIM,2001,House Wife,0,0,0,0,0,0,0,2,10,0,0,12,12
SIKKIM,2001,Service (Government),0,1,1,0,0,2,0,2,1,0,0,3,5
SIKKIM,2001,Service (Private),0,3,4,0,0,7,0,0,0,0,0,0,7
SIKKIM,2001,Public Sector Undertaking,0,1,0,0,0,1,0,0,0,0,0,0,1
SIKKIM,2001,Student,0,1,0,0,0,1,2,2,0,0,0,4,5
SIKKIM,2001,Unemployed,0,4,3,0,1,8,0,3,1,0,0,4,12
SIKKIM,2001,Self-employed (Business activity),0,0,3,0,0,3,0,0,0,0,0,0,3
SIKKIM,2001,Professional Activity,0,2,6,0,0,8,0,3,4,0,0,7,15
SIKKIM,2001,Farming/Agriculture Activity,0,6,4,4,2,16,0,2,0,0,0,2,18
SIKKIM,2001,Others (Please Specify),0,9,6,1,0,16,0,0,0,0,0,0,16
SIKKIM,2001,Retired Person,0,0,0,0,0,0,0,0,0,0,0,0,0
SIKKIM,2001,Others (Please Specify),0,0,0,0,0,0,0,0,0,0,0,0,0
SIKKIM,2001,Total,0,27,27,5,3,62,2,14,16,0,0,32,94
SIKKIM,2001,Total Salaried,0,5,5,0,0,10,0,2,1,0,0,3,13
SIKKIM,2001,Total Self-employed,0,17,19,5,2,43,0,5,4,0,0,9,52
SIKKIM,2002,House Wife,0,0,0,0,0,0,0,1,0,0,0,1,1
SIKKIM,2002,Service (Government),0,0,0,0,0,0,0,0,0,0,0,0,0
SIKKIM,2002,Service (Private),0,0,0,0,0,0,0,0,0,0,0,0,0
SIKKIM,2002,Public Sector Undertaking,0,0,0,0,0,0,0,0,0,0,0,0,0
SIKKIM,2002,Student,1,2,0,0,0,3,0,2,0,0,0,2,5
SIKKIM,2002,Unemployed,0,4,3,2,1,10,1,3,4,2,2,12,22
SIKKIM,2002,Self-employed (Business activity),0,0,0,1,2,3,0,0,0,1,0,1,4
SIKKIM,2002,Professional Activity,0,0,0,0,0,0,0,0,0,0,0,0,0
SIKKIM,2002,Farming/Agriculture Activity,0,2,2,1,0,5,0,2,0,1,0,3,8
SIKKIM,2002,Others (Please Specify),2,4,7,3,3,19,0,3,0,1,0,4,23
SIKKIM,2002,Retired Person,0,3,0,0,0,3,0,0,0,0,0,0,3
SIKKIM,2002,Others (Please Specify),0,0,7,4,0,11,0,0,1,0,0,1,12
SIKKIM,2002,Total,3,15,19,11,6,54,1,11,5,5,2,24,78
SIKKIM,2002,Total Salaried,0,0,0,0,0,0,0,0,0,0,0,0,0
SIKKIM,2002,Total Self-employed,2,6,9,5,5,27,0,5,0,3,0,8,35
SIKKIM,2003,House Wife,0,0,0,0,0,0,0,7,5,4,5,21,21
SIKKIM,2003,Service (Government),0,0,3,2,1,6,0,0,3,0,0,3,9
SIKKIM,2003,Service (Private),0,4,2,4,3,13,0,0,0,0,0,0,13
SIKKIM,2003,Public Sector Undertaking,0,0,0,0,0,0,0,0,0,0,0,0,0
SIKKIM,2003,Student,1,7,0,0,1,9,0,1,0,0,0,1,10
SIKKIM,2003,Unemployed,0,6,5,0,1,12,0,1,0,0,0,1,13
SIKKIM,2003,Self-employed (Business activity),0,0,3,0,0,3,0,0,0,0,0,0,3
SIKKIM,2003,Professional Activity,0,0,0,0,0,0,0,0,0,0,0,0,0
SIKKIM,2003,Farming/Agriculture Activity,0,8,3,4,5,20,0,0,0,7,4,11,31
SIKKIM,2003,Others (Please Specify),0,0,0,4,1,5,0,0,0,0,0,0,5
SIKKIM,2003,Retired Person,0,0,0,0,0,0,0,0,0,0,0,0,0
SIKKIM,2003,Others (Please Specify),0,0,0,0,0,0,0,0,0,0,0,0,0
SIKKIM,2003,Total,1,25,16,14,12,68,0,9,8,11,9,37,105
SIKKIM,2003,Total Salaried,0,4,5,6,4,19,0,0,3,0,0,3,22
SIKKIM,2003,Total Self-employed,0,8,6,8,6,28,0,0,0,7,4,11,39
SIKKIM,2004,House Wife,0,0,0,0,0,0,0,0,2,7,2,11,11
SIKKIM,2004,Service (Government),0,0,3,0,0,3,0,0,0,0,0,0,3
SIKKIM,2004,Service (Private),0,0,4,2,0,6,0,0,0,0,0,0,6
SIKKIM,2004,Public Sector Undertaking,0,0,0,0,0,0,0,0,0,0,0,0,0
SIKKIM,2004,Student,0,0,0,0,0,0,0,0,0,0,0,0,0
SIKKIM,2004,Unemployed,0,0,2,0,0,2,0,0,2,0,2,4,6
SIKKIM,2004,Self-employed (Business activity),0,0,0,0,0,0,0,0,0,0,0,0,0
SIKKIM,2004,Professional Activity,0,0,3,1,2,6,0,0,0,1,1,2,8
SIKKIM,2004,Farming/Agriculture Activity,0,0,3,6,21,30,0,0,4,7,8,19,49
SIKKIM,2004,Others (Please Specify),0,0,0,2,3,5,0,0,0,0,5,5,10
SIKKIM,2004,Retired Person,0,0,0,0,0,0,0,0,0,0,0,0,0
SIKKIM,2004,Others (Please Specify),0,0,2,2,0,4,0,0,1,0,0,1,5
SIKKIM,2004,Total,0,0,17,13,26,56,0,0,9,15,18,42,98
SIKKIM,2004,Total Salaried,0,0,7,2,0,9,0,0,0,0,0,0,9
SIKKIM,2004,Total Self-employed,0,0,6,9,26,41,0,0,4,8,14,26,67
SIKKIM,2005,House Wife,0,0,0,0,0,0,0,10,7,1,2,20,20
SIKKIM,2005,Service (Government),0,0,2,0,0,2,0,0,0,0,0,0,2
SIKKIM,2005,Service (Private),0,2,0,0,0,2,0,0,3,0,0,3,5
SIKKIM,2005,Public Sector Undertaking,0,0,0,0,0,0,0,0,0,0,0,0,0
SIKKIM,2005,Student,2,2,1,0,0,5,2,3,0,0,0,5,10
SIKKIM,2005,Unemployed,0,2,2,0,0,4,0,0,0,0,0,0,4
SIKKIM,2005,Self-employed (Business activity),0,0,0,0,0,0,0,0,1,0,0,1,1
SIKKIM,2005,Professional Activity,0,0,0,0,0,0,0,0,0,0,0,0,0
SIKKIM,2005,Farming/Agriculture Activity,0,15,7,8,4,34,0,1,3,3,0,7,41
SIKKIM,2005,Others (Please Specify),0,3,5,3,0,11,0,0,2,1,3,6,17
SIKKIM,2005,Retired Person,0,0,0,0,0,0,0,0,0,0,0,0,0
SIKKIM,2005,Others (Please Specify),0,2,0,2,0,4,0,0,3,2,0,5,9
SIKKIM,2005,Total,2,26,17,13,4,62,2,14,19,7,5,47,109
SIKKIM,2005,Total Salaried,0,2,2,0,0,4,0,0,3,0,0,3,7
SIKKIM,2005,Total Self-employed,0,18,12,11,4,45,0,1,6,4,3,14,59
SIKKIM,2006,House Wife,0,0,0,0,0,0,0,0,10,1,4,15,15
SIKKIM,2006,Service (Government),0,4,0,0,0,4,0,0,0,0,0,0,4
SIKKIM,2006,Service (Private),0,6,5,2,0,13,0,0,1,0,0,1,14
SIKKIM,2006,Public Sector Undertaking,0,0,0,0,0,0,0,0,0,0,0,0,0
SIKKIM,2006,Student,4,20,0,0,0,24,3,10,2,0,0,15,39
SIKKIM,2006,Unemployed,0,0,10,8,0,18,0,0,0,0,0,0,18
SIKKIM,2006,Self-employed (Business activity),0,0,3,0,0,3,0,0,0,0,0,0,3
SIKKIM,2006,Professional Activity,0,0,0,0,0,0,0,0,0,0,0,0,0
SIKKIM,2006,Farming/Agriculture Activity,0,10,13,4,0,27,0,8,0,0,0,8,35
SIKKIM,2006,Others (Please Specify),0,9,0,0,0,9,0,8,0,0,0,8,17
SIKKIM,2006,Retired Person,0,0,0,0,0,0,0,0,0,0,0,0,0
SIKKIM,2006,Others (Please Specify),0,0,0,0,0,0,0,0,0,0,0,0,0
SIKKIM,2006,Total,4,49,31,14,0,98,3,26,13,1,4,47,145
SIKKIM,2006,Total Salaried,0,10,5,2,0,17,0,0,1,0,0,1,18
SIKKIM,2006,Total Self-employed,0,19,16,4,0,39,0,16,0,0,0,16,55
SIKKIM,2007,House Wife,0,0,0,0,0,0,0,6,0,0,0,6,6
SIKKIM,2007,Service (Government),0,0,0,0,0,0,0,0,0,0,0,0,0
SIKKIM,2007,Service (Private),0,3,3,3,0,9,0,3,0,0,0,3,12
SIKKIM,2007,Public Sector Undertaking,0,0,0,0,0,0,0,1,0,0,0,1,1
SIKKIM,2007,Student,2,3,0,0,0,5,0,0,0,0,0,0,5
SIKKIM,2007,Unemployed,0,9,0,0,0,9,0,2,0,0,0,2,11
SIKKIM,2007,Self-employed (Business activity),0,0,0,0,0,0,0,0,0,0,0,0,0
SIKKIM,2007,Professional Activity,0,0,0,0,0,0,0,0,0,0,0,0,0
SIKKIM,2007,Farming/Agriculture Activity,0,0,8,7,0,15,0,2,4,0,0,6,21
SIKKIM,2007,Others (Please Specify),3,18,5,2,2,30,1,3,0,3,0,7,37
SIKKIM,2007,Retired Person,0,0,0,0,0,0,0,0,0,0,0,0,0
SIKKIM,2007,Others (Please Specify),0,8,8,0,0,16,6,2,4,1,0,13,29
SIKKIM,2007,Total,5,41,24,12,2,84,7,19,8,4,0,38,122
SIKKIM,2007,Total Salaried,0,3,3,3,0,9,0,4,0,0,0,4,13
SIKKIM,2007,Total Self-employed,3,18,13,9,2,45,1,5,4,3,0,13,58
SIKKIM,2008,House Wife,0,0,0,0,0,0,0,6,0,1,0,7,7
SIKKIM,2008,Service (Government),0,0,0,0,0,0,0,0,0,0,0,0,0
SIKKIM,2008,Service (Private),0,8,4,6,2,20,0,2,4,2,0,8,28
SIKKIM,2008,Public Sector Undertaking,0,0,0,0,0,0,0,3,1,2,0,6,6
SIKKIM,2008,Student,2,6,0,0,0,8,0,4,0,0,0,4,12
SIKKIM,2008,Unemployed,0,16,11,6,3,36,0,3,6,4,0,13,49
SIKKIM,2008,Self-employed (Business activity),0,0,0,0,0,0,0,0,0,0,0,0,0
SIKKIM,2008,Professional Activity,0,0,0,0,0,0,0,0,0,0,0,0,0
SIKKIM,2008,Farming/Agriculture Activity,0,10,21,17,1,49,0,2,6,0,3,11,60
SIKKIM,2008,Others (Please Specify),0,20,20,16,4,60,0,0,0,0,0,0,60
SIKKIM,2008,Retired Person,0,0,0,0,0,0,0,0,0,0,0,0,0
SIKKIM,2008,Others (Please Specify),0,10,13,20,0,43,0,6,9,4,3,22,65
SIKKIM,2008,Total,2,70,69,65,10,216,0,26,26,13,6,71,287
SIKKIM,2008,Total Salaried,0,8,4,6,2,20,0,5,5,4,0,14,34
SIKKIM,2008,Total Self-employed,0,30,41,33,5,109,0,2,6,0,3,11,120
SIKKIM,2009,House Wife,0,0,0,0,0,0,0,5,3,0,0,8,8
SIKKIM,2009,Service (Government),0,5,2,0,0,7,0,3,2,0,0,5,12
SIKKIM,2009,Service (Private),0,7,3,2,1,13,0,7,4,4,3,18,31
SIKKIM,2009,Public Sector Undertaking,0,3,5,3,0,11,0,8,5,3,0,16,27
SIKKIM,2009,Student,0,5,0,0,0,5,0,2,0,0,0,2,7
SIKKIM,2009,Unemployed,0,2,3,5,2,12,0,11,7,5,0,23,35
SIKKIM,2009,Self-employed (Business activity),0,11,7,7,1,26,0,5,1,3,0,9,35
SIKKIM,2009,Professional Activity,0,7,0,2,0,9,0,6,3,5,0,14,23
SIKKIM,2009,Farming/Agriculture Activity,0,12,0,1,1,14,0,3,2,2,2,9,23
SIKKIM,2009,Others (Please Specify),1,3,2,1,1,8,1,3,1,0,0,5,13
SIKKIM,2009,Retired Person,0,0,0,2,2,4,0,0,0,1,2,3,7
SIKKIM,2009,Others (Please Specify),2,10,1,0,0,13,2,4,1,0,0,7,20
SIKKIM,2009,Total,3,65,23,23,8,122,3,57,29,23,7,119,241
SIKKIM,2009,Total Salaried,0,15,10,5,1,31,0,18,11,7,3,39,70
SIKKIM,2009,Total Self-employed,1,33,9,11,3,57,1,17,7,10,2,37,94
SIKKIM,2010,House Wife,0,0,0,0,0,0,0,2,1,1,1,5,5
SIKKIM,2010,Service (Government),0,17,11,1,0,29,0,1,5,0,0,6,35
SIKKIM,2010,Service (Private),9,23,17,1,2,52,0,1,2,0,0,3,55
SIKKIM,2010,Public Sector Undertaking,0,11,7,3,0,21,0,5,5,0,0,10,31
SIKKIM,2010,Student,0,2,0,0,0,2,0,1,0,0,0,1,3
SIKKIM,2010,Unemployed,11,13,12,7,2,45,0,2,5,0,0,7,52
SIKKIM,2010,Self-employed (Business activity),0,11,10,0,2,23,0,0,0,1,0,1,24
SIKKIM,2010,Professional Activity,0,9,9,0,3,21,0,0,0,1,0,1,22
SIKKIM,2010,Farming/Agriculture Activity,1,5,5,7,1,19,0,0,0,0,0,0,19
SIKKIM,2010,Others (Please Specify),0,7,0,0,0,7,0,0,1,0,0,1,8
SIKKIM,2010,Retired Person,0,0,0,0,3,3,0,0,0,0,2,2,5
SIKKIM,2010,Others (Please Specify),0,0,0,11,2,13,0,1,0,7,0,8,21
SIKKIM,2010,Total,21,98,71,30,15,235,0,13,19,10,3,45,280
SIKKIM,2010,Total Salaried,9,51,35,5,2,102,0,7,12,0,0,19,121
SIKKIM,2010,Total Self-employed,1,32,24,7,6,70,0,0,1,2,0,3,73
SIKKIM,2011,House Wife,0,0,0,0,0,0,0,7,3,2,0,12,12
SIKKIM,2011,Service (Government),0,9,2,1,0,12,0,2,0,0,0,2,14
SIKKIM,2011,Service (Private),0,11,5,4,0,20,0,10,0,1,0,11,31
SIKKIM,2011,Public Sector Undertaking,0,6,8,0,0,14,0,2,0,2,0,4,18
SIKKIM,2011,Student,0,2,1,0,0,3,0,4,0,0,0,4,7
SIKKIM,2011,Unemployed,0,3,9,5,0,17,0,1,3,5,0,9,26
SIKKIM,2011,Self-employed (Business activity),0,1,2,3,0,6,0,3,2,0,0,5,11
SIKKIM,2011,Professional Activity,0,0,1,0,0,1,0,0,2,2,0,4,5
SIKKIM,2011,Farming/Agriculture Activity,0,0,4,3,0,7,0,0,3,2,0,5,12
SIKKIM,2011,Others (Please Specify),0,4,1,5,0,10,0,0,7,3,0,10,20
SIKKIM,2011,Retired Person,0,0,0,2,0,2,0,0,0,0,0,0,2
SIKKIM,2011,Others (Please Specify),4,4,3,2,2,15,2,3,2,1,3,11,26
SIKKIM,2011,Total,4,40,36,25,2,107,2,32,22,18,3,77,184
SIKKIM,2011,Total Salaried,0,26,15,5,0,46,0,14,0,3,0,17,63
SIKKIM,2011,Total Self-employed,0,5,8,11,0,24,0,3,14,7,0,24,48
SIKKIM,2012,House Wife,0,0,0,0,0,0,0,9,7,4,2,22,22
SIKKIM,2012,Service (Government),0,7,7,3,0,17,0,5,0,1,0,6,23
SIKKIM,2012,Service (Private),0,5,5,4,0,14,0,4,3,1,0,8,22
SIKKIM,2012,Public Sector Undertaking,0,2,2,4,0,8,0,0,2,0,0,2,10
SIKKIM,2012,Student,5,2,0,0,0,7,6,4,3,0,0,13,20
SIKKIM,2012,Unemployed,0,5,0,0,0,5,0,6,8,0,0,14,19
SIKKIM,2012,Self-employed (Business activity),0,5,4,3,3,15,0,0,0,0,0,0,15
SIKKIM,2012,Professional Activity,0,2,2,5,2,11,0,0,0,0,0,0,11
SIKKIM,2012,Farming/Agriculture Activity,0,5,4,1,0,10,0,5,2,0,2,9,19
SIKKIM,2012,Others (Please Specify),0,2,2,0,5,9,0,2,5,3,1,11,20
SIKKIM,2012,Retired Person,0,0,0,0,0,0,0,0,0,0,0,0,0
SIKKIM,2012,Others (Please Specify),0,0,0,0,0,0,0,0,0,0,0,0,0
SIKKIM,2012,Total,5,35,26,20,10,96,6,35,30,9,5,85,181
SIKKIM,2012,Total Salaried,0,14,14,11,0,39,0,9,5,2,0,16,55
SIKKIM,2012,Total Self-employed,0,14,12,9,10,45,0,7,7,3,3,20,65
TAMIL NADU,2001,House Wife,0,0,0,0,0,0,0,822,632,226,75,1755,1755
TAMIL NADU,2001,Service (Government),0,21,63,79,3,166,0,23,33,10,1,67,233
TAMIL NADU,2001,Service (Private),2,221,375,207,45,850,3,89,89,48,5,234,1084
TAMIL NADU,2001,Public Sector Undertaking,0,75,78,50,4,207,0,45,42,9,2,98,305
TAMIL NADU,2001,Student,46,180,10,0,0,236,39,116,7,6,0,168,404
TAMIL NADU,2001,Unemployed,6,333,540,402,49,1330,21,178,238,76,15,528,1858
TAMIL NADU,2001,Self-employed (Business activity),2,134,309,164,47,656,2,12,11,31,1,57,713
TAMIL NADU,2001,Professional Activity,3,83,141,58,9,294,0,14,27,23,0,64,358
TAMIL NADU,2001,Farming/Agriculture Activity,5,304,253,170,94,826,7,63,50,24,15,159,985
TAMIL NADU,2001,Others (Please Specify),18,492,508,313,135,1466,8,216,172,122,55,573,2039
TAMIL NADU,2001,Retired Person,0,0,0,9,35,44,0,0,0,0,6,6,50
TAMIL NADU,2001,Others (Please Specify),64,272,405,221,91,1053,65,124,143,83,38,453,1506
TAMIL NADU,2001,Total,146,2115,2682,1673,512,7128,145,1702,1444,658,213,4162,11290
TAMIL NADU,2001,Total Salaried,2,317,516,336,52,1223,3,157,164,67,8,399,1622
TAMIL NADU,2001,Total Self-employed,28,1013,1211,705,285,3242,17,305,260,200,71,853,4095
TAMIL NADU,2002,House Wife,0,0,0,0,0,0,0,951,741,343,103,2138,2138
TAMIL NADU,2002,Service (Government),0,77,79,62,6,224,0,41,51,32,3,127,351
TAMIL NADU,2002,Service (Private),0,226,378,206,18,828,4,147,67,48,21,287,1115
TAMIL NADU,2002,Public Sector Undertaking,0,68,105,50,7,230,0,57,32,7,0,96,326
TAMIL NADU,2002,Student,42,176,41,0,0,259,37,158,20,0,0,215,474
TAMIL NADU,2002,Unemployed,8,342,381,277,58,1066,14,125,100,48,9,296,1362
TAMIL NADU,2002,Self-employed (Business activity),0,160,298,288,29,775,0,19,24,17,1,61,836
TAMIL NADU,2002,Professional Activity,0,35,65,24,3,127,0,8,7,3,0,18,145
TAMIL NADU,2002,Farming/Agriculture Activity,1,371,420,370,95,1257,5,99,54,31,9,198,1455
TAMIL NADU,2002,Others (Please Specify),12,310,452,270,156,1200,48,159,100,86,53,446,1646
TAMIL NADU,2002,Retired Person,0,0,0,3,32,35,0,0,0,6,13,19,54
TAMIL NADU,2002,Others (Please Specify),36,228,333,246,139,982,37,95,122,86,20,360,1342
TAMIL NADU,2002,Total,99,1993,2552,1796,543,6983,145,1859,1318,707,232,4261,11244
TAMIL NADU,2002,Total Salaried,0,371,562,318,31,1282,4,245,150,87,24,510,1792
TAMIL NADU,2002,Total Self-employed,13,876,1235,952,283,3359,53,285,185,137,63,723,4082
TAMIL NADU,2003,House Wife,0,0,0,0,0,0,0,779,777,409,103,2068,2068
TAMIL NADU,2003,Service (Government),0,36,74,74,5,189,0,31,22,24,0,77,266
TAMIL NADU,2003,Service (Private),0,208,321,223,42,794,0,179,155,93,10,437,1231
TAMIL NADU,2003,Public Sector Undertaking,0,78,141,78,11,308,0,32,44,24,1,101,409
TAMIL NADU,2003,Student,60,170,17,0,0,247,79,136,4,0,0,219,466
TAMIL NADU,2003,Unemployed,11,490,524,298,145,1468,7,200,147,123,29,506,1974
TAMIL NADU,2003,Self-employed (Business activity),1,155,258,240,46,700,0,38,38,23,7,106,806
TAMIL NADU,2003,Professional Activity,0,127,159,95,36,417,0,20,23,33,3,79,496
TAMIL NADU,2003,Farming/Agriculture Activity,1,244,300,200,87,832,5,101,71,27,16,220,1052
TAMIL NADU,2003,Others (Please Specify),24,325,461,415,157,1382,25,110,118,74,50,377,1759
TAMIL NADU,2003,Retired Person,0,0,0,15,52,67,0,0,0,4,13,17,84
TAMIL NADU,2003,Others (Please Specify),40,132,263,203,112,750,50,118,178,92,73,511,1261
TAMIL NADU,2003,Total,137,1965,2518,1841,693,7154,166,1744,1577,926,305,4718,11872
TAMIL NADU,2003,Total Salaried,0,322,536,375,58,1291,0,242,221,141,11,615,1906
TAMIL NADU,2003,Total Self-employed,26,851,1178,950,326,3331,30,269,250,157,76,782,4113
TAMIL NADU,2004,House Wife,0,0,0,0,0,0,0,698,766,485,163,2112,2112
TAMIL NADU,2004,Service (Government),0,34,67,54,0,155,0,3,18,23,0,44,199
TAMIL NADU,2004,Service (Private),0,215,301,268,48,832,3,83,102,57,6,251,1083
TAMIL NADU,2004,Public Sector Undertaking,0,60,94,63,10,227,0,13,30,23,7,73,300
TAMIL NADU,2004,Student,74,158,15,0,0,247,55,163,7,1,0,226,473
TAMIL NADU,2004,Unemployed,7,358,435,350,91,1241,3,207,137,93,18,458,1699
TAMIL NADU,2004,Self-employed (Business activity),3,180,294,271,64,812,0,23,18,17,0,58,870
TAMIL NADU,2004,Professional Activity,2,77,102,75,19,275,0,26,22,8,1,57,332
TAMIL NADU,2004,Farming/Agriculture Activity,7,318,457,329,186,1297,13,124,98,45,22,302,1599
TAMIL NADU,2004,Others (Please Specify),6,372,497,360,191,1426,6,221,163,142,38,570,1996
TAMIL NADU,2004,Retired Person,0,0,0,5,84,89,0,0,0,2,15,17,106
TAMIL NADU,2004,Others (Please Specify),91,248,491,395,120,1345,96,253,194,125,57,725,2070
TAMIL NADU,2004,Total,190,2020,2753,2170,813,7946,176,1814,1555,1021,327,4893,12839
TAMIL NADU,2004,Total Salaried,0,309,462,385,58,1214,3,99,150,103,13,368,1582
TAMIL NADU,2004,Total Self-employed,18,947,1350,1035,460,3810,19,394,301,212,61,987,4797
TAMIL NADU,2005,House Wife,0,0,0,0,0,0,0,647,737,493,181,2058,2058
TAMIL NADU,2005,Service (Government),0,35,63,58,3,159,0,5,16,11,0,32,191
TAMIL NADU,2005,Service (Private),0,259,357,280,51,947,3,115,93,33,5,249,1196
TAMIL NADU,2005,Public Sector Undertaking,0,48,88,59,10,205,0,14,30,23,8,75,280
TAMIL NADU,2005,Student,73,173,15,0,0,261,59,203,7,1,0,270,531
TAMIL NADU,2005,Unemployed,7,390,426,267,84,1174,5,249,141,76,40,511,1685
TAMIL NADU,2005,Self-employed (Business activity),0,195,301,243,54,793,0,42,28,37,18,125,918
TAMIL NADU,2005,Professional Activity,0,72,93,73,8,246,0,21,13,4,2,40,286
TAMIL NADU,2005,Farming/Agriculture Activity,11,217,369,263,142,1002,5,102,73,40,33,253,1255
TAMIL NADU,2005,Others (Please Specify),4,351,524,368,183,1430,6,193,126,120,36,481,1911
TAMIL NADU,2005,Retired Person,0,0,0,10,84,94,0,0,0,0,8,8,102
TAMIL NADU,2005,Others (Please Specify),52,226,471,346,101,1196,94,144,101,85,43,467,1663
TAMIL NADU,2005,Total,147,1966,2707,1967,720,7507,172,1735,1365,923,374,4569,12076
TAMIL NADU,2005,Total Salaried,0,342,508,397,64,1311,3,134,139,67,13,356,1667
TAMIL NADU,2005,Total Self-employed,15,835,1287,947,387,3471,11,358,240,201,89,899,4370
TAMIL NADU,2006,House Wife,0,0,0,0,0,0,0,830,947,451,126,2354,2354
TAMIL NADU,2006,Service (Government),0,20,89,45,1,155,0,10,8,7,5,30,185
TAMIL NADU,2006,Service (Private),0,279,449,291,73,1092,0,462,101,58,7,628,1720
TAMIL NADU,2006,Public Sector Undertaking,0,49,107,60,29,245,0,15,11,59,1,86,331
TAMIL NADU,2006,Student,26,65,8,0,0,99,36,84,7,0,0,127,226
TAMIL NADU,2006,Unemployed,0,364,116,170,96,746,0,240,122,86,33,481,1227
TAMIL NADU,2006,Self-employed (Business activity),0,135,779,174,30,1118,0,8,76,3,0,87,1205
TAMIL NADU,2006,Professional Activity,0,0,0,0,0,0,0,0,0,0,0,0,0
TAMIL NADU,2006,Farming/Agriculture Activity,0,78,147,82,35,342,0,23,40,19,2,84,426
TAMIL NADU,2006,Others (Please Specify),0,757,700,822,281,2560,0,224,180,107,70,581,3141
TAMIL NADU,2006,Retired Person,0,0,0,10,77,87,0,0,0,0,15,15,102
TAMIL NADU,2006,Others (Please Specify),0,249,402,281,133,1065,44,99,129,80,47,399,1464
TAMIL NADU,2006,Total,26,1996,2797,1935,755,7509,80,1995,1621,870,306,4872,12381
TAMIL NADU,2006,Total Salaried,0,348,645,396,103,1492,0,487,120,124,13,744,2236
TAMIL NADU,2006,Total Self-employed,0,970,1626,1078,346,4020,0,255,296,129,72,752,4772
TAMIL NADU,2007,House Wife,0,0,0,0,0,0,0,873,996,474,133,2476,2476
TAMIL NADU,2007,Service (Government),0,23,103,52,1,179,0,10,9,8,5,32,211
TAMIL NADU,2007,Service (Private),0,323,519,337,84,1263,0,486,106,61,7,660,1923
TAMIL NADU,2007,Public Sector Undertaking,0,57,124,69,33,283,0,19,11,59,1,90,373
TAMIL NADU,2007,Student,30,76,6,1,2,115,38,89,7,0,0,134,249
TAMIL NADU,2007,Unemployed,0,421,134,197,111,863,0,253,128,90,35,506,1369
TAMIL NADU,2007,Self-employed (Business activity),0,156,901,201,35,1293,0,9,80,3,0,92,1385
TAMIL NADU,2007,Professional Activity,0,0,0,0,0,0,0,0,0,0,0,0,0
TAMIL NADU,2007,Farming/Agriculture Activity,0,90,170,95,41,396,0,25,42,19,2,88,484
TAMIL NADU,2007,Others (Please Specify),0,876,810,951,325,2962,0,235,189,113,74,611,3573
TAMIL NADU,2007,Retired Person,0,0,0,12,89,101,0,0,0,0,16,16,117
TAMIL NADU,2007,Others (Please Specify),0,289,470,322,151,1232,45,103,134,91,46,419,1651
TAMIL NADU,2007,Total,30,2311,3237,2237,872,8687,83,2102,1702,918,319,5124,13811
TAMIL NADU,2007,Total Salaried,0,403,746,458,118,1725,0,515,126,128,13,782,2507
TAMIL NADU,2007,Total Self-employed,0,1122,1881,1247,401,4651,0,269,311,135,76,791,5442
TAMIL NADU,2008,House Wife,0,0,0,0,0,0,0,841,986,470,133,2430,2430
TAMIL NADU,2008,Service (Government),0,31,153,83,2,269,0,20,11,9,6,46,315
TAMIL NADU,2008,Service (Private),0,357,520,385,71,1333,0,476,120,84,8,688,2021
TAMIL NADU,2008,Public Sector Undertaking,0,75,132,71,3,281,0,31,15,54,7,107,388
TAMIL NADU,2008,Student,30,84,0,0,0,114,43,97,4,0,0,144,258
TAMIL NADU,2008,Unemployed,0,431,134,197,111,873,0,263,145,75,10,493,1366
TAMIL NADU,2008,Self-employed (Business activity),0,196,854,201,35,1286,0,29,95,13,4,141,1427
TAMIL NADU,2008,Professional Activity,0,110,170,95,41,416,0,55,49,28,10,142,558
TAMIL NADU,2008,Farming/Agriculture Activity,0,95,170,95,40,400,0,40,46,24,2,112,512
TAMIL NADU,2008,Others (Please Specify),0,886,710,850,325,2771,0,258,175,123,84,640,3411
TAMIL NADU,2008,Retired Person,0,0,0,12,89,101,0,0,0,0,16,16,117
TAMIL NADU,2008,Others (Please Specify),0,298,422,325,154,1199,40,105,135,84,59,423,1622
TAMIL NADU,2008,Total,30,2563,3265,2314,871,9043,83,2215,1781,964,339,5382,14425
TAMIL NADU,2008,Total Salaried,0,463,805,539,76,1883,0,527,146,147,21,841,2724
TAMIL NADU,2008,Total Self-employed,0,1287,1904,1241,441,4873,0,382,365,188,100,1035,5908
TAMIL NADU,2009,House Wife,0,0,0,0,0,0,0,987,1017,492,267,2763,2763
TAMIL NADU,2009,Service (Government),0,7,86,104,11,208,0,8,26,11,0,45,253
TAMIL NADU,2009,Service (Private),0,393,604,308,54,1359,0,138,125,98,19,380,1739
TAMIL NADU,2009,Public Sector Undertaking,0,152,136,48,9,345,0,4,12,11,0,27,372
TAMIL NADU,2009,Student,83,174,0,0,0,257,68,131,0,0,0,199,456
TAMIL NADU,2009,Unemployed,3,359,617,446,137,1562,6,171,83,140,24,424,1986
TAMIL NADU,2009,Self-employed (Business activity),0,152,249,209,99,709,2,34,53,22,11,122,831
TAMIL NADU,2009,Professional Activity,0,97,84,23,38,242,0,38,23,16,9,86,328
TAMIL NADU,2009,Farming/Agriculture Activity,5,195,306,244,106,856,7,86,56,36,19,204,1060
TAMIL NADU,2009,Others (Please Specify),27,485,645,437,239,1833,26,197,215,82,49,569,2402
TAMIL NADU,2009,Retired Person,0,0,0,84,98,182,0,0,0,14,18,32,214
TAMIL NADU,2009,Others (Please Specify),18,347,447,346,239,1397,35,283,159,97,49,623,2020
TAMIL NADU,2009,Total,136,2361,3174,2249,1030,8950,144,2077,1769,1019,465,5474,14424
TAMIL NADU,2009,Total Salaried,0,552,826,460,74,1912,0,150,163,120,19,452,2364
TAMIL NADU,2009,Total Self-employed,32,929,1284,913,482,3640,35,355,347,156,88,981,4621
TAMIL NADU,2010,House Wife,0,0,0,0,0,0,3,935,984,520,225,2667,2667
TAMIL NADU,2010,Service (Government),0,21,40,61,0,122,0,18,23,16,1,58,180
TAMIL NADU,2010,Service (Private),1,383,609,384,53,1430,0,152,84,67,2,305,1735
TAMIL NADU,2010,Public Sector Undertaking,0,53,122,78,11,264,0,28,37,12,0,77,341
TAMIL NADU,2010,Student,99,254,6,0,0,359,65,208,5,0,0,278,637
TAMIL NADU,2010,Unemployed,3,418,577,360,169,1527,3,289,136,90,27,545,2072
TAMIL NADU,2010,Self-employed (Business activity),0,212,314,273,62,861,6,85,77,32,19,219,1080
TAMIL NADU,2010,Professional Activity,0,53,86,50,23,212,5,16,18,10,2,51,263
TAMIL NADU,2010,Farming/Agriculture Activity,13,137,131,103,58,442,0,65,25,6,3,99,541
TAMIL NADU,2010,Others (Please Specify),60,695,590,376,229,1950,19,296,262,113,77,767,2717
TAMIL NADU,2010,Retired Person,0,0,0,35,77,112,0,0,0,5,15,20,132
TAMIL NADU,2010,Others (Please Specify),23,740,1037,859,614,3273,84,412,143,158,126,923,4196
TAMIL NADU,2010,Total,199,2966,3512,2579,1296,10552,185,2504,1794,1029,497,6009,16561
TAMIL NADU,2010,Total Salaried,1,457,771,523,64,1816,0,198,144,95,3,440,2256
TAMIL NADU,2010,Total Self-employed,73,1097,1121,802,372,3465,30,462,382,161,101,1136,4601
TAMIL NADU,2011,House Wife,0,0,0,0,0,0,5,915,888,407,218,2433,2433
TAMIL NADU,2011,Service (Government),0,11,52,53,4,120,0,11,18,5,3,37,157
TAMIL NADU,2011,Service (Private),0,287,449,257,45,1038,1,96,81,48,1,227,1265
TAMIL NADU,2011,Public Sector Undertaking,1,38,50,34,7,130,0,31,16,3,1,51,181
TAMIL NADU,2011,Student,95,324,61,0,0,480,78,273,18,0,0,369,849
TAMIL NADU,2011,Unemployed,14,408,596,599,146,1763,15,239,114,85,18,471,2234
TAMIL NADU,2011,Self-employed (Business activity),0,187,281,203,58,729,0,11,30,7,1,49,778
TAMIL NADU,2011,Professional Activity,0,69,144,81,33,327,0,18,23,28,25,94,421
TAMIL NADU,2011,Farming/Agriculture Activity,3,99,161,157,62,482,2,61,43,23,12,141,623
TAMIL NADU,2011,Others (Please Specify),10,472,734,528,220,1964,11,199,169,98,33,510,2474
TAMIL NADU,2011,Retired Person,0,0,6,24,51,81,0,0,0,5,4,9,90
TAMIL NADU,2011,Others (Please Specify),36,841,1443,469,379,3168,84,565,426,117,98,1290,4458
TAMIL NADU,2011,Total,159,2736,3977,2405,1005,10282,196,2419,1826,826,414,5681,15963
TAMIL NADU,2011,Total Salaried,1,336,551,344,56,1288,1,138,115,56,5,315,1603
TAMIL NADU,2011,Total Self-employed,13,827,1320,969,373,3502,13,289,265,156,71,794,4296
TAMIL NADU,2012,House Wife,0,0,0,0,0,0,3,1097,1031,575,205,2911,2911
TAMIL NADU,2012,Service (Government),0,39,101,93,4,237,0,17,22,8,0,47,284
TAMIL NADU,2012,Service (Private),0,202,381,244,34,861,0,85,72,25,4,186,1047
TAMIL NADU,2012,Public Sector Undertaking,0,41,76,67,7,191,0,22,27,17,1,67,258
TAMIL NADU,2012,Student,101,274,12,0,0,387,95,294,19,0,0,408,795
TAMIL NADU,2012,Unemployed,5,316,425,594,177,1517,4,175,141,83,18,421,1938
TAMIL NADU,2012,Self-employed (Business activity),0,164,262,226,78,730,0,20,29,19,3,71,801
TAMIL NADU,2012,Professional Activity,0,40,40,46,19,145,0,31,32,10,2,75,220
TAMIL NADU,2012,Farming/Agriculture Activity,0,68,137,123,81,409,0,31,32,22,5,90,499
TAMIL NADU,2012,Others (Please Specify),10,626,891,638,281,2446,23,241,174,108,40,586,3032
TAMIL NADU,2012,Retired Person,0,0,3,13,46,62,0,0,0,0,9,9,71
TAMIL NADU,2012,Others (Please Specify),33,993,1568,607,562,3763,57,534,198,247,272,1308,5071
TAMIL NADU,2012,Total,149,2763,3896,2651,1289,10748,182,2547,1777,1114,559,6179,16927
TAMIL NADU,2012,Total Salaried,0,282,558,404,45,1289,0,124,121,50,5,300,1589
TAMIL NADU,2012,Total Self-employed,10,898,1330,1033,459,3730,23,323,267,159,50,822,4552
TRIPURA,2001,House Wife,0,0,0,0,0,0,0,20,40,8,3,71,71
TRIPURA,2001,Service (Government),0,0,0,0,0,0,0,0,0,0,0,0,0
TRIPURA,2001,Service (Private),0,2,10,1,0,13,0,0,0,2,0,2,15
TRIPURA,2001,Public Sector Undertaking,0,0,0,0,0,0,0,3,0,0,0,3,3
TRIPURA,2001,Student,10,18,9,0,0,37,5,10,18,0,0,33,70
TRIPURA,2001,Unemployed,2,20,14,2,2,40,2,10,1,1,0,14,54
TRIPURA,2001,Self-employed (Business activity),0,9,30,10,0,49,0,2,0,0,0,2,51
TRIPURA,2001,Professional Activity,0,4,4,1,0,9,0,2,2,0,0,4,13
TRIPURA,2001,Farming/Agriculture Activity,0,10,26,3,2,41,0,0,0,0,0,0,41
TRIPURA,2001,Others (Please Specify),0,16,25,6,3,50,0,10,1,4,4,19,69
TRIPURA,2001,Retired Person,0,0,0,0,0,0,0,0,0,0,0,0,0
TRIPURA,2001,Others (Please Specify),6,52,76,64,26,224,5,51,125,47,15,243,467
TRIPURA,2001,Total,18,131,194,87,33,463,12,108,187,62,22,391,854
TRIPURA,2001,Total Salaried,0,2,10,1,0,13,0,3,0,2,0,5,18
TRIPURA,2001,Total Self-employed,0,39,85,20,5,149,0,14,3,4,4,25,174
TRIPURA,2002,House Wife,0,0,0,0,0,0,0,54,39,6,5,104,104
TRIPURA,2002,Service (Government),0,5,10,8,0,23,0,5,4,2,0,11,34
TRIPURA,2002,Service (Private),0,10,8,5,0,23,0,4,5,3,0,12,35
TRIPURA,2002,Public Sector Undertaking,0,6,14,3,0,23,0,3,4,2,0,9,32
TRIPURA,2002,Student,4,15,0,0,0,19,4,9,6,0,0,19,38
TRIPURA,2002,Unemployed,1,22,21,9,0,53,2,2,1,0,0,5,58
TRIPURA,2002,Self-employed (Business activity),0,15,13,13,5,46,0,0,0,0,0,0,46
TRIPURA,2002,Professional Activity,0,10,16,10,4,40,0,0,0,0,0,0,40
TRIPURA,2002,Farming/Agriculture Activity,0,8,12,7,0,27,1,3,4,3,3,14,41
TRIPURA,2002,Others (Please Specify),4,37,37,22,11,111,2,11,6,5,1,25,136
TRIPURA,2002,Retired Person,0,0,0,2,2,4,0,0,0,0,0,0,4
TRIPURA,2002,Others (Please Specify),4,45,48,23,4,124,5,36,23,17,6,87,211
TRIPURA,2002,Total,13,173,179,102,26,493,14,127,92,38,15,286,779
TRIPURA,2002,Total Salaried,0,21,32,16,0,69,0,12,13,7,0,32,101
TRIPURA,2002,Total Self-employed,4,70,78,52,20,224,3,14,10,8,4,39,263
TRIPURA,2003,House Wife,0,0,0,0,0,0,0,52,51,17,0,120,120
TRIPURA,2003,Service (Government),0,12,4,3,0,19,0,3,3,3,0,9,28
TRIPURA,2003,Service (Private),0,14,6,3,0,23,0,2,2,0,0,4,27
TRIPURA,2003,Public Sector Undertaking,0,17,11,7,0,35,0,4,4,2,0,10,45
TRIPURA,2003,Student,7,59,70,21,0,157,2,29,31,11,0,73,230
TRIPURA,2003,Unemployed,0,74,85,49,0,208,3,35,40,24,0,102,310
TRIPURA,2003,Self-employed (Business activity),0,4,2,1,0,7,0,4,3,2,0,9,16
TRIPURA,2003,Professional Activity,0,0,0,1,0,1,0,3,2,1,0,6,7
TRIPURA,2003,Farming/Agriculture Activity,0,0,0,0,0,0,0,2,1,1,0,4,4
TRIPURA,2003,Others (Please Specify),0,11,7,4,0,22,0,4,4,0,0,8,30
TRIPURA,2003,Retired Person,0,0,0,0,4,4,0,0,0,0,4,4,8
TRIPURA,2003,Others (Please Specify),0,7,3,2,0,12,3,2,1,1,0,7,19
TRIPURA,2003,Total,7,198,188,91,4,488,8,140,142,62,4,356,844
TRIPURA,2003,Total Salaried,0,43,21,13,0,77,0,9,9,5,0,23,100
TRIPURA,2003,Total Self-employed,0,15,9,6,0,30,0,13,10,4,0,27,57
TRIPURA,2004,House Wife,0,0,0,0,0,0,4,85,51,7,5,152,152
TRIPURA,2004,Service (Government),0,3,5,0,0,8,0,0,3,0,0,3,11
TRIPURA,2004,Service (Private),0,2,4,3,2,11,0,0,3,0,0,3,14
TRIPURA,2004,Public Sector Undertaking,0,0,2,2,0,4,0,0,0,0,0,0,4
TRIPURA,2004,Student,4,42,0,0,0,46,18,46,0,0,0,64,110
TRIPURA,2004,Unemployed,0,73,57,39,5,174,0,41,33,8,0,82,256
TRIPURA,2004,Self-employed (Business activity),0,12,11,5,3,31,0,2,0,0,0,2,33
TRIPURA,2004,Professional Activity,0,16,11,4,0,31,0,0,0,0,0,0,31
TRIPURA,2004,Farming/Agriculture Activity,0,5,7,2,1,15,0,0,0,0,0,0,15
TRIPURA,2004,Others (Please Specify),0,22,16,6,2,46,0,3,7,1,2,13,59
TRIPURA,2004,Retired Person,0,0,0,0,0,0,0,0,0,0,0,0,0
TRIPURA,2004,Others (Please Specify),1,29,21,16,0,67,0,6,8,4,0,18,85
TRIPURA,2004,Total,5,204,134,77,13,433,22,183,105,20,7,337,770
TRIPURA,2004,Total Salaried,0,5,11,5,2,23,0,0,6,0,0,6,29
TRIPURA,2004,Total Self-employed,0,55,45,17,6,123,0,5,7,1,2,15,138
TRIPURA,2005,House Wife,0,0,0,0,0,0,0,47,38,15,4,104,104
TRIPURA,2005,Service (Government),0,3,13,7,0,23,0,5,3,2,0,10,33
TRIPURA,2005,Service (Private),0,8,15,11,0,34,0,6,5,3,0,14,48
TRIPURA,2005,Public Sector Undertaking,0,8,9,5,0,22,0,3,4,5,0,12,34
TRIPURA,2005,Student,6,22,1,0,0,29,8,28,4,0,0,40,69
TRIPURA,2005,Unemployed,0,33,25,14,0,72,0,11,3,2,2,18,90
TRIPURA,2005,Self-employed (Business activity),0,34,19,3,6,62,0,0,0,0,0,0,62
TRIPURA,2005,Professional Activity,0,8,15,13,5,41,0,0,0,0,0,0,41
TRIPURA,2005,Farming/Agriculture Activity,0,14,6,6,3,29,0,0,0,0,0,0,29
TRIPURA,2005,Others (Please Specify),3,10,9,11,7,40,5,29,16,5,2,57,97
TRIPURA,2005,Retired Person,0,0,0,7,7,14,0,0,0,0,0,0,14
TRIPURA,2005,Others (Please Specify),1,9,15,6,4,35,3,45,5,6,0,59,94
TRIPURA,2005,Total,10,149,127,83,32,401,16,174,78,38,8,314,715
TRIPURA,2005,Total Salaried,0,19,37,23,0,79,0,14,12,10,0,36,115
TRIPURA,2005,Total Self-employed,3,66,49,33,21,172,5,29,16,5,2,57,229
TRIPURA,2006,House Wife,0,0,0,0,0,0,0,72,48,10,3,133,133
TRIPURA,2006,Service (Government),0,1,5,4,0,10,0,0,0,0,0,0,10
TRIPURA,2006,Service (Private),0,2,3,2,0,7,0,0,0,0,0,0,7
TRIPURA,2006,Public Sector Undertaking,0,2,2,2,0,6,0,0,0,0,0,0,6
TRIPURA,2006,Student,4,27,12,0,0,43,7,31,3,0,0,41,84
TRIPURA,2006,Unemployed,0,19,23,3,0,45,0,13,4,0,0,17,62
TRIPURA,2006,Self-employed (Business activity),0,2,7,5,4,18,0,0,0,0,0,0,18
TRIPURA,2006,Professional Activity,0,3,4,0,0,7,0,0,0,0,0,0,7
TRIPURA,2006,Farming/Agriculture Activity,0,0,5,2,0,7,0,0,0,0,0,0,7
TRIPURA,2006,Others (Please Specify),2,7,22,10,6,47,0,3,2,1,0,6,53
TRIPURA,2006,Retired Person,0,0,0,0,0,0,0,0,0,0,0,0,0
TRIPURA,2006,Others (Please Specify),5,82,84,50,17,238,4,49,61,23,3,140,378
TRIPURA,2006,Total,11,145,167,78,27,428,11,168,118,34,6,337,765
TRIPURA,2006,Total Salaried,0,5,10,8,0,23,0,0,0,0,0,0,23
TRIPURA,2006,Total Self-employed,2,12,38,17,10,79,0,3,2,1,0,6,85
TRIPURA,2007,House Wife,0,0,0,0,0,0,0,49,31,9,4,93,93
TRIPURA,2007,Service (Government),0,3,23,2,0,28,0,3,2,0,0,5,33
TRIPURA,2007,Service (Private),0,2,6,0,0,8,0,0,0,0,0,0,8
TRIPURA,2007,Public Sector Undertaking,0,0,0,0,0,0,0,0,0,0,0,0,0
TRIPURA,2007,Student,14,22,0,0,0,36,16,18,0,0,0,34,70
TRIPURA,2007,Unemployed,0,12,20,9,0,41,0,2,1,0,0,3,44
TRIPURA,2007,Self-employed (Business activity),0,14,28,18,3,63,0,0,0,0,0,0,63
TRIPURA,2007,Professional Activity,0,0,0,0,0,0,0,0,0,0,0,0,0
TRIPURA,2007,Farming/Agriculture Activity,0,0,0,0,0,0,0,0,0,0,0,0,0
TRIPURA,2007,Others (Please Specify),8,58,43,51,7,167,0,30,44,26,1,101,268
TRIPURA,2007,Retired Person,0,1,0,1,0,2,0,0,0,0,0,0,2
TRIPURA,2007,Others (Please Specify),4,36,21,13,0,74,6,14,22,6,2,50,124
TRIPURA,2007,Total,26,148,141,94,10,419,22,116,100,41,7,286,705
TRIPURA,2007,Total Salaried,0,5,29,2,0,36,0,3,2,0,0,5,41
TRIPURA,2007,Total Self-employed,8,72,71,69,10,230,0,30,44,26,1,101,331
TRIPURA,2008,House Wife,0,0,0,0,0,0,0,56,43,29,2,130,130
TRIPURA,2008,Service (Government),0,3,9,3,0,15,0,0,0,0,0,0,15
TRIPURA,2008,Service (Private),0,4,8,2,0,14,0,0,7,4,0,11,25
TRIPURA,2008,Public Sector Undertaking,0,0,0,2,0,2,0,0,0,0,0,0,2
TRIPURA,2008,Student,9,43,0,0,0,52,13,26,0,0,0,39,91
TRIPURA,2008,Unemployed,0,32,61,27,13,133,0,13,5,0,0,18,151
TRIPURA,2008,Self-employed (Business activity),0,7,8,3,0,18,0,0,0,0,0,0,18
TRIPURA,2008,Professional Activity,0,0,0,0,0,0,0,0,0,0,0,0,0
TRIPURA,2008,Farming/Agriculture Activity,0,10,20,15,0,45,0,0,5,0,0,5,50
TRIPURA,2008,Others (Please Specify),0,25,38,17,12,92,0,19,10,5,0,34,126
TRIPURA,2008,Retired Person,0,0,0,0,0,0,0,0,0,0,0,0,0
TRIPURA,2008,Others (Please Specify),0,28,23,20,0,71,1,29,26,13,4,73,144
TRIPURA,2008,Total,9,152,167,89,25,442,14,143,96,51,6,310,752
TRIPURA,2008,Total Salaried,0,7,17,7,0,31,0,0,7,4,0,11,42
TRIPURA,2008,Total Self-employed,0,42,66,35,12,155,0,19,15,5,0,39,194
TRIPURA,2009,House Wife,0,0,0,0,0,0,0,93,48,26,9,176,176
TRIPURA,2009,Service (Government),0,5,9,5,0,19,0,0,0,0,0,0,19
TRIPURA,2009,Service (Private),0,9,5,2,3,19,0,0,0,0,0,0,19
TRIPURA,2009,Public Sector Undertaking,0,0,2,0,0,2,0,0,0,0,0,0,2
TRIPURA,2009,Student,8,39,0,0,0,47,8,34,0,0,0,42,89
TRIPURA,2009,Unemployed,0,22,3,0,0,25,0,1,3,0,0,4,29
TRIPURA,2009,Self-employed (Business activity),0,15,38,18,0,71,0,4,0,0,0,4,75
TRIPURA,2009,Professional Activity,0,5,10,4,1,20,0,0,0,0,0,0,20
TRIPURA,2009,Farming/Agriculture Activity,0,11,16,13,5,45,0,0,0,0,0,0,45
TRIPURA,2009,Others (Please Specify),0,49,56,51,12,168,1,25,9,0,0,35,203
TRIPURA,2009,Retired Person,0,0,0,0,0,0,0,0,0,0,0,0,0
TRIPURA,2009,Others (Please Specify),1,32,15,2,1,51,1,1,2,5,1,10,61
TRIPURA,2009,Total,9,187,154,95,22,467,10,158,62,31,10,271,738
TRIPURA,2009,Total Salaried,0,14,16,7,3,40,0,0,0,0,0,0,40
TRIPURA,2009,Total Self-employed,0,80,120,86,18,304,1,29,9,0,0,39,343
TRIPURA,2010,House Wife,0,0,0,0,0,0,1,72,64,34,23,194,194
TRIPURA,2010,Service (Government),0,2,8,8,0,18,0,0,0,1,0,1,19
TRIPURA,2010,Service (Private),0,14,5,6,5,30,0,0,0,0,0,0,30
TRIPURA,2010,Public Sector Undertaking,0,0,0,0,0,0,0,0,0,0,0,0,0
TRIPURA,2010,Student,15,57,2,0,0,74,14,16,2,0,0,32,106
TRIPURA,2010,Unemployed,0,4,3,14,14,35,0,0,0,0,6,6,41
TRIPURA,2010,Self-employed (Business activity),0,15,42,6,12,75,0,3,4,5,0,12,87
TRIPURA,2010,Professional Activity,0,5,17,5,3,30,0,0,0,0,0,0,30
TRIPURA,2010,Farming/Agriculture Activity,0,11,15,17,3,46,0,1,4,7,0,12,58
TRIPURA,2010,Others (Please Specify),1,19,50,34,18,122,3,16,6,2,0,27,149
TRIPURA,2010,Retired Person,0,0,0,1,10,11,0,0,0,0,0,0,11
TRIPURA,2010,Others (Please Specify),0,0,0,0,0,0,0,0,0,0,0,0,0
TRIPURA,2010,Total,16,127,142,91,65,441,18,108,80,49,29,284,725
TRIPURA,2010,Total Salaried,0,16,13,14,5,48,0,0,0,1,0,1,49
TRIPURA,2010,Total Self-employed,1,50,124,62,36,273,3,20,14,14,0,51,324
TRIPURA,2011,House Wife,0,0,0,0,0,0,0,29,47,37,27,140,140
TRIPURA,2011,Service (Government),0,0,2,1,0,3,0,0,0,0,0,0,3
TRIPURA,2011,Service (Private),0,10,6,3,1,20,0,0,0,0,0,0,20
TRIPURA,2011,Public Sector Undertaking,0,0,0,0,0,0,0,0,0,0,0,0,0
TRIPURA,2011,Student,2,78,0,0,0,80,5,77,0,0,0,82,162
TRIPURA,2011,Unemployed,0,1,1,0,0,2,0,0,0,0,0,0,2
TRIPURA,2011,Self-employed (Business activity),0,33,30,24,12,99,0,0,0,0,0,0,99
TRIPURA,2011,Professional Activity,0,0,0,0,0,0,0,0,0,0,0,0,0
TRIPURA,2011,Farming/Agriculture Activity,0,5,9,4,2,20,0,0,0,0,0,0,20
TRIPURA,2011,Others (Please Specify),0,5,12,3,9,29,0,4,2,1,0,7,36
TRIPURA,2011,Retired Person,0,0,0,0,0,0,0,0,0,0,0,0,0
TRIPURA,2011,Others (Please Specify),3,70,73,33,15,194,0,23,4,0,0,27,221
TRIPURA,2011,Total,5,202,133,68,39,447,5,133,53,38,27,256,703
TRIPURA,2011,Total Salaried,0,10,8,4,1,23,0,0,0,0,0,0,23
TRIPURA,2011,Total Self-employed,0,43,51,31,23,148,0,4,2,1,0,7,155
TRIPURA,2012,House Wife,0,0,0,0,0,0,0,44,36,24,24,128,128
TRIPURA,2012,Service (Government),0,1,0,1,0,2,0,0,0,0,0,0,2
TRIPURA,2012,Service (Private),0,3,3,0,0,6,0,0,0,0,0,0,6
TRIPURA,2012,Public Sector Undertaking,0,0,0,0,0,0,0,0,0,0,0,0,0
TRIPURA,2012,Student,7,38,0,0,0,45,4,27,0,0,0,31,76
TRIPURA,2012,Unemployed,0,9,10,6,0,25,0,1,2,0,0,3,28
TRIPURA,2012,Self-employed (Business activity),0,2,15,23,15,55,0,0,0,0,0,0,55
TRIPURA,2012,Professional Activity,0,0,0,2,4,6,0,0,0,0,0,0,6
TRIPURA,2012,Farming/Agriculture Activity,0,5,6,5,2,18,0,0,0,0,0,0,18
TRIPURA,2012,Others (Please Specify),5,49,33,29,19,135,2,15,5,1,0,23,158
TRIPURA,2012,Retired Person,0,0,0,0,0,0,0,0,0,0,0,0,0
TRIPURA,2012,Others (Please Specify),4,63,144,46,11,268,9,29,42,12,7,99,367
TRIPURA,2012,Total,16,170,211,112,51,560,15,116,85,37,31,284,844
TRIPURA,2012,Total Salaried,0,4,3,1,0,8,0,0,0,0,0,0,8
TRIPURA,2012,Total Self-employed,5,56,54,59,40,214,2,15,5,1,0,23,237
UTTAR PRADESH,2001,House Wife,0,0,0,0,0,0,13,577,374,87,24,1075,1075
UTTAR PRADESH,2001,Service (Government),0,8,16,6,1,31,0,15,11,0,0,26,57
UTTAR PRADESH,2001,Service (Private),1,113,85,39,1,239,1,34,23,15,0,73,312
UTTAR PRADESH,2001,Public Sector Undertaking,0,22,11,4,2,39,0,5,2,0,0,7,46
UTTAR PRADESH,2001,Student,38,82,3,0,0,123,20,66,2,0,0,88,211
UTTAR PRADESH,2001,Unemployed,12,167,96,34,7,316,2,12,4,2,0,20,336
UTTAR PRADESH,2001,Self-employed (Business activity),0,55,37,33,6,131,0,7,1,0,0,8,139
UTTAR PRADESH,2001,Professional Activity,0,8,17,9,3,37,0,1,2,1,0,4,41
UTTAR PRADESH,2001,Farming/Agriculture Activity,6,175,175,140,82,578,4,39,40,19,8,110,688
UTTAR PRADESH,2001,Others (Please Specify),11,57,66,45,20,199,11,88,59,47,36,241,440
UTTAR PRADESH,2001,Retired Person,0,0,0,2,3,5,0,1,2,1,2,6,11
UTTAR PRADESH,2001,Others (Please Specify),5,29,39,18,12,103,12,25,17,3,0,57,160
UTTAR PRADESH,2001,Total,73,716,545,330,137,1801,63,870,537,175,70,1715,3516
UTTAR PRADESH,2001,Total Salaried,1,143,112,49,4,309,1,54,36,15,0,106,415
UTTAR PRADESH,2001,Total Self-employed,17,295,295,227,111,945,15,135,102,67,44,363,1308
UTTAR PRADESH,2002,House Wife,0,0,0,0,0,0,8,555,329,157,54,1103,1103
UTTAR PRADESH,2002,Service (Government),0,7,10,3,1,21,0,4,5,0,0,9,30
UTTAR PRADESH,2002,Service (Private),0,82,77,41,0,200,0,14,12,1,0,27,227
UTTAR PRADESH,2002,Public Sector Undertaking,0,11,12,9,0,32,0,1,3,0,0,4,36
UTTAR PRADESH,2002,Student,15,90,11,4,0,120,21,67,8,0,0,96,216
UTTAR PRADESH,2002,Unemployed,1,216,168,53,14,452,4,21,6,2,0,33,485
UTTAR PRADESH,2002,Self-employed (Business activity),0,44,52,15,19,130,0,5,1,1,0,7,137
UTTAR PRADESH,2002,Professional Activity,0,10,7,8,4,29,0,3,3,0,0,6,35
UTTAR PRADESH,2002,Farming/Agriculture Activity,7,152,165,107,40,471,4,28,15,5,2,54,525
UTTAR PRADESH,2002,Others (Please Specify),21,122,176,139,87,545,167,110,104,59,28,468,1013
UTTAR PRADESH,2002,Retired Person,0,0,2,1,10,13,0,0,0,0,1,1,14
UTTAR PRADESH,2002,Others (Please Specify),11,119,86,82,15,313,4,51,35,15,11,116,429
UTTAR PRADESH,2002,Total,55,853,766,462,190,2326,208,859,521,240,96,1924,4250
UTTAR PRADESH,2002,Total Salaried,0,100,99,53,1,253,0,19,20,1,0,40,293
UTTAR PRADESH,2002,Total Self-employed,28,328,400,269,150,1175,171,146,123,65,30,535,1710
UTTAR PRADESH,2003,House Wife,0,0,0,0,0,0,2,548,310,159,54,1073,1073
UTTAR PRADESH,2003,Service (Government),0,19,15,9,0,43,0,6,10,1,0,17,60
UTTAR PRADESH,2003,Service (Private),4,23,93,46,7,173,0,36,26,11,2,75,248
UTTAR PRADESH,2003,Public Sector Undertaking,1,9,28,12,7,57,0,4,1,0,0,5,62
UTTAR PRADESH,2003,Student,24,93,0,1,0,118,27,64,7,0,0,98,216
UTTAR PRADESH,2003,Unemployed,3,195,141,42,11,392,3,35,16,7,1,62,454
UTTAR PRADESH,2003,Self-employed (Business activity),0,48,57,31,8,144,0,5,4,8,2,19,163
UTTAR PRADESH,2003,Professional Activity,1,34,44,18,9,106,0,7,3,1,0,11,117
UTTAR PRADESH,2003,Farming/Agriculture Activity,0,129,132,56,24,341,0,23,16,3,4,46,387
UTTAR PRADESH,2003,Others (Please Specify),24,94,96,80,44,338,17,44,28,31,26,146,484
UTTAR PRADESH,2003,Retired Person,0,0,5,10,14,29,0,7,0,1,1,9,38
UTTAR PRADESH,2003,Others (Please Specify),25,119,11,58,33,246,25,73,9,1,7,115,361
UTTAR PRADESH,2003,Total,82,763,622,363,157,1987,74,852,430,223,97,1676,3663
UTTAR PRADESH,2003,Total Salaried,5,51,136,67,14,273,0,46,37,12,2,97,370
UTTAR PRADESH,2003,Total Self-employed,25,305,329,185,85,929,17,79,51,43,32,222,1151
UTTAR PRADESH,2004,House Wife,0,0,0,0,0,0,26,643,290,104,27,1090,1090
UTTAR PRADESH,2004,Service (Government),0,12,13,5,0,30,0,2,0,0,0,2,32
UTTAR PRADESH,2004,Service (Private),0,54,75,23,3,155,0,32,29,12,0,73,228
UTTAR PRADESH,2004,Public Sector Undertaking,0,42,26,13,2,83,0,14,14,9,0,37,120
UTTAR PRADESH,2004,Student,28,92,8,0,0,128,20,53,0,0,0,73,201
UTTAR PRADESH,2004,Unemployed,2,135,103,42,13,295,2,57,27,3,3,92,387
UTTAR PRADESH,2004,Self-employed (Business activity),0,38,54,24,1,117,0,3,5,2,0,10,127
UTTAR PRADESH,2004,Professional Activity,0,33,26,21,0,80,0,1,5,1,0,7,87
UTTAR PRADESH,2004,Farming/Agriculture Activity,8,128,151,93,21,401,0,51,31,9,4,95,496
UTTAR PRADESH,2004,Others (Please Specify),19,136,125,76,28,384,8,61,28,35,22,154,538
UTTAR PRADESH,2004,Retired Person,0,0,2,2,13,17,0,0,0,1,3,4,21
UTTAR PRADESH,2004,Others (Please Specify),28,67,64,56,49,264,11,5,17,8,5,46,310
UTTAR PRADESH,2004,Total,85,737,647,355,130,1954,67,922,446,184,64,1683,3637
UTTAR PRADESH,2004,Total Salaried,0,108,114,41,5,268,0,48,43,21,0,112,380
UTTAR PRADESH,2004,Total Self-employed,27,335,356,214,50,982,8,116,69,47,26,266,1248
UTTAR PRADESH,2005,House Wife,0,0,0,0,0,0,0,547,348,119,0,1014,1014
UTTAR PRADESH,2005,Service (Government),0,8,16,11,0,35,0,8,3,2,0,13,48
UTTAR PRADESH,2005,Service (Private),3,74,54,27,6,164,25,29,0,5,36,95,259
UTTAR PRADESH,2005,Public Sector Undertaking,0,18,32,22,0,72,0,23,18,11,0,52,124
UTTAR PRADESH,2005,Student,19,105,16,0,0,140,12,60,7,0,0,79,219
UTTAR PRADESH,2005,Unemployed,2,69,91,26,7,195,0,39,24,9,0,72,267
UTTAR PRADESH,2005,Self-employed (Business activity),2,68,76,42,32,220,2,1,5,0,0,8,228
UTTAR PRADESH,2005,Professional Activity,1,13,17,24,6,61,0,1,2,0,0,3,64
UTTAR PRADESH,2005,Farming/Agriculture Activity,3,108,164,103,44,422,1,41,27,15,16,100,522
UTTAR PRADESH,2005,Others (Please Specify),13,71,106,78,37,305,11,90,27,31,8,167,472
UTTAR PRADESH,2005,Retired Person,0,0,0,3,3,6,0,0,0,2,1,3,9
UTTAR PRADESH,2005,Others (Please Specify),15,33,41,33,30,152,8,25,12,14,12,71,223
UTTAR PRADESH,2005,Total,58,567,613,369,165,1772,59,864,473,208,73,1677,3449
UTTAR PRADESH,2005,Total Salaried,3,100,102,60,6,271,25,60,21,18,36,160,431
UTTAR PRADESH,2005,Total Self-employed,19,260,363,247,119,1008,14,133,61,46,24,278,1286
UTTAR PRADESH,2006,House Wife,0,0,0,0,0,0,8,446,186,39,31,710,710
UTTAR PRADESH,2006,Service (Government),0,52,34,20,9,115,0,13,8,8,3,32,147
UTTAR PRADESH,2006,Service (Private),2,79,53,18,3,155,0,27,28,3,0,58,213
UTTAR PRADESH,2006,Public Sector Undertaking,0,9,15,4,0,28,0,13,5,1,0,19,47
UTTAR PRADESH,2006,Student,14,88,0,0,0,102,5,62,2,0,0,69,171
UTTAR PRADESH,2006,Unemployed,1,58,116,17,9,201,0,24,14,1,1,40,241
UTTAR PRADESH,2006,Self-employed (Business activity),0,44,40,36,29,149,0,7,8,3,2,20,169
UTTAR PRADESH,2006,Professional Activity,0,33,20,14,3,70,0,6,3,8,0,17,87
UTTAR PRADESH,2006,Farming/Agriculture Activity,1,125,150,49,21,346,6,27,22,6,4,65,411
UTTAR PRADESH,2006,Others (Please Specify),36,125,102,63,20,346,24,69,71,25,9,198,544
UTTAR PRADESH,2006,Retired Person,0,0,0,4,3,7,0,0,0,0,0,0,7
UTTAR PRADESH,2006,Others (Please Specify),11,16,143,51,21,242,11,43,15,26,15,110,352
UTTAR PRADESH,2006,Total,65,629,673,276,118,1761,54,737,362,120,65,1338,3099
UTTAR PRADESH,2006,Total Salaried,2,140,102,42,12,298,0,53,41,12,3,109,407
UTTAR PRADESH,2006,Total Self-employed,37,327,312,162,73,911,30,109,104,42,15,300,1211
UTTAR PRADESH,2007,House Wife,0,0,0,0,0,0,10,560,312,67,25,974,974
UTTAR PRADESH,2007,Service (Government),0,15,15,9,0,39,0,6,4,1,3,14,53
UTTAR PRADESH,2007,Service (Private),3,72,83,28,5,191,0,26,12,4,1,43,234
UTTAR PRADESH,2007,Public Sector Undertaking,0,10,11,9,3,33,1,8,4,0,0,13,46
UTTAR PRADESH,2007,Student,18,123,7,0,0,148,20,96,8,0,2,126,274
UTTAR PRADESH,2007,Unemployed,5,129,122,49,12,317,1,34,8,2,5,50,367
UTTAR PRADESH,2007,Self-employed (Business activity),0,38,47,46,5,136,0,12,5,0,2,19,155
UTTAR PRADESH,2007,Professional Activity,1,17,31,26,14,89,2,9,0,2,0,13,102
UTTAR PRADESH,2007,Farming/Agriculture Activity,3,84,125,123,54,389,5,29,27,20,16,97,486
UTTAR PRADESH,2007,Others (Please Specify),10,161,132,135,75,513,15,163,109,23,26,336,849
UTTAR PRADESH,2007,Retired Person,0,0,0,2,3,5,0,0,0,0,1,1,6
UTTAR PRADESH,2007,Others (Please Specify),10,46,55,38,45,194,15,47,68,37,20,187,381
UTTAR PRADESH,2007,Total,50,695,628,465,216,2054,69,990,557,156,101,1873,3927
UTTAR PRADESH,2007,Total Salaried,3,97,109,46,8,263,1,40,20,5,4,70,333
UTTAR PRADESH,2007,Total Self-employed,14,300,335,330,148,1127,22,213,141,45,44,465,1592
UTTAR PRADESH,2008,House Wife,0,0,0,0,0,0,10,618,337,91,49,1105,1105
UTTAR PRADESH,2008,Service (Government),0,8,15,7,0,30,0,9,5,0,0,14,44
UTTAR PRADESH,2008,Service (Private),0,102,84,4,2,192,0,24,12,5,0,41,233
UTTAR PRADESH,2008,Public Sector Undertaking,0,18,19,5,1,43,0,3,4,4,0,11,54
UTTAR PRADESH,2008,Student,27,148,22,1,2,200,25,125,4,0,0,154,354
UTTAR PRADESH,2008,Unemployed,1,101,90,32,15,239,0,25,17,4,1,47,286
UTTAR PRADESH,2008,Self-employed (Business activity),1,29,70,53,28,181,4,5,10,1,2,22,203
UTTAR PRADESH,2008,Professional Activity,0,6,9,6,1,22,0,7,1,1,0,9,31
UTTAR PRADESH,2008,Farming/Agriculture Activity,1,128,267,156,64,616,0,44,59,14,12,129,745
UTTAR PRADESH,2008,Others (Please Specify),19,152,106,101,44,422,25,164,40,17,16,262,684
UTTAR PRADESH,2008,Retired Person,0,0,1,2,3,6,0,0,0,0,0,0,6
UTTAR PRADESH,2008,Others (Please Specify),11,76,75,52,14,228,5,59,30,14,7,115,343
UTTAR PRADESH,2008,Total,60,768,758,419,174,2179,69,1083,519,151,87,1909,4088
UTTAR PRADESH,2008,Total Salaried,0,128,118,16,3,265,0,36,21,9,0,66,331
UTTAR PRADESH,2008,Total Self-employed,21,315,452,316,137,1241,29,220,110,33,30,422,1663
UTTAR PRADESH,2009,House Wife,0,0,0,0,0,0,7,605,272,74,48,1006,1006
UTTAR PRADESH,2009,Service (Government),0,10,15,6,0,31,0,11,4,3,0,18,49
UTTAR PRADESH,2009,Service (Private),0,95,112,47,7,261,0,42,36,8,0,86,347
UTTAR PRADESH,2009,Public Sector Undertaking,0,16,12,22,0,50,0,16,7,0,0,23,73
UTTAR PRADESH,2009,Student,21,172,10,0,0,203,29,107,7,0,0,143,346
UTTAR PRADESH,2009,Unemployed,5,135,118,48,13,319,1,21,20,7,3,52,371
UTTAR PRADESH,2009,Self-employed (Business activity),0,45,31,38,12,126,0,6,10,2,0,18,144
UTTAR PRADESH,2009,Professional Activity,0,7,8,5,1,21,0,1,1,0,0,2,23
UTTAR PRADESH,2009,Farming/Agriculture Activity,6,121,253,96,48,524,0,59,28,24,21,132,656
UTTAR PRADESH,2009,Others (Please Specify),8,148,143,118,68,485,14,134,100,35,14,297,782
UTTAR PRADESH,2009,Retired Person,0,2,0,0,2,4,0,0,11,0,0,11,15
UTTAR PRADESH,2009,Others (Please Specify),11,85,63,38,18,215,11,67,35,8,10,131,346
UTTAR PRADESH,2009,Total,51,836,765,418,169,2239,62,1069,531,161,96,1919,4158
UTTAR PRADESH,2009,Total Salaried,0,121,139,75,7,342,0,69,47,11,0,127,469
UTTAR PRADESH,2009,Total Self-employed,14,321,435,257,129,1156,14,200,139,61,35,449,1605
UTTAR PRADESH,2010,House Wife,0,0,0,0,0,0,8,480,350,105,62,1005,1005
UTTAR PRADESH,2010,Service (Government),0,14,16,7,1,38,0,60,9,6,0,75,113
UTTAR PRADESH,2010,Service (Private),0,90,51,42,5,188,4,37,20,8,1,70,258
UTTAR PRADESH,2010,Public Sector Undertaking,0,5,7,4,0,16,0,3,2,1,0,6,22
UTTAR PRADESH,2010,Student,13,131,10,2,0,156,29,132,0,0,0,161,317
UTTAR PRADESH,2010,Unemployed,5,95,88,32,12,232,0,23,24,9,0,56,288
UTTAR PRADESH,2010,Self-employed (Business activity),0,50,60,45,29,184,0,5,2,0,0,7,191
UTTAR PRADESH,2010,Professional Activity,0,32,21,9,5,67,0,0,0,0,0,0,67
UTTAR PRADESH,2010,Farming/Agriculture Activity,2,110,171,116,33,432,4,54,31,19,8,116,548
UTTAR PRADESH,2010,Others (Please Specify),6,109,123,46,30,314,9,124,59,22,7,221,535
UTTAR PRADESH,2010,Retired Person,0,0,0,4,8,12,0,1,0,2,1,4,16
UTTAR PRADESH,2010,Others (Please Specify),20,36,33,40,19,148,4,108,8,0,0,120,268
UTTAR PRADESH,2010,Total,46,672,580,347,142,1787,58,1027,505,172,79,1841,3628
UTTAR PRADESH,2010,Total Salaried,0,109,74,53,6,242,4,100,31,15,1,151,393
UTTAR PRADESH,2010,Total Self-employed,8,301,375,216,97,997,13,183,92,41,15,344,1341
UTTAR PRADESH,2011,House Wife,0,0,0,0,0,0,24,739,327,109,45,1244,1244
UTTAR PRADESH,2011,Service (Government),0,11,21,16,0,48,0,22,17,2,0,41,89
UTTAR PRADESH,2011,Service (Private),0,133,127,57,2,319,0,29,46,4,0,79,398
UTTAR PRADESH,2011,Public Sector Undertaking,0,4,4,8,0,16,0,2,2,0,0,4,20
UTTAR PRADESH,2011,Student,17,122,10,4,0,153,16,89,1,0,0,106,259
UTTAR PRADESH,2011,Unemployed,1,132,86,29,11,259,3,22,27,9,2,63,322
UTTAR PRADESH,2011,Self-employed (Business activity),1,33,59,10,2,105,0,27,0,0,0,27,132
UTTAR PRADESH,2011,Professional Activity,0,30,54,27,2,113,0,4,3,2,0,9,122
UTTAR PRADESH,2011,Farming/Agriculture Activity,3,152,199,118,81,553,4,32,36,12,8,92,645
UTTAR PRADESH,2011,Others (Please Specify),9,153,201,117,36,516,6,97,82,39,14,238,754
UTTAR PRADESH,2011,Retired Person,0,0,2,1,3,6,0,2,0,0,1,3,9
UTTAR PRADESH,2011,Others (Please Specify),14,197,234,131,49,625,6,105,75,24,14,224,849
UTTAR PRADESH,2011,Total,45,967,997,518,186,2713,59,1170,616,201,84,2130,4843
UTTAR PRADESH,2011,Total Salaried,0,148,152,81,2,383,0,53,65,6,0,124,507
UTTAR PRADESH,2011,Total Self-employed,13,368,513,272,121,1287,10,160,121,53,22,366,1653
UTTAR PRADESH,2012,House Wife,0,0,0,0,0,0,7,546,393,98,33,1077,1077
UTTAR PRADESH,2012,Service (Government),0,24,23,15,0,62,4,10,12,1,0,27,89
UTTAR PRADESH,2012,Service (Private),1,94,142,73,15,325,14,93,24,14,0,145,470
UTTAR PRADESH,2012,Public Sector Undertaking,0,12,8,11,0,31,0,6,10,9,0,25,56
UTTAR PRADESH,2012,Student,20,122,11,1,0,154,15,104,31,0,1,151,305
UTTAR PRADESH,2012,Unemployed,2,98,80,26,3,209,0,21,15,1,0,37,246
UTTAR PRADESH,2012,Self-employed (Business activity),0,85,80,32,13,210,0,6,6,5,0,17,227
UTTAR PRADESH,2012,Professional Activity,0,22,53,28,22,125,0,5,0,0,0,5,130
UTTAR PRADESH,2012,Farming/Agriculture Activity,2,161,230,170,56,619,2,36,44,27,17,126,745
UTTAR PRADESH,2012,Others (Please Specify),3,96,95,75,13,282,4,89,27,39,6,165,447
UTTAR PRADESH,2012,Retired Person,0,0,2,1,5,8,0,0,0,0,2,2,10
UTTAR PRADESH,2012,Others (Please Specify),3,131,118,142,76,470,8,73,29,24,16,150,620
UTTAR PRADESH,2012,Total,31,845,842,574,203,2495,54,989,591,218,75,1927,4422
UTTAR PRADESH,2012,Total Salaried,1,130,173,99,15,418,18,109,46,24,0,197,615
UTTAR PRADESH,2012,Total Self-employed,5,364,458,305,104,1236,6,136,77,71,23,313,1549
UTTARAKHAND,2001,House Wife,0,0,0,0,0,0,0,30,24,8,2,64,64
UTTARAKHAND,2001,Service (Government),0,2,6,2,0,10,0,9,1,0,0,10,20
UTTARAKHAND,2001,Service (Private),1,3,41,18,2,65,3,9,5,0,0,17,82
UTTARAKHAND,2001,Public Sector Undertaking,0,1,1,0,0,2,0,0,0,0,0,0,2
UTTARAKHAND,2001,Student,2,10,0,0,0,12,1,8,0,0,0,9,21
UTTARAKHAND,2001,Unemployed,0,10,18,0,0,28,0,3,0,1,0,4,32
UTTARAKHAND,2001,Self-employed (Business activity),0,4,0,4,0,8,0,0,0,0,0,0,8
UTTARAKHAND,2001,Professional Activity,0,0,0,0,0,0,0,0,0,0,0,0,0
UTTARAKHAND,2001,Farming/Agriculture Activity,0,3,9,5,1,18,0,2,1,0,0,3,21
UTTARAKHAND,2001,Others (Please Specify),0,7,12,9,2,30,0,10,8,1,0,19,49
UTTARAKHAND,2001,Retired Person,0,0,0,2,0,2,0,0,0,0,0,0,2
UTTARAKHAND,2001,Others (Please Specify),0,1,4,2,0,7,0,1,2,0,0,3,10
UTTARAKHAND,2001,Total,3,41,91,42,5,182,4,72,41,10,2,129,311
UTTARAKHAND,2001,Total Salaried,1,6,48,20,2,77,3,18,6,0,0,27,104
UTTARAKHAND,2001,Total Self-employed,0,14,21,18,3,56,0,12,9,1,0,22,78
UTTARAKHAND,2002,House Wife,0,0,0,0,0,0,1,58,44,14,2,119,119
UTTARAKHAND,2002,Service (Government),0,2,2,1,0,5,0,1,1,0,0,2,7
UTTARAKHAND,2002,Service (Private),0,12,12,1,0,25,0,2,0,0,0,2,27
UTTARAKHAND,2002,Public Sector Undertaking,0,1,0,0,0,1,0,0,0,0,0,0,1
UTTARAKHAND,2002,Student,2,4,0,0,0,6,0,3,0,0,0,3,9
UTTARAKHAND,2002,Unemployed,1,18,9,7,3,38,1,4,1,0,1,7,45
UTTARAKHAND,2002,Self-employed (Business activity),0,5,3,0,0,8,0,0,0,0,0,0,8
UTTARAKHAND,2002,Professional Activity,0,3,1,0,0,4,0,0,0,0,0,0,4
UTTARAKHAND,2002,Farming/Agriculture Activity,0,10,14,3,4,31,0,2,1,0,0,3,34
UTTARAKHAND,2002,Others (Please Specify),2,32,19,13,9,75,6,10,3,1,0,20,95
UTTARAKHAND,2002,Retired Person,0,0,0,5,0,5,0,0,0,0,0,0,5
UTTARAKHAND,2002,Others (Please Specify),3,2,0,2,0,7,0,0,0,0,0,0,7
UTTARAKHAND,2002,Total,8,89,60,32,16,205,8,80,50,15,3,156,361
UTTARAKHAND,2002,Total Salaried,0,15,14,2,0,31,0,3,1,0,0,4,35
UTTARAKHAND,2002,Total Self-employed,2,50,37,16,13,118,6,12,4,1,0,23,141
UTTARAKHAND,2003,House Wife,0,0,0,0,0,0,0,49,21,10,1,81,81
UTTARAKHAND,2003,Service (Government),0,4,6,4,0,14,0,1,0,0,0,1,15
UTTARAKHAND,2003,Service (Private),0,19,29,12,0,60,0,12,3,0,0,15,75
UTTARAKHAND,2003,Public Sector Undertaking,0,1,1,0,0,2,0,0,4,1,0,5,7
UTTARAKHAND,2003,Student,0,9,0,0,0,9,1,7,0,0,0,8,17
UTTARAKHAND,2003,Unemployed,0,30,15,10,0,55,0,0,0,0,0,0,55
UTTARAKHAND,2003,Self-employed (Business activity),0,4,4,3,0,11,0,0,0,0,0,0,11
UTTARAKHAND,2003,Professional Activity,0,5,2,2,0,9,0,0,1,0,0,1,10
UTTARAKHAND,2003,Farming/Agriculture Activity,0,14,14,10,1,39,0,1,1,0,0,2,41
UTTARAKHAND,2003,Others (Please Specify),0,16,16,12,3,47,0,4,1,3,1,9,56
UTTARAKHAND,2003,Retired Person,0,0,0,1,0,1,0,0,0,0,0,0,1
UTTARAKHAND,2003,Others (Please Specify),0,9,4,1,1,15,2,3,1,0,1,7,22
UTTARAKHAND,2003,Total,0,111,91,55,5,262,3,77,32,14,3,129,391
UTTARAKHAND,2003,Total Salaried,0,24,36,16,0,76,0,13,7,1,0,21,97
UTTARAKHAND,2003,Total Self-employed,0,39,36,27,4,106,0,5,3,3,1,12,118
UTTARAKHAND,2004,House Wife,0,0,0,0,0,0,0,37,18,8,0,63,63
UTTARAKHAND,2004,Service (Government),0,0,5,2,0,7,0,0,0,0,0,0,7
UTTARAKHAND,2004,Service (Private),0,10,6,2,0,18,0,2,1,0,0,3,21
UTTARAKHAND,2004,Public Sector Undertaking,0,0,0,0,0,0,0,0,0,0,0,0,0
UTTARAKHAND,2004,Student,1,6,0,0,0,7,0,9,0,0,0,9,16
UTTARAKHAND,2004,Unemployed,0,10,10,5,1,26,0,1,0,0,0,1,27
UTTARAKHAND,2004,Self-employed (Business activity),0,2,3,3,0,8,0,0,0,0,0,0,8
UTTARAKHAND,2004,Professional Activity,0,0,0,0,0,0,0,0,1,0,0,1,1
UTTARAKHAND,2004,Farming/Agriculture Activity,0,2,11,4,1,18,0,3,1,0,0,4,22
UTTARAKHAND,2004,Others (Please Specify),1,6,8,3,3,21,0,1,0,2,0,3,24
UTTARAKHAND,2004,Retired Person,0,0,1,0,0,1,0,0,0,0,0,0,1
UTTARAKHAND,2004,Others (Please Specify),6,23,9,2,2,42,2,2,1,0,0,5,47
UTTARAKHAND,2004,Total,8,59,53,21,7,148,2,55,22,10,0,89,237
UTTARAKHAND,2004,Total Salaried,0,10,11,4,0,25,0,2,1,0,0,3,28
UTTARAKHAND,2004,Total Self-employed,1,10,22,10,4,47,0,4,2,2,0,8,55
UTTARAKHAND,2005,House Wife,0,0,0,0,0,0,0,44,20,3,0,67,67
UTTARAKHAND,2005,Service (Government),0,2,3,2,0,7,0,0,0,0,0,0,7
UTTARAKHAND,2005,Service (Private),0,7,7,3,0,17,0,2,1,0,0,3,20
UTTARAKHAND,2005,Public Sector Undertaking,0,3,3,0,0,6,0,1,0,0,0,1,7
UTTARAKHAND,2005,Student,0,8,0,0,0,8,3,3,0,0,0,6,14
UTTARAKHAND,2005,Unemployed,0,19,18,6,0,43,0,0,1,0,0,1,44
UTTARAKHAND,2005,Self-employed (Business activity),0,7,16,2,1,26,0,0,0,0,0,0,26
UTTARAKHAND,2005,Professional Activity,0,2,4,4,0,10,0,0,0,0,0,0,10
UTTARAKHAND,2005,Farming/Agriculture Activity,0,4,4,5,2,15,0,3,3,3,0,9,24
UTTARAKHAND,2005,Others (Please Specify),0,8,8,4,0,20,0,1,0,1,0,2,22
UTTARAKHAND,2005,Retired Person,0,0,0,1,2,3,0,0,0,0,0,0,3
UTTARAKHAND,2005,Others (Please Specify),0,16,3,2,4,25,1,0,1,2,0,4,29
UTTARAKHAND,2005,Total,0,76,66,29,9,180,4,54,26,9,0,93,273
UTTARAKHAND,2005,Total Salaried,0,12,13,5,0,30,0,3,1,0,0,4,34
UTTARAKHAND,2005,Total Self-employed,0,21,32,15,3,71,0,4,3,4,0,11,82
UTTARAKHAND,2006,House Wife,0,0,0,0,0,0,0,43,33,8,2,86,86
UTTARAKHAND,2006,Service (Government),0,4,7,2,0,13,0,0,0,1,0,1,14
UTTARAKHAND,2006,Service (Private),0,4,9,4,1,18,0,3,4,1,1,9,27
UTTARAKHAND,2006,Public Sector Undertaking,0,1,3,2,0,6,0,3,2,1,0,6,12
UTTARAKHAND,2006,Student,0,4,0,0,0,4,1,6,3,0,0,10,14
UTTARAKHAND,2006,Unemployed,0,6,6,5,2,19,0,2,2,1,0,5,24
UTTARAKHAND,2006,Self-employed (Business activity),0,5,8,6,2,21,0,2,0,0,0,2,23
UTTARAKHAND,2006,Professional Activity,0,0,4,2,0,6,0,2,1,0,0,3,9
UTTARAKHAND,2006,Farming/Agriculture Activity,0,10,12,10,1,33,0,9,8,1,0,18,51
UTTARAKHAND,2006,Others (Please Specify),0,3,4,5,3,15,1,1,0,0,0,2,17
UTTARAKHAND,2006,Retired Person,0,0,0,0,4,4,0,0,0,0,0,0,4
UTTARAKHAND,2006,Others (Please Specify),0,14,17,3,0,34,3,6,2,0,0,11,45
UTTARAKHAND,2006,Total,0,51,70,39,13,173,5,77,55,13,3,153,326
UTTARAKHAND,2006,Total Salaried,0,9,19,8,1,37,0,6,6,3,1,16,53
UTTARAKHAND,2006,Total Self-employed,0,18,28,23,6,75,1,14,9,1,0,25,100
UTTARAKHAND,2007,House Wife,0,0,0,0,0,0,0,40,19,6,2,67,67
UTTARAKHAND,2007,Service (Government),0,1,4,0,0,5,0,2,0,0,0,2,7
UTTARAKHAND,2007,Service (Private),0,8,14,4,0,26,0,3,2,0,0,5,31
UTTARAKHAND,2007,Public Sector Undertaking,0,2,10,1,0,13,0,3,3,0,0,6,19
UTTARAKHAND,2007,Student,1,5,2,0,0,8,3,4,0,0,0,7,15
UTTARAKHAND,2007,Unemployed,1,8,8,3,0,20,1,2,3,0,0,6,26
UTTARAKHAND,2007,Self-employed (Business activity),0,6,4,0,0,10,0,0,2,0,0,2,12
UTTARAKHAND,2007,Professional Activity,0,0,3,1,0,4,0,1,0,0,0,1,5
UTTARAKHAND,2007,Farming/Agriculture Activity,0,7,9,2,0,18,0,6,2,2,0,10,28
UTTARAKHAND,2007,Others (Please Specify),0,5,1,2,0,8,2,2,1,0,0,5,13
UTTARAKHAND,2007,Retired Person,0,0,0,0,0,0,0,0,0,0,0,0,0
UTTARAKHAND,2007,Others (Please Specify),0,11,5,1,1,18,2,0,3,0,2,7,25
UTTARAKHAND,2007,Total,2,53,60,14,1,130,8,63,35,8,4,118,248
UTTARAKHAND,2007,Total Salaried,0,11,28,5,0,44,0,8,5,0,0,13,57
UTTARAKHAND,2007,Total Self-employed,0,18,17,5,0,40,2,9,5,2,0,18,58
UTTARAKHAND,2008,House Wife,0,0,0,0,0,0,0,32,8,4,0,44,44
UTTARAKHAND,2008,Service (Government),0,4,2,1,0,7,0,0,0,0,0,0,7
UTTARAKHAND,2008,Service (Private),1,7,7,2,0,17,0,3,2,1,0,6,23
UTTARAKHAND,2008,Public Sector Undertaking,0,2,2,1,0,5,0,0,0,1,0,1,6
UTTARAKHAND,2008,Student,0,4,2,0,0,6,2,5,0,0,0,7,13
UTTARAKHAND,2008,Unemployed,0,5,0,0,0,5,0,1,1,0,0,2,7
UTTARAKHAND,2008,Self-employed (Business activity),0,3,2,1,0,6,0,0,0,0,0,0,6
UTTARAKHAND,2008,Professional Activity,0,0,0,0,0,0,0,0,0,0,0,0,0
UTTARAKHAND,2008,Farming/Agriculture Activity,0,6,10,5,0,21,0,4,2,1,0,7,28
UTTARAKHAND,2008,Others (Please Specify),2,2,5,2,2,13,1,12,2,0,0,15,28
UTTARAKHAND,2008,Retired Person,0,0,0,3,0,3,0,0,0,0,0,0,3
UTTARAKHAND,2008,Others (Please Specify),5,4,5,5,2,21,0,4,0,1,0,5,26
UTTARAKHAND,2008,Total,8,37,35,20,4,104,3,61,15,8,0,87,191
UTTARAKHAND,2008,Total Salaried,1,13,11,4,0,29,0,3,2,2,0,7,36
UTTARAKHAND,2008,Total Self-employed,2,11,17,8,2,40,1,16,4,1,0,22,62
UTTARAKHAND,2009,House Wife,0,0,0,0,0,0,0,42,25,7,1,75,75
UTTARAKHAND,2009,Service (Government),0,3,1,4,0,8,0,0,0,0,0,0,8
UTTARAKHAND,2009,Service (Private),0,15,9,9,0,33,0,2,4,0,0,6,39
UTTARAKHAND,2009,Public Sector Undertaking,0,3,1,2,0,6,0,0,0,2,0,2,8
UTTARAKHAND,2009,Student,1,20,0,0,0,21,3,16,0,0,0,19,40
UTTARAKHAND,2009,Unemployed,0,10,16,5,0,31,0,4,1,0,0,5,36
UTTARAKHAND,2009,Self-employed (Business activity),0,2,4,2,0,8,0,0,2,0,0,2,10
UTTARAKHAND,2009,Professional Activity,0,2,8,14,3,27,0,5,2,0,0,7,34
UTTARAKHAND,2009,Farming/Agriculture Activity,0,10,9,4,3,26,0,4,0,0,0,4,30
UTTARAKHAND,2009,Others (Please Specify),0,0,0,0,0,0,0,0,0,0,0,0,0
UTTARAKHAND,2009,Retired Person,1,12,7,17,5,42,0,6,8,6,0,20,62
UTTARAKHAND,2009,Others (Please Specify),0,0,0,0,0,0,0,0,0,0,0,0,0
UTTARAKHAND,2009,Total,2,77,55,57,11,202,3,79,42,15,1,140,342
UTTARAKHAND,2009,Total Salaried,0,21,11,15,0,47,0,2,4,2,0,8,55
UTTARAKHAND,2009,Total Self-employed,0,14,21,20,6,61,0,9,4,0,0,13,74
UTTARAKHAND,2010,House Wife,0,0,0,0,0,0,0,28,18,6,2,54,54
UTTARAKHAND,2010,Service (Government),0,4,6,1,0,11,0,1,2,0,0,3,14
UTTARAKHAND,2010,Service (Private),0,7,10,4,0,21,0,3,0,0,0,3,24
UTTARAKHAND,2010,Public Sector Undertaking,0,0,0,0,0,0,0,1,0,0,0,1,1
UTTARAKHAND,2010,Student,2,8,0,0,0,10,4,20,0,0,0,24,34
UTTARAKHAND,2010,Unemployed,0,14,0,5,0,19,0,1,2,0,0,3,22
UTTARAKHAND,2010,Self-employed (Business activity),2,4,6,2,1,15,0,0,0,0,0,0,15
UTTARAKHAND,2010,Professional Activity,0,0,1,0,0,1,0,0,0,0,0,0,1
UTTARAKHAND,2010,Farming/Agriculture Activity,0,8,14,7,4,33,0,4,2,0,0,6,39
UTTARAKHAND,2010,Others (Please Specify),0,8,9,5,4,26,0,4,3,1,0,8,34
UTTARAKHAND,2010,Retired Person,0,0,0,3,0,3,0,0,0,0,0,0,3
UTTARAKHAND,2010,Others (Please Specify),0,9,11,2,3,25,3,7,3,2,0,15,40
UTTARAKHAND,2010,Total,4,62,57,29,12,164,7,69,30,9,2,117,281
UTTARAKHAND,2010,Total Salaried,0,11,16,5,0,32,0,5,2,0,0,7,39
UTTARAKHAND,2010,Total Self-employed,2,20,30,14,9,75,0,8,5,1,0,14,89
UTTARAKHAND,2011,House Wife,0,0,0,0,0,0,0,23,24,3,1,51,51
UTTARAKHAND,2011,Service (Government),0,5,9,3,0,17,0,2,0,0,0,2,19
UTTARAKHAND,2011,Service (Private),0,11,18,2,0,31,0,4,2,0,0,6,37
UTTARAKHAND,2011,Public Sector Undertaking,0,2,1,1,1,5,0,4,0,0,0,4,9
UTTARAKHAND,2011,Student,3,9,1,0,0,13,1,16,0,0,0,17,30
UTTARAKHAND,2011,Unemployed,1,12,13,7,3,36,0,3,2,0,0,5,41
UTTARAKHAND,2011,Self-employed (Business activity),0,7,5,3,0,15,0,0,0,0,0,0,15
UTTARAKHAND,2011,Professional Activity,0,1,2,0,0,3,0,0,0,0,0,0,3
UTTARAKHAND,2011,Farming/Agriculture Activity,0,10,2,9,1,22,0,2,1,0,0,3,25
UTTARAKHAND,2011,Others (Please Specify),1,7,11,4,3,26,0,5,8,5,0,18,44
UTTARAKHAND,2011,Retired Person,0,0,1,0,3,4,0,0,0,0,0,0,4
UTTARAKHAND,2011,Others (Please Specify),0,5,10,5,0,20,0,10,7,2,0,19,39
UTTARAKHAND,2011,Total,5,69,73,34,11,192,1,69,44,10,1,125,317
UTTARAKHAND,2011,Total Salaried,0,18,28,6,1,53,0,10,2,0,0,12,65
UTTARAKHAND,2011,Total Self-employed,1,25,20,16,4,66,0,7,9,5,0,21,87
UTTARAKHAND,2012,House Wife,0,0,0,0,0,0,0,43,15,2,3,63,63
UTTARAKHAND,2012,Service (Government),0,1,6,0,0,7,0,0,0,0,0,0,7
UTTARAKHAND,2012,Service (Private),0,11,21,13,0,45,0,1,1,0,0,2,47
UTTARAKHAND,2012,Public Sector Undertaking,0,0,5,2,0,7,1,0,0,0,0,1,8
UTTARAKHAND,2012,Student,1,8,2,0,0,11,1,6,2,0,0,9,20
UTTARAKHAND,2012,Unemployed,0,10,11,0,0,21,0,4,1,0,0,5,26
UTTARAKHAND,2012,Self-employed (Business activity),0,7,5,6,2,20,0,0,0,0,0,0,20
UTTARAKHAND,2012,Professional Activity,0,0,0,1,0,1,0,0,0,0,0,0,1
UTTARAKHAND,2012,Farming/Agriculture Activity,0,3,5,1,3,12,0,1,1,0,0,2,14
UTTARAKHAND,2012,Others (Please Specify),1,6,18,5,2,32,3,7,4,2,0,16,48
UTTARAKHAND,2012,Retired Person,0,0,0,0,0,0,0,0,0,0,0,0,0
UTTARAKHAND,2012,Others (Please Specify),5,27,33,19,9,93,4,38,23,8,4,77,170
UTTARAKHAND,2012,Total,7,73,106,47,16,249,9,100,47,12,7,175,424
UTTARAKHAND,2012,Total Salaried,0,12,32,15,0,59,1,1,1,0,0,3,62
UTTARAKHAND,2012,Total Self-employed,1,16,28,13,7,65,3,8,5,2,0,18,83
WEST BENGAL,2001,House Wife,0,0,0,0,0,0,0,653,588,242,72,1555,1555
WEST BENGAL,2001,Service (Government),0,42,65,68,7,182,0,38,65,13,5,121,303
WEST BENGAL,2001,Service (Private),16,229,366,335,49,995,41,118,121,97,48,425,1420
WEST BENGAL,2001,Public Sector Undertaking,0,170,111,137,55,473,0,93,104,64,8,269,742
WEST BENGAL,2001,Student,132,263,2,0,0,397,73,331,13,0,0,417,814
WEST BENGAL,2001,Unemployed,2,217,229,186,12,646,0,99,110,14,0,223,869
WEST BENGAL,2001,Self-employed (Business activity),0,88,193,195,33,509,0,34,44,51,37,166,675
WEST BENGAL,2001,Professional Activity,0,23,67,64,41,195,5,22,28,16,10,81,276
WEST BENGAL,2001,Farming/Agriculture Activity,8,284,279,266,98,935,13,72,133,93,0,311,1246
WEST BENGAL,2001,Others (Please Specify),21,364,328,291,153,1157,24,271,265,215,72,847,2004
WEST BENGAL,2001,Retired Person,0,0,0,8,94,102,0,0,0,17,28,45,147
WEST BENGAL,2001,Others (Please Specify),104,347,786,496,171,1904,127,523,544,348,193,1735,3639
WEST BENGAL,2001,Total,283,2027,2426,2046,713,7495,283,2254,2015,1170,473,6195,13690
WEST BENGAL,2001,Total Salaried,16,441,542,540,111,1650,41,249,290,174,61,815,2465
WEST BENGAL,2001,Total Self-employed,29,759,867,816,325,2796,42,399,470,375,119,1405,4201
WEST BENGAL,2002,House Wife,0,0,0,0,0,0,0,925,907,395,67,2294,2294
WEST BENGAL,2002,Service (Government),0,20,64,59,5,148,0,21,35,49,1,106,254
WEST BENGAL,2002,Service (Private),2,251,273,235,31,792,0,141,136,63,34,374,1166
WEST BENGAL,2002,Public Sector Undertaking,0,173,96,110,27,406,0,72,86,54,1,213,619
WEST BENGAL,2002,Student,127,251,20,1,0,399,144,118,6,0,0,268,667
WEST BENGAL,2002,Unemployed,4,274,218,145,19,660,0,150,124,13,3,290,950
WEST BENGAL,2002,Self-employed (Business activity),0,155,232,185,47,619,0,59,25,66,20,170,789
WEST BENGAL,2002,Professional Activity,0,15,79,56,14,164,0,1,16,28,0,45,209
WEST BENGAL,2002,Farming/Agriculture Activity,0,321,425,302,95,1143,1,108,140,119,7,375,1518
WEST BENGAL,2002,Others (Please Specify),32,347,400,239,91,1109,40,223,178,136,70,647,1756
WEST BENGAL,2002,Retired Person,0,0,0,40,95,135,0,0,0,0,18,18,153
WEST BENGAL,2002,Others (Please Specify),118,408,547,339,137,1549,109,340,335,161,138,1083,2632
WEST BENGAL,2002,Total,283,2215,2354,1711,561,7124,294,2158,1988,1084,359,5883,13007
WEST BENGAL,2002,Total Salaried,2,444,433,404,63,1346,0,234,257,166,36,693,2039
WEST BENGAL,2002,Total Self-employed,32,838,1136,782,247,3035,41,391,359,349,97,1237,4272
WEST BENGAL,2003,House Wife,0,0,0,0,0,0,0,1402,1414,980,287,4083,4083
WEST BENGAL,2003,Service (Government),0,74,76,52,0,202,0,7,12,9,0,28,230
WEST BENGAL,2003,Service (Private),0,221,290,226,0,737,0,26,47,22,0,95,832
WEST BENGAL,2003,Public Sector Undertaking,0,322,255,369,0,946,0,79,44,18,0,141,1087
WEST BENGAL,2003,Student,41,418,79,0,0,538,61,413,99,0,0,573,1111
WEST BENGAL,2003,Unemployed,0,392,356,9,0,757,0,87,64,0,0,151,908
WEST BENGAL,2003,Self-employed (Business activity),0,217,329,322,74,942,0,35,22,11,0,68,1010
WEST BENGAL,2003,Professional Activity,0,92,121,140,15,368,0,9,6,5,1,21,389
WEST BENGAL,2003,Farming/Agriculture Activity,0,201,394,260,65,920,0,51,48,16,1,116,1036
WEST BENGAL,2003,Others (Please Specify),2,255,274,226,111,868,4,80,123,103,53,363,1231
WEST BENGAL,2003,Retired Person,0,0,0,0,241,241,0,0,0,0,7,7,248
WEST BENGAL,2003,Others (Please Specify),18,204,444,166,73,905,33,93,16,27,41,210,1115
WEST BENGAL,2003,Total,61,2396,2618,1770,579,7424,98,2282,1895,1191,390,5856,13280
WEST BENGAL,2003,Total Salaried,0,617,621,647,0,1885,0,112,103,49,0,264,2149
WEST BENGAL,2003,Total Self-employed,2,765,1118,948,265,3098,4,175,199,135,55,568,3666
WEST BENGAL,2004,House Wife,0,0,0,0,0,0,0,1577,1224,480,71,3352,3352
WEST BENGAL,2004,Service (Government),0,15,65,45,0,125,0,9,11,6,0,26,151
WEST BENGAL,2004,Service (Private),0,122,263,212,0,597,0,37,20,20,0,77,674
WEST BENGAL,2004,Public Sector Undertaking,0,162,243,246,0,651,0,13,27,26,0,66,717
WEST BENGAL,2004,Student,119,318,11,0,0,448,145,212,4,0,0,361,809
WEST BENGAL,2004,Unemployed,0,371,270,72,0,713,0,68,74,16,0,158,871
WEST BENGAL,2004,Self-employed (Business activity),0,127,271,300,48,746,0,1,20,5,0,26,772
WEST BENGAL,2004,Professional Activity,0,71,70,136,9,286,0,2,4,2,1,9,295
WEST BENGAL,2004,Farming/Agriculture Activity,0,220,298,250,29,797,2,7,10,6,0,25,822
WEST BENGAL,2004,Others (Please Specify),27,357,368,256,107,1115,15,160,126,133,85,519,1634
WEST BENGAL,2004,Retired Person,0,0,0,0,218,218,0,0,0,3,10,13,231
WEST BENGAL,2004,Others (Please Specify),138,592,691,392,152,1965,127,284,416,219,85,1131,3096
WEST BENGAL,2004,Total,284,2355,2550,1909,563,7661,289,2370,1936,916,252,5763,13424
WEST BENGAL,2004,Total Salaried,0,299,571,503,0,1373,0,59,58,52,0,169,1542
WEST BENGAL,2004,Total Self-employed,27,775,1007,942,193,2944,17,170,160,146,86,579,3523
WEST BENGAL,2005,House Wife,0,0,0,0,0,0,0,1834,1296,830,195,4155,4155
WEST BENGAL,2005,Service (Government),0,46,70,48,0,164,0,2,9,9,0,20,184
WEST BENGAL,2005,Service (Private),0,418,464,237,0,1119,0,94,104,47,0,245,1364
WEST BENGAL,2005,Public Sector Undertaking,0,97,222,152,0,471,0,32,12,2,0,46,517
WEST BENGAL,2005,Student,141,285,27,0,0,453,164,102,12,0,0,278,731
WEST BENGAL,2005,Unemployed,0,617,301,10,0,928,0,152,63,6,0,221,1149
WEST BENGAL,2005,Self-employed (Business activity),0,212,351,307,34,904,0,11,56,8,21,96,1000
WEST BENGAL,2005,Professional Activity,0,57,133,148,8,346,0,3,1,2,0,6,352
WEST BENGAL,2005,Farming/Agriculture Activity,0,233,293,282,45,853,0,12,60,30,10,112,965
WEST BENGAL,2005,Others (Please Specify),0,372,610,528,202,1712,4,193,86,133,42,458,2170
WEST BENGAL,2005,Retired Person,0,0,0,0,212,212,0,0,0,0,15,15,227
WEST BENGAL,2005,Others (Please Specify),73,625,430,296,28,1452,37,345,220,111,36,749,2201
WEST BENGAL,2005,Total,214,2962,2901,2008,529,8614,205,2780,1919,1178,319,6401,15015
WEST BENGAL,2005,Total Salaried,0,561,756,437,0,1754,0,128,125,58,0,311,2065
WEST BENGAL,2005,Total Self-employed,0,874,1387,1265,289,3815,4,219,203,173,73,672,4487
WEST BENGAL,2006,House Wife,0,0,0,0,0,0,0,2263,1584,1111,62,5020,5020
WEST BENGAL,2006,Service (Government),0,20,81,62,0,163,0,8,16,12,0,36,199
WEST BENGAL,2006,Service (Private),0,93,339,256,0,688,0,36,65,29,0,130,818
WEST BENGAL,2006,Public Sector Undertaking,0,265,388,123,0,776,0,33,25,21,0,79,855
WEST BENGAL,2006,Student,146,491,2,0,0,639,184,317,1,0,0,502,1141
WEST BENGAL,2006,Unemployed,0,928,639,0,0,1567,0,144,37,0,0,181,1748
WEST BENGAL,2006,Self-employed (Business activity),0,338,688,335,39,1400,0,10,33,8,0,51,1451
WEST BENGAL,2006,Professional Activity,0,182,242,279,35,738,0,23,12,3,0,38,776
WEST BENGAL,2006,Farming/Agriculture Activity,0,196,455,256,56,963,0,85,105,31,5,226,1189
WEST BENGAL,2006,Others (Please Specify),0,521,627,562,113,1823,0,78,34,18,158,288,2111
WEST BENGAL,2006,Retired Person,0,0,0,0,297,297,0,0,0,0,46,46,343
WEST BENGAL,2006,Others (Please Specify),4,3,14,20,25,66,0,1,1,1,5,8,74
WEST BENGAL,2006,Total,150,3037,3475,1893,565,9120,184,2998,1913,1234,276,6605,15725
WEST BENGAL,2006,Total Salaried,0,378,808,441,0,1627,0,77,106,62,0,245,1872
WEST BENGAL,2006,Total Self-employed,0,1237,2012,1432,243,4924,0,196,184,60,163,603,5527
WEST BENGAL,2007,House Wife,0,0,0,0,0,0,0,1541,1296,451,74,3362,3362
WEST BENGAL,2007,Service (Government),0,23,48,43,2,116,0,3,8,13,0,24,140
WEST BENGAL,2007,Service (Private),0,136,225,207,11,579,0,23,63,17,0,103,682
WEST BENGAL,2007,Public Sector Undertaking,0,130,327,192,6,655,0,42,24,18,0,84,739
WEST BENGAL,2007,Student,112,532,5,0,0,649,110,369,10,0,0,489,1138
WEST BENGAL,2007,Unemployed,3,321,348,129,4,805,10,137,183,32,0,362,1167
WEST BENGAL,2007,Self-employed (Business activity),0,312,506,316,24,1158,0,8,25,6,0,39,1197
WEST BENGAL,2007,Professional Activity,0,22,118,122,1,263,0,2,1,0,0,3,266
WEST BENGAL,2007,Farming/Agriculture Activity,5,188,432,185,68,878,0,68,98,40,18,224,1102
WEST BENGAL,2007,Others (Please Specify),61,562,824,449,183,2079,38,249,289,258,50,884,2963
WEST BENGAL,2007,Retired Person,0,0,0,0,95,95,0,0,0,0,16,16,111
WEST BENGAL,2007,Others (Please Specify),36,420,373,297,102,1228,44,288,181,178,74,765,1993
WEST BENGAL,2007,Total,217,2646,3206,1940,496,8505,202,2730,2178,1013,232,6355,14860
WEST BENGAL,2007,Total Salaried,0,289,600,442,19,1350,0,68,95,48,0,211,1561
WEST BENGAL,2007,Total Self-employed,66,1084,1880,1072,276,4378,38,327,413,304,68,1150,5528
WEST BENGAL,2008,House Wife,0,0,0,0,0,0,0,1607,1172,406,59,3244,3244
WEST BENGAL,2008,Service (Government),0,17,62,41,0,120,0,4,7,14,0,25,145
WEST BENGAL,2008,Service (Private),2,122,214,190,7,535,0,29,38,16,0,83,618
WEST BENGAL,2008,Public Sector Undertaking,0,58,275,201,3,537,1,19,43,22,0,85,622
WEST BENGAL,2008,Student,112,430,13,0,0,555,118,262,5,0,0,385,940
WEST BENGAL,2008,Unemployed,9,460,471,166,5,1111,15,152,212,66,1,446,1557
WEST BENGAL,2008,Self-employed (Business activity),0,242,403,210,27,882,0,16,30,6,0,52,934
WEST BENGAL,2008,Professional Activity,0,34,124,74,2,234,0,9,4,0,0,13,247
WEST BENGAL,2008,Farming/Agriculture Activity,0,161,311,159,29,660,0,33,50,12,4,99,759
WEST BENGAL,2008,Others (Please Specify),63,665,525,188,98,1539,25,324,167,106,30,652,2191
WEST BENGAL,2008,Retired Person,0,0,0,0,63,63,0,0,0,0,10,10,73
WEST BENGAL,2008,Others (Please Specify),89,617,929,364,134,2133,82,549,432,254,72,1389,3522
WEST BENGAL,2008,Total,275,2806,3327,1593,368,8369,241,3004,2160,902,176,6483,14852
WEST BENGAL,2008,Total Salaried,2,197,551,432,10,1192,1,52,88,52,0,193,1385
WEST BENGAL,2008,Total Self-employed,63,1102,1363,631,156,3315,25,382,251,124,34,816,4131
WEST BENGAL,2009,House Wife,0,0,0,0,0,0,0,1495,1256,488,66,3305,3305
WEST BENGAL,2009,Service (Government),0,32,94,53,0,179,0,19,26,14,1,60,239
WEST BENGAL,2009,Service (Private),0,143,241,266,6,656,0,64,80,15,1,160,816
WEST BENGAL,2009,Public Sector Undertaking,0,67,228,215,4,514,0,33,37,23,0,93,607
WEST BENGAL,2009,Student,117,313,23,0,0,453,120,279,18,0,0,417,870
WEST BENGAL,2009,Unemployed,1,448,591,108,3,1151,1,86,88,29,0,204,1355
WEST BENGAL,2009,Self-employed (Business activity),0,290,471,333,44,1138,0,69,83,44,4,200,1338
WEST BENGAL,2009,Professional Activity,0,23,96,59,2,180,0,15,13,0,0,28,208
WEST BENGAL,2009,Farming/Agriculture Activity,1,256,402,217,53,929,4,49,52,18,2,125,1054
WEST BENGAL,2009,Others (Please Specify),72,329,724,312,67,1504,18,204,168,90,26,506,2010
WEST BENGAL,2009,Retired Person,0,0,0,0,58,58,0,0,0,0,30,30,88
WEST BENGAL,2009,Others (Please Specify),44,506,539,417,226,1732,75,412,310,163,66,1026,2758
WEST BENGAL,2009,Total,235,2407,3409,1980,463,8494,218,2725,2131,884,196,6154,14648
WEST BENGAL,2009,Total Salaried,0,242,563,534,10,1349,0,116,143,52,2,313,1662
WEST BENGAL,2009,Total Self-employed,73,898,1693,921,166,3751,22,337,316,152,32,859,4610
WEST BENGAL,2010,House Wife,0,0,0,0,0,0,0,1271,1123,459,75,2928,2928
WEST BENGAL,2010,Service (Government),0,17,84,39,1,141,0,4,7,8,0,19,160
WEST BENGAL,2010,Service (Private),0,143,243,253,7,646,0,64,69,19,5,157,803
WEST BENGAL,2010,Public Sector Undertaking,0,83,264,195,2,544,0,57,44,12,11,124,668
WEST BENGAL,2010,Student,108,398,35,3,0,544,97,280,23,5,0,405,949
WEST BENGAL,2010,Unemployed,0,304,382,75,3,764,0,114,127,23,1,265,1029
WEST BENGAL,2010,Self-employed (Business activity),0,241,329,260,21,851,0,7,24,6,0,37,888
WEST BENGAL,2010,Professional Activity,0,56,232,102,11,401,0,31,53,10,6,100,501
WEST BENGAL,2010,Farming/Agriculture Activity,2,218,389,164,27,800,0,63,53,57,20,193,993
WEST BENGAL,2010,Others (Please Specify),70,634,932,627,214,2477,33,416,508,311,74,1342,3819
WEST BENGAL,2010,Retired Person,0,0,0,0,55,55,0,0,0,0,11,11,66
WEST BENGAL,2010,Others (Please Specify),88,582,605,586,217,2078,82,319,346,321,87,1155,3233
WEST BENGAL,2010,Total,268,2676,3495,2304,558,9301,212,2626,2377,1231,290,6736,16037
WEST BENGAL,2010,Total Salaried,0,243,591,487,10,1331,0,125,120,39,16,300,1631
WEST BENGAL,2010,Total Self-employed,72,1149,1882,1153,273,4529,33,517,638,384,100,1672,6201
WEST BENGAL,2011,House Wife,0,0,0,0,0,0,1,1218,1171,474,91,2955,2955
WEST BENGAL,2011,Service (Government),0,14,66,25,1,106,0,7,5,5,0,17,123
WEST BENGAL,2011,Service (Private),0,114,235,222,1,572,0,78,66,32,0,176,748
WEST BENGAL,2011,Public Sector Undertaking,0,73,245,191,0,509,0,90,61,30,2,183,692
WEST BENGAL,2011,Student,92,426,9,0,0,527,96,404,7,0,0,507,1034
WEST BENGAL,2011,Unemployed,0,394,638,139,24,1195,0,138,163,76,6,383,1578
WEST BENGAL,2011,Self-employed (Business activity),0,353,427,257,32,1069,15,15,39,18,0,87,1156
WEST BENGAL,2011,Professional Activity,0,43,165,151,8,367,0,16,18,13,0,47,414
WEST BENGAL,2011,Farming/Agriculture Activity,0,132,293,182,55,662,0,39,69,37,0,145,807
WEST BENGAL,2011,Others (Please Specify),31,302,727,528,195,1783,36,364,296,199,58,953,2736
WEST BENGAL,2011,Retired Person,0,0,0,0,61,61,0,0,0,0,11,11,72
WEST BENGAL,2011,Others (Please Specify),161,670,987,601,354,2773,110,344,431,277,242,1404,4177
WEST BENGAL,2011,Total,284,2521,3792,2296,731,9624,258,2713,2326,1161,410,6868,16492
WEST BENGAL,2011,Total Salaried,0,201,546,438,2,1187,0,175,132,67,2,376,1563
WEST BENGAL,2011,Total Self-employed,31,830,1612,1118,290,3881,51,434,422,267,58,1232,5113
WEST BENGAL,2012,House Wife,0,0,0,0,0,0,0,0,0,0,0,0,0
WEST BENGAL,2012,Service (Government),0,0,0,0,0,0,0,0,0,0,0,0,0
WEST BENGAL,2012,Service (Private),0,0,0,0,0,0,0,0,0,0,0,0,0
WEST BENGAL,2012,Public Sector Undertaking,0,0,0,0,0,0,0,0,0,0,0,0,0
WEST BENGAL,2012,Student,0,0,0,0,0,0,0,0,0,0,0,0,0
WEST BENGAL,2012,Unemployed,0,0,0,0,0,0,0,0,0,0,0,0,0
WEST BENGAL,2012,Self-employed (Business activity),0,0,0,0,0,0,0,0,0,0,0,0,0
WEST BENGAL,2012,Professional Activity,0,0,0,0,0,0,0,0,0,0,0,0,0
WEST BENGAL,2012,Farming/Agriculture Activity,0,0,0,0,0,0,0,0,0,0,0,0,0
WEST BENGAL,2012,Others (Please Specify),0,0,0,0,0,0,0,0,0,0,0,0,0
WEST BENGAL,2012,Retired Person,0,0,0,0,0,0,0,0,0,0,0,0,0
WEST BENGAL,2012,Others (Please Specify),0,0,0,0,0,0,0,0,0,0,0,0,0
WEST BENGAL,2012,Total,0,0,0,0,0,0,0,0,0,0,0,0,0
WEST BENGAL,2012,Total Salaried,0,0,0,0,0,0,0,0,0,0,0,0,0
WEST BENGAL,2012,Total Self-employed,0,0,0,0,0,0,0,0,0,0,0,0,0
TOTAL (STATES),2001,House Wife,0,0,0,0,0,0,69,9879,7077,2934,1166,21125,21125
TOTAL (STATES),2001,Service (Government),0,371,751,574,21,1717,0,201,231,70,14,516,2233
TOTAL (STATES),2001,Service (Private),24,2107,2881,1655,360,7027,60,692,483,298,110,1643,8670
TOTAL (STATES),2001,Public Sector Undertaking,0,628,636,465,126,1855,0,254,222,95,14,585,2440
TOTAL (STATES),2001,Student,671,2179,160,27,0,3037,526,1666,66,22,2,2282,5319
TOTAL (STATES),2001,Unemployed,52,2806,2912,1814,562,8146,51,855,595,194,90,1785,9931
TOTAL (STATES),2001,Self-employed (Business activity),39,1160,1881,1253,278,4611,25,204,182,148,64,623,5234
TOTAL (STATES),2001,Professional Activity,21,603,955,538,166,2283,11,107,99,76,23,316,2599
TOTAL (STATES),2001,Farming/Agriculture Activity,88,3808,5080,3375,1357,13708,80,1021,888,449,138,2576,16284
TOTAL (STATES),2001,Others (Please Specify),275,3514,4515,3117,1510,12931,243,1887,1436,898,453,4917,17848
TOTAL (STATES),2001,Retired Person,0,27,32,140,497,696,0,6,20,46,112,184,880
TOTAL (STATES),2001,Others (Please Specify),309,2322,3271,2221,964,9087,407,1693,1414,880,431,4825,13912
TOTAL (STATES),2001,Total,1479,19525,23074,15179,5841,65098,1472,18465,12713,6110,2617,41377,106475
TOTAL (STATES),2001,Total Salaried,24,3106,4268,2694,507,10599,60,1147,936,463,138,2744,13343
TOTAL (STATES),2001,Total Self-employed,423,9085,12431,8283,3311,33533,359,3219,2605,1571,678,8432,41965
TOTAL (STATES),2002,House Wife,0,0,0,0,0,0,30,10265,7506,3237,1257,22295,22295
TOTAL (STATES),2002,Service (Government),0,399,745,478,20,1642,0,161,200,125,8,494,2136
TOTAL (STATES),2002,Service (Private),11,2156,2763,1569,232,6731,14,639,477,224,75,1429,8160
TOTAL (STATES),2002,Public Sector Undertaking,0,588,674,461,71,1794,0,218,199,99,7,523,2317
TOTAL (STATES),2002,Student,568,2205,199,19,0,2991,660,1466,78,1,0,2205,5196
TOTAL (STATES),2002,Unemployed,35,2975,2907,1571,605,8093,39,917,556,181,66,1759,9852
TOTAL (STATES),2002,Self-employed (Business activity),14,1318,2184,1565,426,5507,11,190,170,132,48,551,6058
TOTAL (STATES),2002,Professional Activity,1,611,896,545,172,2225,0,67,83,78,13,241,2466
TOTAL (STATES),2002,Farming/Agriculture Activity,30,4109,5596,3917,1513,15165,28,1103,861,503,160,2655,17820
TOTAL (STATES),2002,Others (Please Specify),272,3662,4948,3150,1601,13633,416,1598,1202,724,397,4337,17970
TOTAL (STATES),2002,Retired Person,0,5,16,173,517,711,0,0,14,27,95,136,847
TOTAL (STATES),2002,Others (Please Specify),351,2427,3435,2271,1112,9596,354,1369,1163,516,384,3786,13382
TOTAL (STATES),2002,Total,1282,20455,24363,15719,6269,68088,1552,17993,12509,5847,2510,40411,108499
TOTAL (STATES),2002,Total Salaried,11,3143,4182,2508,323,10167,14,1018,876,448,90,2446,12613
TOTAL (STATES),2002,Total Self-employed,317,9700,13624,9177,3712,36530,455,2958,2316,1437,618,7784,44314
TOTAL (STATES),2003,House Wife,0,0,0,0,0,0,22,9849,7711,3767,1546,22895,22895
TOTAL (STATES),2003,Service (Government),1,481,768,567,22,1839,1,181,175,71,0,428,2267
TOTAL (STATES),2003,Service (Private),22,1914,2723,1562,228,6449,2,640,521,235,32,1430,7879
TOTAL (STATES),2003,Public Sector Undertaking,1,706,872,752,47,2378,3,242,157,80,5,487,2865
TOTAL (STATES),2003,Student,561,2425,288,37,2,3313,582,1839,171,15,0,2607,5920
TOTAL (STATES),2003,Unemployed,50,3142,2924,1222,508,7846,36,821,480,235,84,1656,9502
TOTAL (STATES),2003,Self-employed (Business activity),13,1204,1973,1557,397,5144,16,188,162,95,26,487,5631
TOTAL (STATES),2003,Professional Activity,5,805,1072,665,163,2710,1,93,101,60,16,271,2981
TOTAL (STATES),2003,Farming/Agriculture Activity,49,3779,5398,3782,1638,14646,71,1024,823,423,120,2461,17107
TOTAL (STATES),2003,Others (Please Specify),221,3947,4949,3576,1654,14347,202,1588,1001,658,385,3834,18181
TOTAL (STATES),2003,Retired Person,0,10,32,162,692,896,0,9,10,54,89,162,1058
TOTAL (STATES),2003,Others (Please Specify),329,2774,3190,2017,1027,9337,338,1236,857,455,313,3199,12536
TOTAL (STATES),2003,Total,1252,21187,24189,15899,6378,68905,1274,17710,12169,6148,2616,39917,108822
TOTAL (STATES),2003,Total Salaried,24,3101,4363,2881,297,10666,6,1063,853,386,37,2345,13011
TOTAL (STATES),2003,Total Self-employed,288,9735,13392,9580,3852,36847,290,2893,2087,1236,547,7053,43900
TOTAL (STATES),2004,House Wife,0,0,0,0,0,0,48,10395,7638,3356,1304,22741,22741
TOTAL (STATES),2004,Service (Government),0,365,753,433,17,1568,0,96,94,55,0,245,1813
TOTAL (STATES),2004,Service (Private),11,1831,2661,1572,209,6284,6,524,392,175,27,1124,7408
TOTAL (STATES),2004,Public Sector Undertaking,0,527,728,499,40,1794,0,135,154,82,8,379,2173
TOTAL (STATES),2004,Student,633,2227,170,0,0,3030,609,1755,44,1,1,2410,5440
TOTAL (STATES),2004,Unemployed,40,2938,2705,1381,428,7492,29,798,476,213,96,1612,9104
TOTAL (STATES),2004,Self-employed (Business activity),18,1385,2100,1472,395,5370,3,134,132,71,7,347,5717
TOTAL (STATES),2004,Professional Activity,5,695,921,655,142,2418,1,83,83,44,27,238,2656
TOTAL (STATES),2004,Farming/Agriculture Activity,26,4050,5947,4091,1672,15786,50,904,762,406,163,2285,18071
TOTAL (STATES),2004,Others (Please Specify),160,3978,5289,3954,1647,15028,203,1653,1142,748,408,4154,19182
TOTAL (STATES),2004,Retired Person,0,0,28,118,669,815,0,0,0,42,74,116,931
TOTAL (STATES),2004,Others (Please Specify),554,3132,4075,2642,1368,11771,475,1600,1327,831,413,4646,16417
TOTAL (STATES),2004,Total,1447,21128,25377,16817,6587,71356,1424,18077,12244,6024,2528,40297,111653
TOTAL (STATES),2004,Total Salaried,11,2723,4142,2504,266,9646,6,755,640,312,35,1748,11394
TOTAL (STATES),2004,Total Self-employed,209,10108,14257,10172,3856,38602,257,2774,2119,1269,605,7024,45626
TOTAL (STATES),2005,House Wife,0,0,0,0,0,0,30,10468,7786,3907,1458,23649,23649
TOTAL (STATES),2005,Service (Government),0,290,592,489,5,1376,0,80,118,46,1,245,1621
TOTAL (STATES),2005,Service (Private),20,2399,2876,1691,186,7172,33,608,413,174,64,1292,8464
TOTAL (STATES),2005,Public Sector Undertaking,0,465,742,517,32,1756,0,149,147,70,8,374,2130
TOTAL (STATES),2005,Student,575,2085,151,3,0,2814,575,1531,77,1,0,2184,4998
TOTAL (STATES),2005,Unemployed,40,2956,2448,1036,342,6822,13,874,451,158,92,1588,8410
TOTAL (STATES),2005,Self-employed (Business activity),21,1452,2273,1554,367,5667,3,192,183,108,48,534,6201
TOTAL (STATES),2005,Professional Activity,17,626,979,705,151,2478,5,107,49,50,20,231,2709
TOTAL (STATES),2005,Farming/Agriculture Activity,54,3604,5600,3859,1685,14802,41,758,751,417,187,2154,16956
TOTAL (STATES),2005,Others (Please Specify),179,3899,5223,3686,1879,14866,145,1556,943,738,338,3720,18586
TOTAL (STATES),2005,Retired Person,0,16,10,163,624,813,0,4,4,15,71,94,907
TOTAL (STATES),2005,Others (Please Specify),405,3512,4586,3266,1249,13018,363,1643,1109,639,399,4153,17171
TOTAL (STATES),2005,Total,1311,21304,25480,16969,6520,71584,1208,17970,12031,6323,2686,40218,111802
TOTAL (STATES),2005,Total Salaried,20,3154,4210,2697,223,10304,33,837,678,290,73,1911,12215
TOTAL (STATES),2005,Total Self-employed,271,9581,14075,9804,4082,37813,194,2613,1926,1313,593,6639,44452
TOTAL (STATES),2006,House Wife,0,0,0,0,0,0,40,11044,8215,3991,1281,24571,24571
TOTAL (STATES),2006,Service (Government),5,424,783,547,12,1771,0,120,124,54,8,306,2077
TOTAL (STATES),2006,Service (Private),6,2013,2940,1885,221,7065,0,879,453,200,19,1551,8616
TOTAL (STATES),2006,Public Sector Undertaking,2,600,923,418,56,1999,2,151,110,106,4,373,2372
TOTAL (STATES),2006,Student,553,2345,107,25,8,3038,615,1917,83,5,0,2620,5658
TOTAL (STATES),2006,Unemployed,10,3084,2551,1032,386,7063,5,788,364,166,76,1399,8462
TOTAL (STATES),2006,Self-employed (Business activity),5,1586,3031,1516,316,6454,2,139,208,65,9,423,6877
TOTAL (STATES),2006,Professional Activity,16,851,1358,971,208,3404,5,112,77,35,6,235,3639
TOTAL (STATES),2006,Farming/Agriculture Activity,56,3496,5678,3650,1593,14473,58,921,845,426,140,2390,16863
TOTAL (STATES),2006,Others (Please Specify),177,4574,5793,4386,1802,16732,180,1456,1048,582,542,3808,20540
TOTAL (STATES),2006,Retired Person,1,27,34,135,749,946,0,1,6,12,135,154,1100
TOTAL (STATES),2006,Others (Please Specify),345,3162,4063,2516,1172,11258,332,1445,1148,570,287,3782,15040
TOTAL (STATES),2006,Total,1176,22162,27261,17081,6523,74203,1239,18973,12681,6212,2507,41612,115815
TOTAL (STATES),2006,Total Salaried,13,3037,4646,2850,289,10835,2,1150,687,360,31,2230,13065
TOTAL (STATES),2006,Total Self-employed,254,10507,15860,10523,3919,41063,245,2628,2178,1108,697,6856,47919
TOTAL (STATES),2007,House Wife,0,0,0,0,0,0,49,10681,8050,3613,1342,23735,23735
TOTAL (STATES),2007,Service (Government),0,358,631,509,10,1508,1,115,105,53,15,289,1797
TOTAL (STATES),2007,Service (Private),30,2264,3313,2002,329,7938,6,950,503,258,67,1784,9722
TOTAL (STATES),2007,Public Sector Undertaking,0,542,990,584,83,2199,6,194,111,122,1,434,2633
TOTAL (STATES),2007,Student,591,2555,154,8,2,3310,621,2010,87,6,7,2731,6041
TOTAL (STATES),2007,Unemployed,28,2639,2319,1149,255,6390,32,860,574,190,53,1709,8099
TOTAL (STATES),2007,Self-employed (Business activity),1,1581,3209,1751,272,6814,1,156,204,57,6,424,7238
TOTAL (STATES),2007,Professional Activity,4,777,1228,782,191,2982,9,113,83,31,12,248,3230
TOTAL (STATES),2007,Farming/Agriculture Activity,46,3220,5366,3996,1644,14272,49,788,701,413,156,2107,16379
TOTAL (STATES),2007,Others (Please Specify),150,5313,6584,4939,2112,19098,191,1886,1533,934,404,4948,24046
TOTAL (STATES),2007,Retired Person,0,37,69,148,650,904,2,8,7,23,89,129,1033
TOTAL (STATES),2007,Others (Please Specify),317,3576,4117,2998,1376,12384,301,1420,1115,717,417,3970,16354
TOTAL (STATES),2007,Total,1167,22862,27980,18866,6924,77799,1268,19181,13073,6417,2569,42508,120307
TOTAL (STATES),2007,Total Salaried,30,3164,4934,3095,422,11645,13,1259,719,433,83,2507,14152
TOTAL (STATES),2007,Total Self-employed,201,10891,16387,11468,4219,43166,250,2943,2521,1435,578,7727,50893
TOTAL (STATES),2008,House Wife,0,0,0,0,0,0,51,10560,8434,3514,1363,23922,23922
TOTAL (STATES),2008,Service (Government),0,318,765,598,14,1695,0,129,132,60,12,333,2028
TOTAL (STATES),2008,Service (Private),7,2452,3568,2081,300,8408,8,974,534,217,49,1782,10190
TOTAL (STATES),2008,Public Sector Undertaking,4,620,1024,774,134,2556,3,213,137,122,35,510,3066
TOTAL (STATES),2008,Student,499,2544,184,35,4,3266,560,1952,56,4,0,2572,5838
TOTAL (STATES),2008,Unemployed,42,2822,2411,1286,307,6868,27,852,597,244,27,1747,8615
TOTAL (STATES),2008,Self-employed (Business activity),2,1479,3192,1533,350,6556,4,151,197,56,13,421,6977
TOTAL (STATES),2008,Professional Activity,5,743,1295,782,197,3022,5,174,127,49,20,375,3397
TOTAL (STATES),2008,Farming/Agriculture Activity,32,3451,5388,3713,1497,14081,38,750,755,368,136,2047,16128
TOTAL (STATES),2008,Others (Please Specify),214,5463,6163,4375,1869,18084,157,2044,1241,766,386,4594,22678
TOTAL (STATES),2008,Retired Person,0,12,35,145,553,745,0,3,6,20,103,132,877
TOTAL (STATES),2008,Others (Please Specify),341,3963,5020,3255,1353,13932,345,1947,1640,905,417,5254,19186
TOTAL (STATES),2008,Total,1146,23867,29045,18577,6578,79213,1198,19749,13856,6325,2561,43689,122902
TOTAL (STATES),2008,Total Salaried,11,3390,5357,3453,448,12659,11,1316,803,399,96,2625,15284
TOTAL (STATES),2008,Total Self-employed,253,11136,16038,10403,3913,41743,204,3119,2320,1239,555,7437,49180
TOTAL (STATES),2009,House Wife,0,0,0,0,0,0,62,10751,8459,3792,1524,24588,24588
TOTAL (STATES),2009,Service (Government),0,273,608,461,24,1366,0,125,108,59,2,294,1660
TOTAL (STATES),2009,Service (Private),3,2643,3800,2032,383,8861,2,722,500,239,64,1527,10388
TOTAL (STATES),2009,Public Sector Undertaking,0,707,940,652,136,2435,1,173,145,100,17,436,2871
TOTAL (STATES),2009,Student,636,2829,171,11,0,3647,609,2183,88,3,0,2883,6530
TOTAL (STATES),2009,Unemployed,36,2783,3338,1493,416,8066,25,639,422,275,88,1449,9515
TOTAL (STATES),2009,Self-employed (Business activity),24,1759,2732,2072,563,7150,2,199,229,103,19,552,7702
TOTAL (STATES),2009,Professional Activity,20,850,1214,937,199,3220,0,153,123,54,16,346,3566
TOTAL (STATES),2009,Farming/Agriculture Activity,46,3418,5762,3977,1563,14766,27,929,803,481,169,2409,17175
TOTAL (STATES),2009,Others (Please Specify),217,4541,6060,4232,1740,16790,297,1822,1597,868,349,4933,21723
TOTAL (STATES),2009,Retired Person,1,17,29,189,590,826,0,10,46,31,108,195,1021
TOTAL (STATES),2009,Others (Please Specify),500,3313,4211,3285,1601,12910,393,1953,1430,935,510,5221,18131
TOTAL (STATES),2009,Total,1483,23133,28865,19341,7215,80037,1418,19659,13950,6940,2866,44833,124870
TOTAL (STATES),2009,Total Salaried,3,3623,5348,3145,543,12662,3,1020,753,398,83,2257,14919
TOTAL (STATES),2009,Total Self-employed,307,10568,15768,11218,4065,41926,326,3103,2752,1506,553,8240,50166
TOTAL (STATES),2010,House Wife,0,0,0,0,0,0,58,10725,8389,3749,1608,24529,24529
TOTAL (STATES),2010,Service (Government),0,297,627,441,26,1391,0,198,144,52,3,397,1788
TOTAL (STATES),2010,Service (Private),14,2774,3485,2150,274,8697,9,737,484,192,39,1461,10158
TOTAL (STATES),2010,Public Sector Undertaking,18,635,1011,623,124,2411,1,170,176,74,16,437,2848
TOTAL (STATES),2010,Student,697,3045,136,42,7,3927,672,2483,68,8,0,3231,7158
TOTAL (STATES),2010,Unemployed,52,2828,3079,1440,531,7930,28,827,536,192,116,1699,9629
TOTAL (STATES),2010,Self-employed (Business activity),3,1874,2541,1680,453,6551,12,216,191,100,31,550,7101
TOTAL (STATES),2010,Professional Activity,4,989,1379,840,286,3498,8,137,133,53,16,347,3845
TOTAL (STATES),2010,Farming/Agriculture Activity,58,3411,5069,3608,1415,13561,46,889,759,453,225,2372,15933
TOTAL (STATES),2010,Others (Please Specify),313,6009,7650,5498,2233,21703,234,2445,1947,1139,448,6213,27916
TOTAL (STATES),2010,Retired Person,0,16,17,141,562,736,0,12,2,31,101,146,882
TOTAL (STATES),2010,Others (Please Specify),456,3935,4907,4050,1934,15282,393,1856,1353,1022,533,5157,20439
TOTAL (STATES),2010,Total,1615,25813,29901,20513,7845,85687,1461,20695,14182,7065,3136,46539,132226
TOTAL (STATES),2010,Total Salaried,32,3706,5123,3214,424,12499,10,1105,804,318,58,2295,14794
TOTAL (STATES),2010,Total Self-employed,378,12283,16639,11626,4387,45313,300,3687,3030,1745,720,9482,54795
TOTAL (STATES),2011,House Wife,0,0,0,0,0,0,81,10501,8387,3668,1515,24152,24152
TOTAL (STATES),2011,Service (Government),0,248,591,423,10,1272,1,121,115,38,10,285,1557
TOTAL (STATES),2011,Service (Private),7,2823,3788,2144,352,9114,4,740,611,241,53,1649,10763
TOTAL (STATES),2011,Public Sector Undertaking,8,565,824,602,82,2081,4,264,210,79,9,566,2647
TOTAL (STATES),2011,Student,604,3252,171,13,0,4040,544,2725,92,8,3,3372,7412
TOTAL (STATES),2011,Unemployed,64,2684,3328,1675,364,8115,42,860,520,270,60,1752,9867
TOTAL (STATES),2011,Self-employed (Business activity),2,1884,2552,1712,412,6562,15,213,201,90,7,526,7088
TOTAL (STATES),2011,Professional Activity,1,1055,1386,891,249,3582,3,181,127,85,45,441,4023
TOTAL (STATES),2011,Farming/Agriculture Activity,24,2961,4500,3220,1343,12048,19,762,693,391,91,1956,14004
TOTAL (STATES),2011,Others (Please Specify),235,5377,7413,5158,2329,20512,264,2175,1766,1076,458,5739,26251
TOTAL (STATES),2011,Retired Person,0,19,23,146,518,706,0,18,5,31,80,134,840
TOTAL (STATES),2011,Others (Please Specify),607,4939,6245,4228,2014,18033,454,2345,1888,984,667,6338,24371
TOTAL (STATES),2011,Total,1552,25807,30821,20212,7673,86065,1431,20905,14615,6961,2998,46910,132975
TOTAL (STATES),2011,Total Salaried,15,3636,5203,3169,444,12467,9,1125,936,358,72,2500,14967
TOTAL (STATES),2011,Total Self-employed,262,11277,15851,10981,4333,42704,301,3331,2787,1642,601,8662,51366
TOTAL (STATES),2012,House Wife,0,0,0,0,0,0,28,9330,7100,3493,1428,21379,21379
TOTAL (STATES),2012,Service (Government),0,256,535,476,25,1292,6,122,125,44,3,300,1592
TOTAL (STATES),2012,Service (Private),21,3118,3764,2067,332,9302,22,747,530,214,43,1556,10858
TOTAL (STATES),2012,Public Sector Undertaking,0,464,681,447,82,1674,9,104,187,79,9,388,2062
TOTAL (STATES),2012,Student,514,2630,141,22,0,3307,542,2330,115,7,8,3002,6309
TOTAL (STATES),2012,Unemployed,35,2246,2558,1735,473,7047,26,636,456,227,60,1405,8452
TOTAL (STATES),2012,Self-employed (Business activity),10,1312,2049,1498,437,5306,4,118,127,73,10,332,5638
TOTAL (STATES),2012,Professional Activity,7,830,1167,805,223,3032,1,136,112,46,13,308,3340
TOTAL (STATES),2012,Farming/Agriculture Activity,6,2612,4368,3448,1490,11924,18,607,674,356,148,1803,13727
TOTAL (STATES),2012,Others (Please Specify),193,5214,6959,4745,1991,19102,210,1783,1227,735,341,4296,23398
TOTAL (STATES),2012,Retired Person,0,9,18,182,499,708,5,9,2,14,71,101,809
TOTAL (STATES),2012,Others (Please Specify),303,3916,5606,3493,1921,15239,285,1918,1234,853,617,4907,20146
TOTAL (STATES),2012,Total,1089,22607,27846,18918,7473,77933,1156,17840,11889,6141,2751,39777,117710
TOTAL (STATES),2012,Total Salaried,21,3838,4980,2990,439,12268,37,973,842,337,55,2244,14512
TOTAL (STATES),2012,Total Self-employed,216,9968,14543,10496,4141,39364,233,2644,2140,1210,512,6739,46103
A & N ISLANDS,2001,House Wife,0,0,0,0,0,0,0,21,9,5,3,38,38
A & N ISLANDS,2001,Service (Government),0,3,10,7,0,20,0,0,0,0,0,0,20
A & N ISLANDS,2001,Service (Private),0,14,7,9,2,32,0,0,0,0,0,0,32
A & N ISLANDS,2001,Public Sector Undertaking,0,2,1,1,0,4,0,0,0,0,0,0,4
A & N ISLANDS,2001,Student,1,2,0,0,0,3,2,9,0,0,0,11,14
A & N ISLANDS,2001,Unemployed,0,0,0,0,0,0,0,0,0,0,0,0,0
A & N ISLANDS,2001,Self-employed (Business activity),0,0,0,0,0,0,0,0,0,0,0,0,0
A & N ISLANDS,2001,Professional Activity,0,0,0,0,0,0,0,0,0,0,0,0,0
A & N ISLANDS,2001,Farming/Agriculture Activity,0,0,0,0,3,3,0,0,0,0,0,0,3
A & N ISLANDS,2001,Others (Please Specify),1,4,5,4,1,15,0,1,0,0,0,1,16
A & N ISLANDS,2001,Retired Person,0,0,0,0,2,2,0,0,0,0,0,0,2
A & N ISLANDS,2001,Others (Please Specify),0,0,0,0,0,0,0,0,0,0,0,0,0
A & N ISLANDS,2001,Total,2,25,23,21,8,79,2,31,9,5,3,50,129
A & N ISLANDS,2001,Total Salaried,0,19,18,17,2,56,0,0,0,0,0,0,56
A & N ISLANDS,2001,Total Self-employed,1,4,5,4,4,18,0,1,0,0,0,1,19
A & N ISLANDS,2002,House Wife,0,0,0,0,0,0,0,22,13,6,3,44,44
A & N ISLANDS,2002,Service (Government),0,2,8,8,0,18,0,0,1,0,0,1,19
A & N ISLANDS,2002,Service (Private),0,20,16,13,7,56,0,0,0,0,0,0,56
A & N ISLANDS,2002,Public Sector Undertaking,0,0,0,0,0,0,0,0,0,0,0,0,0
A & N ISLANDS,2002,Student,2,3,0,0,0,5,2,6,0,0,0,8,13
A & N ISLANDS,2002,Unemployed,0,0,0,0,0,0,0,0,0,0,0,0,0
A & N ISLANDS,2002,Self-employed (Business activity),0,1,0,0,0,1,0,0,0,0,0,0,1
A & N ISLANDS,2002,Professional Activity,0,0,0,0,0,0,0,0,0,0,0,0,0
A & N ISLANDS,2002,Farming/Agriculture Activity,0,1,3,0,3,7,0,0,0,0,0,0,7
A & N ISLANDS,2002,Others (Please Specify),0,0,1,0,0,1,0,0,0,0,0,0,1
A & N ISLANDS,2002,Retired Person,0,0,0,0,3,3,0,0,0,0,0,0,3
A & N ISLANDS,2002,Others (Please Specify),0,0,0,0,0,0,0,0,0,0,0,0,0
A & N ISLANDS,2002,Total,2,27,28,21,13,91,2,28,14,6,3,53,144
A & N ISLANDS,2002,Total Salaried,0,22,24,21,7,74,0,0,1,0,0,1,75
A & N ISLANDS,2002,Total Self-employed,0,2,4,0,3,9,0,0,0,0,0,0,9
A & N ISLANDS,2003,House Wife,0,0,0,0,0,0,0,17,8,2,1,28,28
A & N ISLANDS,2003,Service (Government),0,0,7,6,1,14,0,1,0,0,0,1,15
A & N ISLANDS,2003,Service (Private),0,17,13,10,2,42,0,0,0,0,0,0,42
A & N ISLANDS,2003,Public Sector Undertaking,0,1,2,0,0,3,0,0,0,0,0,0,3
A & N ISLANDS,2003,Student,1,1,0,0,0,2,4,4,0,0,0,8,10
A & N ISLANDS,2003,Unemployed,0,3,1,0,2,6,0,6,0,0,0,6,12
A & N ISLANDS,2003,Self-employed (Business activity),0,0,0,0,0,0,0,0,0,0,0,0,0
A & N ISLANDS,2003,Professional Activity,0,0,0,0,0,0,0,0,0,0,0,0,0
A & N ISLANDS,2003,Farming/Agriculture Activity,0,1,0,0,0,1,0,0,0,0,0,0,1
A & N ISLANDS,2003,Others (Please Specify),0,0,0,0,0,0,0,0,0,0,0,0,0
A & N ISLANDS,2003,Retired Person,0,0,0,1,1,2,0,0,0,0,0,0,2
A & N ISLANDS,2003,Others (Please Specify),0,0,0,0,0,0,0,0,0,0,0,0,0
A & N ISLANDS,2003,Total,1,23,23,17,6,70,4,28,8,2,1,43,113
A & N ISLANDS,2003,Total Salaried,0,18,22,16,3,59,0,1,0,0,0,1,60
A & N ISLANDS,2003,Total Self-employed,0,1,0,0,0,1,0,0,0,0,0,0,1
A & N ISLANDS,2004,House Wife,0,0,0,0,0,0,0,10,11,3,1,25,25
A & N ISLANDS,2004,Service (Government),0,4,7,7,0,18,0,0,2,0,0,2,20
A & N ISLANDS,2004,Service (Private),0,13,13,6,4,36,0,1,0,0,0,1,37
A & N ISLANDS,2004,Public Sector Undertaking,0,0,0,0,0,0,0,0,0,0,0,0,0
A & N ISLANDS,2004,Student,0,8,0,0,0,8,1,7,0,0,0,8,16
A & N ISLANDS,2004,Unemployed,0,0,0,0,0,0,0,1,0,0,0,1,1
A & N ISLANDS,2004,Self-employed (Business activity),0,2,2,0,0,4,0,0,0,0,0,0,4
A & N ISLANDS,2004,Professional Activity,0,1,0,1,0,2,0,0,0,0,0,0,2
A & N ISLANDS,2004,Farming/Agriculture Activity,0,1,0,0,2,3,0,0,0,0,0,0,3
A & N ISLANDS,2004,Others (Please Specify),0,0,0,0,0,0,0,1,0,0,0,1,1
A & N ISLANDS,2004,Retired Person,0,0,0,0,2,2,0,0,0,0,0,0,2
A & N ISLANDS,2004,Others (Please Specify),0,5,2,0,1,8,0,3,0,0,0,3,11
A & N ISLANDS,2004,Total,0,34,24,14,9,81,1,23,13,3,1,41,122
A & N ISLANDS,2004,Total Salaried,0,17,20,13,4,54,0,1,2,0,0,3,57
A & N ISLANDS,2004,Total Self-employed,0,4,2,1,2,9,0,1,0,0,0,1,10
A & N ISLANDS,2005,House Wife,0,0,0,0,0,0,0,11,7,10,4,32,32
A & N ISLANDS,2005,Service (Government),0,1,5,7,0,13,0,0,0,0,0,0,13
A & N ISLANDS,2005,Service (Private),0,9,12,14,12,47,0,4,0,0,0,4,51
A & N ISLANDS,2005,Public Sector Undertaking,0,0,0,0,0,0,0,0,0,0,0,0,0
A & N ISLANDS,2005,Student,2,3,0,0,0,5,3,4,0,0,0,7,12
A & N ISLANDS,2005,Unemployed,0,1,1,1,0,3,0,8,0,0,1,9,12
A & N ISLANDS,2005,Self-employed (Business activity),3,1,0,0,1,5,0,0,0,0,0,0,5
A & N ISLANDS,2005,Professional Activity,0,0,0,0,0,0,0,0,0,0,0,0,0
A & N ISLANDS,2005,Farming/Agriculture Activity,0,0,2,1,4,7,0,0,1,0,0,1,8
A & N ISLANDS,2005,Others (Please Specify),0,0,4,2,0,6,0,0,0,0,0,0,6
A & N ISLANDS,2005,Retired Person,0,0,0,0,0,0,0,0,0,0,0,0,0
A & N ISLANDS,2005,Others (Please Specify),0,0,0,0,0,0,0,0,0,0,0,0,0
A & N ISLANDS,2005,Total,5,15,24,25,17,86,3,27,8,10,5,53,139
A & N ISLANDS,2005,Total Salaried,0,10,17,21,12,60,0,4,0,0,0,4,64
A & N ISLANDS,2005,Total Self-employed,3,1,6,3,5,18,0,0,1,0,0,1,19
A & N ISLANDS,2006,House Wife,0,0,0,0,0,0,0,18,10,3,2,33,33
A & N ISLANDS,2006,Service (Government),0,3,4,4,0,11,0,0,0,0,0,0,11
A & N ISLANDS,2006,Service (Private),0,10,28,18,6,62,0,1,0,0,0,1,63
A & N ISLANDS,2006,Public Sector Undertaking,0,0,0,0,0,0,0,0,0,0,0,0,0
A & N ISLANDS,2006,Student,1,0,0,0,0,1,1,2,0,0,0,3,4
A & N ISLANDS,2006,Unemployed,0,2,0,0,0,2,0,0,0,0,0,0,2
A & N ISLANDS,2006,Self-employed (Business activity),0,2,0,2,0,4,0,0,0,0,0,0,4
A & N ISLANDS,2006,Professional Activity,0,0,0,0,0,0,0,0,0,0,0,0,0
A & N ISLANDS,2006,Farming/Agriculture Activity,0,2,2,1,1,6,0,0,0,0,0,0,6
A & N ISLANDS,2006,Others (Please Specify),0,0,0,0,0,0,0,0,0,0,0,0,0
A & N ISLANDS,2006,Retired Person,0,0,0,0,0,0,0,0,0,0,0,0,0
A & N ISLANDS,2006,Others (Please Specify),3,2,0,0,5,10,0,0,0,0,0,0,10
A & N ISLANDS,2006,Total,4,21,34,25,12,96,1,21,10,3,2,37,133
A & N ISLANDS,2006,Total Salaried,0,13,32,22,6,73,0,1,0,0,0,1,74
A & N ISLANDS,2006,Total Self-employed,0,4,2,3,1,10,0,0,0,0,0,0,10
A & N ISLANDS,2007,House Wife,0,0,0,0,0,0,0,10,10,8,2,30,30
A & N ISLANDS,2007,Service (Government),0,1,4,4,0,9,0,1,0,0,0,1,10
A & N ISLANDS,2007,Service (Private),0,17,12,8,2,39,0,1,0,0,0,1,40
A & N ISLANDS,2007,Public Sector Undertaking,0,0,0,0,0,0,0,0,0,0,0,0,0
A & N ISLANDS,2007,Student,0,4,0,0,0,4,4,9,0,0,0,13,17
A & N ISLANDS,2007,Unemployed,0,9,1,1,1,12,0,0,0,0,0,0,12
A & N ISLANDS,2007,Self-employed (Business activity),0,0,0,0,0,0,0,0,0,0,0,0,0
A & N ISLANDS,2007,Professional Activity,0,0,0,0,0,0,0,0,0,0,0,0,0
A & N ISLANDS,2007,Farming/Agriculture Activity,0,4,3,5,4,16,0,0,0,0,0,0,16
A & N ISLANDS,2007,Others (Please Specify),0,0,2,4,1,7,0,0,0,0,0,0,7
A & N ISLANDS,2007,Retired Person,0,0,0,1,2,3,0,0,0,0,0,0,3
A & N ISLANDS,2007,Others (Please Specify),0,1,4,4,1,10,2,9,0,0,0,11,21
A & N ISLANDS,2007,Total,0,36,26,27,11,100,6,30,10,8,2,56,156
A & N ISLANDS,2007,Total Salaried,0,18,16,12,2,48,0,2,0,0,0,2,50
A & N ISLANDS,2007,Total Self-employed,0,4,5,9,5,23,0,0,0,0,0,0,23
A & N ISLANDS,2008,House Wife,0,0,0,0,0,0,0,10,13,5,4,32,32
A & N ISLANDS,2008,Service (Government),0,2,2,3,0,7,0,0,0,0,0,0,7
A & N ISLANDS,2008,Service (Private),0,17,15,8,3,43,0,1,0,0,0,1,44
A & N ISLANDS,2008,Public Sector Undertaking,0,0,0,0,0,0,0,0,0,0,0,0,0
A & N ISLANDS,2008,Student,0,4,0,0,0,4,0,7,0,0,0,7,11
A & N ISLANDS,2008,Unemployed,0,2,1,0,2,5,0,0,0,0,0,0,5
A & N ISLANDS,2008,Self-employed (Business activity),0,0,1,0,0,1,0,0,0,0,0,0,1
A & N ISLANDS,2008,Professional Activity,0,0,0,0,0,0,0,0,0,0,0,0,0
A & N ISLANDS,2008,Farming/Agriculture Activity,0,5,8,6,4,23,0,0,0,0,0,0,23
A & N ISLANDS,2008,Others (Please Specify),0,0,2,1,1,4,0,0,0,0,0,0,4
A & N ISLANDS,2008,Retired Person,0,0,0,1,3,4,0,0,0,0,0,0,4
A & N ISLANDS,2008,Others (Please Specify),0,1,3,2,1,7,0,5,0,0,0,5,12
A & N ISLANDS,2008,Total,0,31,32,21,14,98,0,23,13,5,4,45,143
A & N ISLANDS,2008,Total Salaried,0,19,17,11,3,50,0,1,0,0,0,1,51
A & N ISLANDS,2008,Total Self-employed,0,5,11,7,5,28,0,0,0,0,0,0,28
A & N ISLANDS,2009,House Wife,0,0,0,0,0,0,0,14,10,4,1,29,29
A & N ISLANDS,2009,Service (Government),0,0,3,9,1,13,0,0,1,0,0,1,14
A & N ISLANDS,2009,Service (Private),0,20,10,10,2,42,0,0,2,0,0,2,44
A & N ISLANDS,2009,Public Sector Undertaking,0,0,0,0,0,0,0,0,0,0,0,0,0
A & N ISLANDS,2009,Student,1,2,0,0,0,3,7,3,0,0,0,10,13
A & N ISLANDS,2009,Unemployed,0,0,0,0,0,0,0,0,0,0,0,0,0
A & N ISLANDS,2009,Self-employed (Business activity),0,0,2,0,0,2,0,0,0,0,0,0,2
A & N ISLANDS,2009,Professional Activity,0,0,0,0,0,0,0,0,0,0,0,0,0
A & N ISLANDS,2009,Farming/Agriculture Activity,0,5,7,5,2,19,0,0,0,0,0,0,19
A & N ISLANDS,2009,Others (Please Specify),0,4,1,1,0,6,0,2,1,0,0,3,9
A & N ISLANDS,2009,Retired Person,0,0,0,0,1,1,0,0,0,0,0,0,1
A & N ISLANDS,2009,Others (Please Specify),0,0,0,0,0,0,0,0,0,0,0,0,0
A & N ISLANDS,2009,Total,1,31,23,25,6,86,7,19,14,4,1,45,131
A & N ISLANDS,2009,Total Salaried,0,20,13,19,3,55,0,0,3,0,0,3,58
A & N ISLANDS,2009,Total Self-employed,0,9,10,6,2,27,0,2,1,0,0,3,30
A & N ISLANDS,2010,House Wife,0,0,0,0,0,0,0,15,11,2,3,31,31
A & N ISLANDS,2010,Service (Government),0,3,8,7,0,18,0,1,0,0,0,1,19
A & N ISLANDS,2010,Service (Private),0,16,19,10,3,48,0,2,0,0,0,2,50
A & N ISLANDS,2010,Public Sector Undertaking,0,0,0,0,0,0,0,0,0,0,0,0,0
A & N ISLANDS,2010,Student,4,4,0,0,0,8,0,6,0,0,0,6,14
A & N ISLANDS,2010,Unemployed,0,13,0,0,0,13,0,4,0,0,0,4,17
A & N ISLANDS,2010,Self-employed (Business activity),0,1,3,1,1,6,0,0,0,0,0,0,6
A & N ISLANDS,2010,Professional Activity,0,0,0,0,0,0,0,0,0,0,0,0,0
A & N ISLANDS,2010,Farming/Agriculture Activity,0,1,2,0,5,8,0,0,0,0,0,0,8
A & N ISLANDS,2010,Others (Please Specify),0,0,1,0,1,2,0,0,0,0,0,0,2
A & N ISLANDS,2010,Retired Person,0,0,0,0,8,8,0,0,0,0,0,0,8
A & N ISLANDS,2010,Others (Please Specify),0,1,0,0,0,1,0,0,0,0,0,0,1
A & N ISLANDS,2010,Total,4,39,33,18,18,112,0,28,11,2,3,44,156
A & N ISLANDS,2010,Total Salaried,0,19,27,17,3,66,0,3,0,0,0,3,69
A & N ISLANDS,2010,Total Self-employed,0,2,6,1,7,16,0,0,0,0,0,0,16
A & N ISLANDS,2011,House Wife,0,0,0,0,0,0,0,3,4,2,1,10,10
A & N ISLANDS,2011,Service (Government),0,7,6,4,1,18,0,2,1,1,0,4,22
A & N ISLANDS,2011,Service (Private),0,7,17,8,1,33,0,4,4,1,1,10,43
A & N ISLANDS,2011,Public Sector Undertaking,0,0,0,0,0,0,0,0,0,0,0,0,0
A & N ISLANDS,2011,Student,1,9,0,0,0,10,4,8,0,1,0,13,23
A & N ISLANDS,2011,Unemployed,0,3,5,2,0,10,0,0,0,1,0,1,11
A & N ISLANDS,2011,Self-employed (Business activity),0,0,3,4,0,7,0,2,0,0,0,2,9
A & N ISLANDS,2011,Professional Activity,0,0,0,0,0,0,0,0,0,0,0,0,0
A & N ISLANDS,2011,Farming/Agriculture Activity,0,0,0,0,0,0,0,0,0,0,0,0,0
A & N ISLANDS,2011,Others (Please Specify),0,0,3,0,0,3,0,0,1,0,0,1,4
A & N ISLANDS,2011,Retired Person,0,0,0,0,5,5,0,0,1,0,0,1,6
A & N ISLANDS,2011,Others (Please Specify),0,2,1,2,3,8,0,0,0,0,0,0,8
A & N ISLANDS,2011,Total,1,28,35,20,10,94,4,19,11,6,2,42,136
A & N ISLANDS,2011,Total Salaried,0,14,23,12,2,51,0,6,5,2,1,14,65
A & N ISLANDS,2011,Total Self-employed,0,0,6,4,0,10,0,2,1,0,0,3,13
A & N ISLANDS,2012,House Wife,0,0,0,0,0,0,0,11,11,2,4,28,28
A & N ISLANDS,2012,Service (Government),0,1,5,11,1,18,0,1,1,1,0,3,21
A & N ISLANDS,2012,Service (Private),0,12,21,9,7,49,0,1,0,0,0,1,50
A & N ISLANDS,2012,Public Sector Undertaking,0,0,0,0,0,0,0,0,0,0,0,0,0
A & N ISLANDS,2012,Student,2,2,0,0,0,4,1,4,0,0,0,5,9
A & N ISLANDS,2012,Unemployed,0,4,0,0,0,4,0,1,0,0,0,1,5
A & N ISLANDS,2012,Self-employed (Business activity),0,0,0,0,0,0,0,0,0,0,0,0,0
A & N ISLANDS,2012,Professional Activity,0,0,0,0,0,0,0,0,0,0,0,0,0
A & N ISLANDS,2012,Farming/Agriculture Activity,0,0,0,0,0,0,0,0,0,0,0,0,0
A & N ISLANDS,2012,Others (Please Specify),0,3,0,0,1,4,0,3,0,0,0,3,7
A & N ISLANDS,2012,Retired Person,0,0,0,0,1,1,0,0,0,0,0,0,1
A & N ISLANDS,2012,Others (Please Specify),0,0,0,0,0,0,0,0,0,0,0,0,0
A & N ISLANDS,2012,Total,2,22,26,20,10,80,1,21,12,3,4,41,121
A & N ISLANDS,2012,Total Salaried,0,13,26,20,8,67,0,2,1,1,0,4,71
A & N ISLANDS,2012,Total Self-employed,0,3,0,0,1,4,0,3,0,0,0,3,7
CHANDIGARH,2001,House Wife,0,0,0,0,0,0,0,11,6,2,0,19,19
CHANDIGARH,2001,Service (Government),0,1,1,1,0,3,0,0,0,0,0,0,3
CHANDIGARH,2001,Service (Private),0,4,4,0,0,8,0,0,0,0,0,0,8
CHANDIGARH,2001,Public Sector Undertaking,0,0,0,0,0,0,0,0,0,0,0,0,0
CHANDIGARH,2001,Student,0,4,0,0,0,4,0,2,0,0,0,2,6
CHANDIGARH,2001,Unemployed,0,1,0,0,0,1,0,0,0,0,0,0,1
CHANDIGARH,2001,Self-employed (Business activity),0,1,0,0,0,1,0,0,0,0,0,0,1
CHANDIGARH,2001,Professional Activity,0,0,0,0,0,0,0,0,0,0,0,0,0
CHANDIGARH,2001,Farming/Agriculture Activity,0,0,0,0,0,0,0,0,0,0,0,0,0
CHANDIGARH,2001,Others (Please Specify),0,2,4,0,0,6,0,0,0,0,0,0,6
CHANDIGARH,2001,Retired Person,0,0,0,0,1,1,0,0,0,0,0,0,1
CHANDIGARH,2001,Others (Please Specify),0,7,6,1,1,15,0,5,5,0,0,10,25
CHANDIGARH,2001,Total,0,20,15,2,2,39,0,18,11,2,0,31,70
CHANDIGARH,2001,Total Salaried,0,5,5,1,0,11,0,0,0,0,0,0,11
CHANDIGARH,2001,Total Self-employed,0,3,4,0,0,7,0,0,0,0,0,0,7
CHANDIGARH,2002,House Wife,0,0,0,0,0,0,0,13,5,1,2,21,21
CHANDIGARH,2002,Service (Government),0,0,3,0,0,3,0,0,0,0,0,0,3
CHANDIGARH,2002,Service (Private),0,0,10,2,0,12,0,0,1,0,0,1,13
CHANDIGARH,2002,Public Sector Undertaking,0,0,0,0,0,0,0,0,0,0,0,0,0
CHANDIGARH,2002,Student,0,5,0,0,0,5,0,4,0,0,0,4,9
CHANDIGARH,2002,Unemployed,1,2,0,0,0,3,1,3,0,0,0,4,7
CHANDIGARH,2002,Self-employed (Business activity),0,0,1,0,0,1,0,0,0,0,0,0,1
CHANDIGARH,2002,Professional Activity,0,0,0,0,0,0,0,0,0,0,0,0,0
CHANDIGARH,2002,Farming/Agriculture Activity,0,0,0,0,0,0,0,0,0,0,0,0,0
CHANDIGARH,2002,Others (Please Specify),0,0,0,0,0,0,0,0,0,0,0,0,0
CHANDIGARH,2002,Retired Person,0,0,0,0,0,0,0,0,0,0,0,0,0
CHANDIGARH,2002,Others (Please Specify),0,16,12,1,0,29,0,3,1,0,0,4,33
CHANDIGARH,2002,Total,1,23,26,3,0,53,1,23,7,1,2,34,87
CHANDIGARH,2002,Total Salaried,0,0,13,2,0,15,0,0,1,0,0,1,16
CHANDIGARH,2002,Total Self-employed,0,0,1,0,0,1,0,0,0,0,0,0,1
CHANDIGARH,2003,House Wife,0,0,0,0,0,0,0,11,7,2,2,22,22
CHANDIGARH,2003,Service (Government),0,2,6,1,0,9,0,0,0,0,0,0,9
CHANDIGARH,2003,Service (Private),0,9,11,3,1,24,0,1,0,0,0,1,25
CHANDIGARH,2003,Public Sector Undertaking,0,0,0,0,0,0,0,0,0,0,0,0,0
CHANDIGARH,2003,Student,0,4,0,0,0,4,1,7,0,0,0,8,12
CHANDIGARH,2003,Unemployed,0,9,3,0,0,12,0,2,1,0,0,3,15
CHANDIGARH,2003,Self-employed (Business activity),0,0,0,0,0,0,0,0,0,0,0,0,0
CHANDIGARH,2003,Professional Activity,0,1,1,0,0,2,0,0,0,0,0,0,2
CHANDIGARH,2003,Farming/Agriculture Activity,0,1,0,1,0,2,0,0,0,0,0,0,2
CHANDIGARH,2003,Others (Please Specify),0,0,0,0,0,0,0,0,0,0,0,0,0
CHANDIGARH,2003,Retired Person,0,0,0,1,1,2,0,0,0,0,0,0,2
CHANDIGARH,2003,Others (Please Specify),0,4,6,2,1,13,0,1,0,0,0,1,14
CHANDIGARH,2003,Total,0,30,27,8,3,68,1,22,8,2,2,35,103
CHANDIGARH,2003,Total Salaried,0,11,17,4,1,33,0,1,0,0,0,1,34
CHANDIGARH,2003,Total Self-employed,0,2,1,1,0,4,0,0,0,0,0,0,4
CHANDIGARH,2004,House Wife,0,0,0,0,0,0,0,10,2,0,0,12,12
CHANDIGARH,2004,Service (Government),0,0,3,0,0,3,0,0,0,1,0,1,4
CHANDIGARH,2004,Service (Private),0,6,4,1,0,11,0,0,0,0,0,0,11
CHANDIGARH,2004,Public Sector Undertaking,0,0,0,0,0,0,0,0,0,0,0,0,0
CHANDIGARH,2004,Student,0,5,0,0,0,5,0,8,0,0,0,8,13
CHANDIGARH,2004,Unemployed,0,8,3,1,0,12,0,1,0,0,0,1,13
CHANDIGARH,2004,Self-employed (Business activity),0,0,4,0,0,4,0,0,0,0,0,0,4
CHANDIGARH,2004,Professional Activity,0,0,0,1,0,1,0,0,0,0,0,0,1
CHANDIGARH,2004,Farming/Agriculture Activity,0,0,0,0,0,0,0,0,0,0,0,0,0
CHANDIGARH,2004,Others (Please Specify),0,3,5,4,0,12,0,0,0,0,0,0,12
CHANDIGARH,2004,Retired Person,0,0,0,0,0,0,0,0,0,0,0,0,0
CHANDIGARH,2004,Others (Please Specify),0,1,2,0,1,4,0,0,0,1,0,1,5
CHANDIGARH,2004,Total,0,23,21,7,1,52,0,19,2,2,0,23,75
CHANDIGARH,2004,Total Salaried,0,6,7,1,0,14,0,0,0,1,0,1,15
CHANDIGARH,2004,Total Self-employed,0,3,9,5,0,17,0,0,0,0,0,0,17
CHANDIGARH,2005,House Wife,0,0,0,0,0,0,0,6,5,3,0,14,14
CHANDIGARH,2005,Service (Government),0,1,0,1,0,2,0,0,0,1,0,1,3
CHANDIGARH,2005,Service (Private),0,5,6,6,0,17,0,1,0,0,0,1,18
CHANDIGARH,2005,Public Sector Undertaking,0,0,5,0,0,5,0,0,0,0,0,0,5
CHANDIGARH,2005,Student,1,2,0,0,0,3,0,3,0,0,0,3,6
CHANDIGARH,2005,Unemployed,0,12,3,0,0,15,0,2,0,0,0,2,17
CHANDIGARH,2005,Self-employed (Business activity),0,8,2,1,0,11,0,0,0,0,0,0,11
CHANDIGARH,2005,Professional Activity,0,0,0,0,0,0,0,0,0,0,0,0,0
CHANDIGARH,2005,Farming/Agriculture Activity,0,0,0,0,0,0,0,0,0,0,0,0,0
CHANDIGARH,2005,Others (Please Specify),0,5,2,2,0,9,0,3,1,0,0,4,13
CHANDIGARH,2005,Retired Person,0,0,0,0,0,0,0,0,0,0,0,0,0
CHANDIGARH,2005,Others (Please Specify),1,0,0,0,0,1,1,0,0,0,0,1,2
CHANDIGARH,2005,Total,2,33,18,10,0,63,1,15,6,4,0,26,89
CHANDIGARH,2005,Total Salaried,0,6,11,7,0,24,0,1,0,1,0,2,26
CHANDIGARH,2005,Total Self-employed,0,13,4,3,0,20,0,3,1,0,0,4,24
CHANDIGARH,2006,House Wife,0,0,0,0,0,0,0,3,6,1,1,11,11
CHANDIGARH,2006,Service (Government),0,2,3,2,0,7,0,0,0,0,0,0,7
CHANDIGARH,2006,Service (Private),0,5,8,0,0,13,0,2,0,0,0,2,15
CHANDIGARH,2006,Public Sector Undertaking,0,0,0,0,0,0,0,0,0,0,0,0,0
CHANDIGARH,2006,Student,0,11,0,0,0,11,2,7,0,0,0,9,20
CHANDIGARH,2006,Unemployed,0,7,15,1,0,23,0,2,0,0,0,2,25
CHANDIGARH,2006,Self-employed (Business activity),0,0,0,0,1,1,0,0,0,0,0,0,1
CHANDIGARH,2006,Professional Activity,0,0,0,0,0,0,0,0,0,0,0,0,0
CHANDIGARH,2006,Farming/Agriculture Activity,0,1,0,0,0,1,0,0,0,0,0,0,1
CHANDIGARH,2006,Others (Please Specify),0,0,0,0,0,0,0,0,0,0,0,0,0
CHANDIGARH,2006,Retired Person,0,0,0,0,0,0,0,0,0,0,0,0,0
CHANDIGARH,2006,Others (Please Specify),0,0,0,0,0,0,0,0,0,0,0,0,0
CHANDIGARH,2006,Total,0,26,26,3,1,56,2,14,6,1,1,24,80
CHANDIGARH,2006,Total Salaried,0,7,11,2,0,20,0,2,0,0,0,2,22
CHANDIGARH,2006,Total Self-employed,0,1,0,0,1,2,0,0,0,0,0,0,2
CHANDIGARH,2007,House Wife,0,0,0,0,0,0,0,10,8,1,2,21,21
CHANDIGARH,2007,Service (Government),0,0,3,1,0,4,0,1,0,0,0,1,5
CHANDIGARH,2007,Service (Private),0,3,10,4,0,17,0,0,0,0,0,0,17
CHANDIGARH,2007,Public Sector Undertaking,0,0,0,0,0,0,0,0,0,0,0,0,0
CHANDIGARH,2007,Student,2,13,0,0,0,15,0,0,0,0,0,0,15
CHANDIGARH,2007,Unemployed,0,6,2,2,0,10,0,0,0,0,0,0,10
CHANDIGARH,2007,Self-employed (Business activity),0,0,2,1,0,3,0,0,0,0,0,0,3
CHANDIGARH,2007,Professional Activity,0,0,0,0,0,0,0,0,0,0,0,0,0
CHANDIGARH,2007,Farming/Agriculture Activity,0,0,0,0,0,0,0,0,0,0,0,0,0
CHANDIGARH,2007,Others (Please Specify),0,2,3,0,0,5,0,0,0,0,0,0,5
CHANDIGARH,2007,Retired Person,0,0,0,0,2,2,0,0,0,0,0,0,2
CHANDIGARH,2007,Others (Please Specify),0,2,1,0,1,4,0,0,0,0,0,0,4
CHANDIGARH,2007,Total,2,26,21,8,3,60,0,11,8,1,2,22,82
CHANDIGARH,2007,Total Salaried,0,3,13,5,0,21,0,1,0,0,0,1,22
CHANDIGARH,2007,Total Self-employed,0,2,5,1,0,8,0,0,0,0,0,0,8
CHANDIGARH,2008,House Wife,0,0,0,0,0,0,0,8,7,2,0,17,17
CHANDIGARH,2008,Service (Government),0,0,2,1,0,3,0,0,0,0,0,0,3
CHANDIGARH,2008,Service (Private),0,4,7,4,0,15,0,3,0,0,0,3,18
CHANDIGARH,2008,Public Sector Undertaking,0,0,0,0,0,0,0,0,0,0,0,0,0
CHANDIGARH,2008,Student,0,6,0,0,0,6,0,5,0,0,0,5,11
CHANDIGARH,2008,Unemployed,0,10,7,6,0,23,0,0,0,0,0,0,23
CHANDIGARH,2008,Self-employed (Business activity),0,2,3,3,0,8,0,0,0,0,0,0,8
CHANDIGARH,2008,Professional Activity,0,0,0,1,0,1,0,0,0,0,0,0,1
CHANDIGARH,2008,Farming/Agriculture Activity,0,0,0,0,0,0,0,0,0,0,0,0,0
CHANDIGARH,2008,Others (Please Specify),0,0,0,0,0,0,0,0,0,0,0,0,0
CHANDIGARH,2008,Retired Person,0,0,0,1,1,2,0,0,0,0,0,0,2
CHANDIGARH,2008,Others (Please Specify),0,0,0,0,0,0,0,0,0,0,0,0,0
CHANDIGARH,2008,Total,0,22,19,16,1,58,0,16,7,2,0,25,83
CHANDIGARH,2008,Total Salaried,0,4,9,5,0,18,0,3,0,0,0,3,21
CHANDIGARH,2008,Total Self-employed,0,2,3,4,0,9,0,0,0,0,0,0,9
CHANDIGARH,2009,House Wife,0,0,0,0,0,0,0,6,8,1,2,17,17
CHANDIGARH,2009,Service (Government),0,0,4,3,0,7,0,0,0,0,0,0,7
CHANDIGARH,2009,Service (Private),0,0,3,2,0,5,0,0,1,0,0,1,6
CHANDIGARH,2009,Public Sector Undertaking,0,5,6,1,0,12,0,0,0,0,0,0,12
CHANDIGARH,2009,Student,0,6,0,0,0,6,1,11,0,0,0,12,18
CHANDIGARH,2009,Unemployed,0,3,3,1,0,7,0,0,0,0,0,0,7
CHANDIGARH,2009,Self-employed (Business activity),0,0,1,1,1,3,0,0,0,0,0,0,3
CHANDIGARH,2009,Professional Activity,0,0,1,0,0,1,0,0,0,0,0,0,1
CHANDIGARH,2009,Farming/Agriculture Activity,0,0,0,0,0,0,0,0,0,0,0,0,0
CHANDIGARH,2009,Others (Please Specify),0,1,0,0,0,1,0,0,0,0,0,0,1
CHANDIGARH,2009,Retired Person,0,0,0,0,1,1,0,0,0,0,0,0,1
CHANDIGARH,2009,Others (Please Specify),0,1,0,0,0,1,0,1,0,0,0,1,2
CHANDIGARH,2009,Total,0,16,18,8,2,44,1,18,9,1,2,31,75
CHANDIGARH,2009,Total Salaried,0,5,13,6,0,24,0,0,1,0,0,1,25
CHANDIGARH,2009,Total Self-employed,0,1,2,1,1,5,0,0,0,0,0,0,5
CHANDIGARH,2010,House Wife,0,0,0,0,0,0,0,6,10,2,1,19,19
CHANDIGARH,2010,Service (Government),0,1,2,0,0,3,0,1,0,0,0,1,4
CHANDIGARH,2010,Service (Private),0,4,4,2,0,10,0,0,0,0,0,0,10
CHANDIGARH,2010,Public Sector Undertaking,0,1,0,1,0,2,0,0,0,0,0,0,2
CHANDIGARH,2010,Student,0,4,0,0,0,4,1,9,0,0,0,10,14
CHANDIGARH,2010,Unemployed,0,4,1,0,0,5,0,3,0,0,0,3,8
CHANDIGARH,2010,Self-employed (Business activity),0,0,1,0,0,1,0,0,0,0,0,0,1
CHANDIGARH,2010,Professional Activity,0,0,0,0,0,0,0,0,0,0,0,0,0
CHANDIGARH,2010,Farming/Agriculture Activity,0,0,0,0,0,0,0,0,0,0,0,0,0
CHANDIGARH,2010,Others (Please Specify),0,0,4,1,0,5,1,5,0,0,0,6,11
CHANDIGARH,2010,Retired Person,0,0,0,0,1,1,0,0,0,0,0,0,1
CHANDIGARH,2010,Others (Please Specify),0,0,0,0,0,0,0,1,0,0,0,1,1
CHANDIGARH,2010,Total,0,14,12,4,1,31,2,25,10,2,1,40,71
CHANDIGARH,2010,Total Salaried,0,6,6,3,0,15,0,1,0,0,0,1,16
CHANDIGARH,2010,Total Self-employed,0,0,5,1,0,6,1,5,0,0,0,6,12
CHANDIGARH,2011,House Wife,0,0,0,0,0,0,0,13,13,2,0,28,28
CHANDIGARH,2011,Service (Government),0,0,1,2,0,3,0,0,0,0,0,0,3
CHANDIGARH,2011,Service (Private),0,2,8,7,0,17,0,2,0,1,0,3,20
CHANDIGARH,2011,Public Sector Undertaking,0,0,0,0,0,0,0,0,0,0,0,0,0
CHANDIGARH,2011,Student,0,4,0,0,0,4,0,10,0,0,0,10,14
CHANDIGARH,2011,Unemployed,0,8,1,1,0,10,0,2,0,0,0,2,12
CHANDIGARH,2011,Self-employed (Business activity),0,0,3,0,0,3,0,0,0,0,0,0,3
CHANDIGARH,2011,Professional Activity,0,0,0,0,0,0,0,0,0,0,0,0,0
CHANDIGARH,2011,Farming/Agriculture Activity,0,0,0,0,0,0,0,0,0,0,0,0,0
CHANDIGARH,2011,Others (Please Specify),0,10,6,3,1,20,0,1,0,0,0,1,21
CHANDIGARH,2011,Retired Person,0,0,0,0,0,0,0,0,0,0,0,0,0
CHANDIGARH,2011,Others (Please Specify),0,0,0,0,0,0,0,3,1,0,0,4,4
CHANDIGARH,2011,Total,0,24,19,13,1,57,0,31,14,3,0,48,105
CHANDIGARH,2011,Total Salaried,0,2,9,9,0,20,0,2,0,1,0,3,23
CHANDIGARH,2011,Total Self-employed,0,10,9,3,1,23,0,1,0,0,0,1,24
CHANDIGARH,2012,House Wife,0,0,0,0,0,0,0,9,8,0,1,18,18
CHANDIGARH,2012,Service (Government),0,1,5,2,0,8,0,0,0,0,0,0,8
CHANDIGARH,2012,Service (Private),0,12,13,3,0,28,0,1,0,0,0,1,29
CHANDIGARH,2012,Public Sector Undertaking,0,1,2,1,0,4,0,1,0,0,0,1,5
CHANDIGARH,2012,Student,2,3,0,0,0,5,1,11,0,0,0,12,17
CHANDIGARH,2012,Unemployed,0,9,3,0,0,12,0,1,0,0,0,1,13
CHANDIGARH,2012,Self-employed (Business activity),0,1,1,1,0,3,0,0,0,0,0,0,3
CHANDIGARH,2012,Professional Activity,0,0,0,0,0,0,0,0,0,0,0,0,0
CHANDIGARH,2012,Farming/Agriculture Activity,0,0,0,0,0,0,0,0,0,0,0,0,0
CHANDIGARH,2012,Others (Please Specify),0,6,7,1,1,15,0,3,0,0,0,3,18
CHANDIGARH,2012,Retired Person,0,0,0,0,0,0,0,0,0,0,0,0,0
CHANDIGARH,2012,Others (Please Specify),0,0,0,0,0,0,0,3,0,0,0,3,3
CHANDIGARH,2012,Total,2,33,31,8,1,75,1,29,8,0,1,39,114
CHANDIGARH,2012,Total Salaried,0,14,20,6,0,40,0,2,0,0,0,2,42
CHANDIGARH,2012,Total Self-employed,0,7,8,2,1,18,0,3,0,0,0,3,21
D & N HAVELI,2001,House Wife,0,0,0,0,0,0,1,9,3,0,0,13,13
D & N HAVELI,2001,Service (Government),0,0,0,0,0,0,0,0,0,0,0,0,0
D & N HAVELI,2001,Service (Private),0,1,3,1,0,5,0,0,0,0,0,0,5
D & N HAVELI,2001,Public Sector Undertaking,0,0,0,0,0,0,0,0,0,0,0,0,0
D & N HAVELI,2001,Student,0,0,0,0,0,0,0,0,0,0,0,0,0
D & N HAVELI,2001,Unemployed,0,5,3,0,0,8,0,0,0,0,0,0,8
D & N HAVELI,2001,Self-employed (Business activity),0,0,0,0,0,0,0,0,0,0,0,0,0
D & N HAVELI,2001,Professional Activity,0,0,0,0,0,0,0,0,0,0,0,0,0
D & N HAVELI,2001,Farming/Agriculture Activity,0,4,4,3,8,19,0,0,0,0,0,0,19
D & N HAVELI,2001,Others (Please Specify),0,0,0,2,0,2,0,0,0,1,0,1,3
D & N HAVELI,2001,Retired Person,0,0,0,0,0,0,0,0,0,0,0,0,0
D & N HAVELI,2001,Others (Please Specify),0,0,0,1,0,1,0,0,1,0,0,1,2
D & N HAVELI,2001,Total,0,10,10,7,8,35,1,9,4,1,0,15,50
D & N HAVELI,2001,Total Salaried,0,1,3,1,0,5,0,0,0,0,0,0,5
D & N HAVELI,2001,Total Self-employed,0,4,4,5,8,21,0,0,0,1,0,1,22
D & N HAVELI,2002,House Wife,0,0,0,0,0,0,0,9,2,2,2,15,15
D & N HAVELI,2002,Service (Government),0,1,0,0,0,1,0,0,0,0,0,0,1
D & N HAVELI,2002,Service (Private),0,2,0,2,0,4,0,0,0,0,0,0,4
D & N HAVELI,2002,Public Sector Undertaking,0,0,0,0,0,0,0,0,0,0,0,0,0
D & N HAVELI,2002,Student,1,0,0,0,0,1,0,2,1,0,0,3,4
D & N HAVELI,2002,Unemployed,0,0,0,0,0,0,0,0,0,0,0,0,0
D & N HAVELI,2002,Self-employed (Business activity),0,0,0,0,0,0,0,0,0,0,0,0,0
D & N HAVELI,2002,Professional Activity,0,0,0,0,0,0,0,0,0,0,0,0,0
D & N HAVELI,2002,Farming/Agriculture Activity,0,4,5,7,5,21,0,0,0,0,0,0,21
D & N HAVELI,2002,Others (Please Specify),0,2,3,0,0,5,0,0,0,0,0,0,5
D & N HAVELI,2002,Retired Person,0,0,0,0,0,0,0,0,0,0,0,0,0
D & N HAVELI,2002,Others (Please Specify),0,0,0,0,0,0,0,0,0,0,0,0,0
D & N HAVELI,2002,Total,1,9,8,9,5,32,0,11,3,2,2,18,50
D & N HAVELI,2002,Total Salaried,0,3,0,2,0,5,0,0,0,0,0,0,5
D & N HAVELI,2002,Total Self-employed,0,6,8,7,5,26,0,0,0,0,0,0,26
D & N HAVELI,2003,House Wife,0,0,0,0,0,0,0,5,7,9,0,21,21
D & N HAVELI,2003,Service (Government),0,0,1,0,0,1,0,0,0,0,0,0,1
D & N HAVELI,2003,Service (Private),0,0,4,0,0,4,0,0,0,0,0,0,4
D & N HAVELI,2003,Public Sector Undertaking,0,0,0,0,0,0,0,0,0,0,0,0,0
D & N HAVELI,2003,Student,1,0,0,0,0,1,0,1,0,0,0,1,2
D & N HAVELI,2003,Unemployed,0,0,0,0,0,0,0,0,0,0,0,0,0
D & N HAVELI,2003,Self-employed (Business activity),0,0,0,0,0,0,0,0,0,0,0,0,0
D & N HAVELI,2003,Professional Activity,0,0,0,0,0,0,0,0,0,0,0,0,0
D & N HAVELI,2003,Farming/Agriculture Activity,0,8,3,7,5,23,0,0,0,0,0,0,23
D & N HAVELI,2003,Others (Please Specify),0,0,0,0,0,0,0,0,0,0,0,0,0
D & N HAVELI,2003,Retired Person,0,0,0,0,0,0,0,0,0,0,0,0,0
D & N HAVELI,2003,Others (Please Specify),1,0,0,0,0,1,0,0,0,0,0,0,1
D & N HAVELI,2003,Total,2,8,8,7,5,30,0,6,7,9,0,22,52
D & N HAVELI,2003,Total Salaried,0,0,5,0,0,5,0,0,0,0,0,0,5
D & N HAVELI,2003,Total Self-employed,0,8,3,7,5,23,0,0,0,0,0,0,23
D & N HAVELI,2004,House Wife,0,0,0,0,0,0,0,9,5,1,1,16,16
D & N HAVELI,2004,Service (Government),0,0,0,0,0,0,0,0,0,0,0,0,0
D & N HAVELI,2004,Service (Private),0,2,1,1,0,4,0,1,0,0,0,1,5
D & N HAVELI,2004,Public Sector Undertaking,0,0,0,0,0,0,0,0,0,0,0,0,0
D & N HAVELI,2004,Student,0,0,0,0,0,0,0,2,0,0,0,2,2
D & N HAVELI,2004,Unemployed,0,2,1,0,0,3,0,0,0,0,0,0,3
D & N HAVELI,2004,Self-employed (Business activity),0,0,1,0,0,1,0,0,0,0,0,0,1
D & N HAVELI,2004,Professional Activity,0,0,0,0,0,0,0,0,0,0,0,0,0
D & N HAVELI,2004,Farming/Agriculture Activity,0,2,2,2,1,7,0,0,0,0,0,0,7
D & N HAVELI,2004,Others (Please Specify),0,1,1,1,2,5,0,0,0,0,0,0,5
D & N HAVELI,2004,Retired Person,0,0,0,0,0,0,0,0,0,0,0,0,0
D & N HAVELI,2004,Others (Please Specify),0,0,0,0,0,0,0,0,0,0,0,0,0
D & N HAVELI,2004,Total,0,7,6,4,3,20,0,12,5,1,1,19,39
D & N HAVELI,2004,Total Salaried,0,2,1,1,0,4,0,1,0,0,0,1,5
D & N HAVELI,2004,Total Self-employed,0,3,4,3,3,13,0,0,0,0,0,0,13
D & N HAVELI,2005,House Wife,0,0,0,0,0,0,0,7,7,7,1,22,22
D & N HAVELI,2005,Service (Government),0,0,0,0,0,0,0,2,1,0,0,3,3
D & N HAVELI,2005,Service (Private),0,3,1,0,0,4,0,0,0,0,0,0,4
D & N HAVELI,2005,Public Sector Undertaking,0,0,0,0,0,0,0,0,0,0,0,0,0
D & N HAVELI,2005,Student,0,0,0,0,0,0,0,0,0,0,0,0,0
D & N HAVELI,2005,Unemployed,0,1,1,0,0,2,0,0,0,0,0,0,2
D & N HAVELI,2005,Self-employed (Business activity),0,0,0,0,0,0,0,0,0,0,0,0,0
D & N HAVELI,2005,Professional Activity,0,0,0,0,0,0,0,0,0,0,0,0,0
D & N HAVELI,2005,Farming/Agriculture Activity,0,3,6,4,0,13,0,0,0,0,0,0,13
D & N HAVELI,2005,Others (Please Specify),0,0,0,0,0,0,0,0,0,0,0,0,0
D & N HAVELI,2005,Retired Person,0,0,0,0,0,0,0,0,0,0,0,0,0
D & N HAVELI,2005,Others (Please Specify),0,9,5,2,6,22,0,3,0,0,0,3,25
D & N HAVELI,2005,Total,0,16,13,6,6,41,0,12,8,7,1,28,69
D & N HAVELI,2005,Total Salaried,0,3,1,0,0,4,0,2,1,0,0,3,7
D & N HAVELI,2005,Total Self-employed,0,3,6,4,0,13,0,0,0,0,0,0,13
D & N HAVELI,2006,House Wife,0,0,0,0,0,0,0,7,6,2,2,17,17
D & N HAVELI,2006,Service (Government),0,0,0,0,0,0,0,0,0,0,0,0,0
D & N HAVELI,2006,Service (Private),0,2,0,0,1,3,0,0,0,0,0,0,3
D & N HAVELI,2006,Public Sector Undertaking,0,0,0,0,0,0,0,0,0,0,0,0,0
D & N HAVELI,2006,Student,0,2,0,0,0,2,0,0,0,0,0,0,2
D & N HAVELI,2006,Unemployed,0,3,2,0,0,5,1,1,0,0,0,2,7
D & N HAVELI,2006,Self-employed (Business activity),0,0,1,0,0,1,0,0,0,0,0,0,1
D & N HAVELI,2006,Professional Activity,0,0,0,0,0,0,0,0,0,0,0,0,0
D & N HAVELI,2006,Farming/Agriculture Activity,0,1,2,3,6,12,0,0,0,0,0,0,12
D & N HAVELI,2006,Others (Please Specify),0,0,0,0,0,0,0,0,0,0,0,0,0
D & N HAVELI,2006,Retired Person,0,0,0,0,0,0,0,0,0,0,0,0,0
D & N HAVELI,2006,Others (Please Specify),0,0,0,0,0,0,0,0,0,0,0,0,0
D & N HAVELI,2006,Total,0,8,5,3,7,23,1,8,6,2,2,19,42
D & N HAVELI,2006,Total Salaried,0,2,0,0,1,3,0,0,0,0,0,0,3
D & N HAVELI,2006,Total Self-employed,0,1,3,3,6,13,0,0,0,0,0,0,13
D & N HAVELI,2007,House Wife,0,0,0,0,0,0,0,15,8,4,1,28,28
D & N HAVELI,2007,Service (Government),0,0,0,0,0,0,0,0,0,0,0,0,0
D & N HAVELI,2007,Service (Private),0,4,4,0,0,8,0,0,0,0,0,0,8
D & N HAVELI,2007,Public Sector Undertaking,0,0,0,0,0,0,0,0,0,0,0,0,0
D & N HAVELI,2007,Student,0,3,0,0,0,3,0,4,0,0,0,4,7
D & N HAVELI,2007,Unemployed,0,2,3,2,0,7,0,0,0,0,0,0,7
D & N HAVELI,2007,Self-employed (Business activity),0,0,1,1,0,2,0,0,0,0,0,0,2
D & N HAVELI,2007,Professional Activity,0,0,0,0,0,0,0,0,0,0,0,0,0
D & N HAVELI,2007,Farming/Agriculture Activity,0,4,6,4,3,17,0,0,0,0,0,0,17
D & N HAVELI,2007,Others (Please Specify),0,0,0,0,0,0,0,0,0,0,0,0,0
D & N HAVELI,2007,Retired Person,0,0,0,0,5,5,0,0,0,0,0,0,5
D & N HAVELI,2007,Others (Please Specify),0,2,0,0,0,2,0,0,0,0,0,0,2
D & N HAVELI,2007,Total,0,15,14,7,8,44,0,19,8,4,1,32,76
D & N HAVELI,2007,Total Salaried,0,4,4,0,0,8,0,0,0,0,0,0,8
D & N HAVELI,2007,Total Self-employed,0,4,7,5,3,19,0,0,0,0,0,0,19
D & N HAVELI,2008,House Wife,0,0,0,0,0,0,0,10,6,6,1,23,23
D & N HAVELI,2008,Service (Government),0,0,0,1,0,1,0,0,0,0,0,0,1
D & N HAVELI,2008,Service (Private),0,8,4,1,0,13,0,4,0,0,0,4,17
D & N HAVELI,2008,Public Sector Undertaking,0,0,0,0,0,0,0,0,0,0,0,0,0
D & N HAVELI,2008,Student,0,0,0,0,0,0,0,1,0,0,0,1,1
D & N HAVELI,2008,Unemployed,0,0,0,0,0,0,0,0,0,0,0,0,0
D & N HAVELI,2008,Self-employed (Business activity),0,0,1,0,0,1,0,0,0,0,0,0,1
D & N HAVELI,2008,Professional Activity,0,0,0,0,0,0,0,0,0,0,0,0,0
D & N HAVELI,2008,Farming/Agriculture Activity,0,1,6,4,1,12,0,0,0,0,0,0,12
D & N HAVELI,2008,Others (Please Specify),0,0,0,0,0,0,0,0,0,0,0,0,0
D & N HAVELI,2008,Retired Person,0,0,0,0,0,0,0,0,0,0,0,0,0
D & N HAVELI,2008,Others (Please Specify),1,2,0,2,0,5,0,0,0,0,0,0,5
D & N HAVELI,2008,Total,1,11,11,8,1,32,0,15,6,6,1,28,60
D & N HAVELI,2008,Total Salaried,0,8,4,2,0,14,0,4,0,0,0,4,18
D & N HAVELI,2008,Total Self-employed,0,1,7,4,1,13,0,0,0,0,0,0,13
D & N HAVELI,2009,House Wife,0,0,0,0,0,0,0,10,2,1,6,19,19
D & N HAVELI,2009,Service (Government),0,0,1,0,0,1,0,0,0,0,0,0,1
D & N HAVELI,2009,Service (Private),0,6,3,1,0,10,0,0,2,0,0,2,12
D & N HAVELI,2009,Public Sector Undertaking,0,0,0,0,0,0,0,0,0,0,0,0,0
D & N HAVELI,2009,Student,0,2,0,0,0,2,0,4,0,0,0,4,6
D & N HAVELI,2009,Unemployed,0,0,0,0,0,0,0,0,0,0,0,0,0
D & N HAVELI,2009,Self-employed (Business activity),0,0,0,1,0,1,0,0,0,0,0,0,1
D & N HAVELI,2009,Professional Activity,0,0,0,0,0,0,0,0,0,0,0,0,0
D & N HAVELI,2009,Farming/Agriculture Activity,0,2,5,6,2,15,0,0,0,0,0,0,15
D & N HAVELI,2009,Others (Please Specify),0,0,1,0,0,1,0,0,0,0,1,1,2
D & N HAVELI,2009,Retired Person,0,0,0,0,0,0,0,0,0,0,0,0,0
D & N HAVELI,2009,Others (Please Specify),0,0,0,0,0,0,0,0,0,0,0,0,0
D & N HAVELI,2009,Total,0,10,10,8,2,30,0,14,4,1,7,26,56
D & N HAVELI,2009,Total Salaried,0,6,4,1,0,11,0,0,2,0,0,2,13
D & N HAVELI,2009,Total Self-employed,0,2,6,7,2,17,0,0,0,0,1,1,18
D & N HAVELI,2010,House Wife,0,0,0,0,0,0,0,15,4,4,0,23,23
D & N HAVELI,2010,Service (Government),0,1,0,0,0,1,0,0,0,0,0,0,1
D & N HAVELI,2010,Service (Private),0,6,5,1,0,12,0,0,0,0,0,0,12
D & N HAVELI,2010,Public Sector Undertaking,0,0,0,0,0,0,0,0,0,0,0,0,0
D & N HAVELI,2010,Student,0,0,0,0,0,0,0,3,0,0,0,3,3
D & N HAVELI,2010,Unemployed,0,0,0,0,0,0,0,0,0,0,0,0,0
D & N HAVELI,2010,Self-employed (Business activity),0,0,0,0,0,0,0,0,0,0,0,0,0
D & N HAVELI,2010,Professional Activity,0,0,0,0,0,0,0,0,0,0,0,0,0
D & N HAVELI,2010,Farming/Agriculture Activity,0,2,5,3,0,10,0,0,0,0,0,0,10
D & N HAVELI,2010,Others (Please Specify),0,1,0,0,0,1,0,0,0,0,0,0,1
D & N HAVELI,2010,Retired Person,0,0,0,0,0,0,0,0,0,0,0,0,0
D & N HAVELI,2010,Others (Please Specify),0,4,2,2,5,13,0,0,0,0,0,0,13
D & N HAVELI,2010,Total,0,14,12,6,5,37,0,18,4,4,0,26,63
D & N HAVELI,2010,Total Salaried,0,7,5,1,0,13,0,0,0,0,0,0,13
D & N HAVELI,2010,Total Self-employed,0,3,5,3,0,11,0,0,0,0,0,0,11
D & N HAVELI,2011,House Wife,0,0,0,0,0,0,0,5,5,2,0,12,12
D & N HAVELI,2011,Service (Government),0,0,0,0,0,0,0,0,0,0,0,0,0
D & N HAVELI,2011,Service (Private),0,15,3,2,0,20,0,5,0,0,0,5,25
D & N HAVELI,2011,Public Sector Undertaking,0,0,0,0,0,0,0,0,0,0,0,0,0
D & N HAVELI,2011,Student,0,3,0,0,0,3,0,3,0,0,0,3,6
D & N HAVELI,2011,Unemployed,0,0,0,0,0,0,0,0,0,0,0,0,0
D & N HAVELI,2011,Self-employed (Business activity),0,0,0,2,0,2,0,0,0,0,0,0,2
D & N HAVELI,2011,Professional Activity,0,0,0,0,0,0,0,0,0,0,0,0,0
D & N HAVELI,2011,Farming/Agriculture Activity,0,4,3,5,1,13,0,0,0,0,0,0,13
D & N HAVELI,2011,Others (Please Specify),0,1,2,0,0,3,0,0,0,1,1,2,5
D & N HAVELI,2011,Retired Person,0,0,0,0,0,0,0,0,0,0,0,0,0
D & N HAVELI,2011,Others (Please Specify),0,0,0,0,0,0,0,0,0,0,0,0,0
D & N HAVELI,2011,Total,0,23,8,9,1,41,0,13,5,3,1,22,63
D & N HAVELI,2011,Total Salaried,0,15,3,2,0,20,0,5,0,0,0,5,25
D & N HAVELI,2011,Total Self-employed,0,5,5,7,1,18,0,0,0,1,1,2,20
D & N HAVELI,2012,House Wife,0,0,0,0,0,0,0,6,2,2,3,13,13
D & N HAVELI,2012,Service (Government),0,0,0,0,0,0,0,0,0,0,0,0,0
D & N HAVELI,2012,Service (Private),0,11,13,2,0,26,0,2,0,0,0,2,28
D & N HAVELI,2012,Public Sector Undertaking,0,0,0,0,0,0,0,0,0,0,0,0,0
D & N HAVELI,2012,Student,0,0,0,0,0,0,0,6,0,0,0,6,6
D & N HAVELI,2012,Unemployed,0,1,0,0,1,2,0,2,0,0,0,2,4
D & N HAVELI,2012,Self-employed (Business activity),0,2,0,1,0,3,0,0,0,0,0,0,3
D & N HAVELI,2012,Professional Activity,0,0,0,0,0,0,0,0,0,0,0,0,0
D & N HAVELI,2012,Farming/Agriculture Activity,0,0,3,2,1,6,0,0,0,0,0,0,6
D & N HAVELI,2012,Others (Please Specify),0,0,0,0,0,0,0,0,0,0,0,0,0
D & N HAVELI,2012,Retired Person,0,0,0,0,0,0,0,0,0,0,0,0,0
D & N HAVELI,2012,Others (Please Specify),0,3,0,0,1,4,0,2,0,0,0,2,6
D & N HAVELI,2012,Total,0,17,16,5,3,41,0,18,2,2,3,25,66
D & N HAVELI,2012,Total Salaried,0,11,13,2,0,26,0,2,0,0,0,2,28
D & N HAVELI,2012,Total Self-employed,0,2,3,3,1,9,0,0,0,0,0,0,9
DAMAN & DIU,2001,House Wife,0,0,0,0,0,0,0,3,0,0,0,3,3
DAMAN & DIU,2001,Service (Government),0,0,0,0,0,0,0,0,0,0,0,0,0
DAMAN & DIU,2001,Service (Private),0,2,3,0,0,5,0,1,0,0,0,1,6
DAMAN & DIU,2001,Public Sector Undertaking,0,0,0,0,0,0,0,0,0,0,0,0,0
DAMAN & DIU,2001,Student,0,0,0,0,0,0,0,0,0,0,0,0,0
DAMAN & DIU,2001,Unemployed,0,0,0,0,0,0,0,0,0,0,0,0,0
DAMAN & DIU,2001,Self-employed (Business activity),0,0,0,0,0,0,0,0,0,0,0,0,0
DAMAN & DIU,2001,Professional Activity,0,0,1,0,0,1,0,0,0,0,0,0,1
DAMAN & DIU,2001,Farming/Agriculture Activity,0,0,0,0,0,0,0,0,0,0,0,0,0
DAMAN & DIU,2001,Others (Please Specify),0,1,2,0,0,3,0,0,0,0,0,0,3
DAMAN & DIU,2001,Retired Person,0,0,0,0,0,0,0,0,0,0,0,0,0
DAMAN & DIU,2001,Others (Please Specify),0,1,0,0,0,1,0,0,0,0,0,0,1
DAMAN & DIU,2001,Total,0,4,6,0,0,10,0,4,0,0,0,4,14
DAMAN & DIU,2001,Total Salaried,0,2,3,0,0,5,0,1,0,0,0,1,6
DAMAN & DIU,2001,Total Self-employed,0,1,3,0,0,4,0,0,0,0,0,0,4
DAMAN & DIU,2002,House Wife,0,0,0,0,0,0,0,1,1,0,0,2,2
DAMAN & DIU,2002,Service (Government),0,0,0,0,0,0,0,0,0,0,0,0,0
DAMAN & DIU,2002,Service (Private),0,3,6,0,0,9,0,0,0,0,0,0,9
DAMAN & DIU,2002,Public Sector Undertaking,0,0,0,0,0,0,0,0,0,0,0,0,0
DAMAN & DIU,2002,Student,0,0,0,0,0,0,0,0,0,0,0,0,0
DAMAN & DIU,2002,Unemployed,0,0,1,0,0,1,0,0,0,0,0,0,1
DAMAN & DIU,2002,Self-employed (Business activity),0,0,0,0,0,0,0,0,0,0,0,0,0
DAMAN & DIU,2002,Professional Activity,0,0,0,0,0,0,0,0,0,0,0,0,0
DAMAN & DIU,2002,Farming/Agriculture Activity,0,1,1,0,0,2,0,0,0,0,0,0,2
DAMAN & DIU,2002,Others (Please Specify),0,0,0,0,0,0,0,0,0,0,0,0,0
DAMAN & DIU,2002,Retired Person,0,0,0,0,0,0,0,0,0,0,0,0,0
DAMAN & DIU,2002,Others (Please Specify),0,0,1,1,1,3,0,0,0,0,0,0,3
DAMAN & DIU,2002,Total,0,4,9,1,1,15,0,1,1,0,0,2,17
DAMAN & DIU,2002,Total Salaried,0,3,6,0,0,9,0,0,0,0,0,0,9
DAMAN & DIU,2002,Total Self-employed,0,1,1,0,0,2,0,0,0,0,0,0,2
DAMAN & DIU,2003,House Wife,0,0,0,0,0,0,0,2,2,1,0,5,5
DAMAN & DIU,2003,Service (Government),0,0,0,0,0,0,0,0,0,0,0,0,0
DAMAN & DIU,2003,Service (Private),0,1,3,0,0,4,0,0,0,0,0,0,4
DAMAN & DIU,2003,Public Sector Undertaking,0,0,0,0,0,0,0,0,0,0,0,0,0
DAMAN & DIU,2003,Student,0,0,0,0,0,0,0,0,0,0,0,0,0
DAMAN & DIU,2003,Unemployed,0,1,2,0,0,3,0,0,0,0,0,0,3
DAMAN & DIU,2003,Self-employed (Business activity),0,1,0,0,0,1,0,0,0,0,0,0,1
DAMAN & DIU,2003,Professional Activity,0,0,1,0,0,1,0,0,0,0,0,0,1
DAMAN & DIU,2003,Farming/Agriculture Activity,0,0,0,0,0,0,0,0,0,0,0,0,0
DAMAN & DIU,2003,Others (Please Specify),0,1,1,1,0,3,0,0,0,0,0,0,3
DAMAN & DIU,2003,Retired Person,0,0,0,0,0,0,0,0,0,0,0,0,0
DAMAN & DIU,2003,Others (Please Specify),1,3,1,1,0,6,0,1,0,0,0,1,7
DAMAN & DIU,2003,Total,1,7,8,2,0,18,0,3,2,1,0,6,24
DAMAN & DIU,2003,Total Salaried,0,1,3,0,0,4,0,0,0,0,0,0,4
DAMAN & DIU,2003,Total Self-employed,0,2,2,1,0,5,0,0,0,0,0,0,5
DAMAN & DIU,2004,House Wife,0,0,0,0,0,0,0,5,0,0,0,5,5
DAMAN & DIU,2004,Service (Government),0,0,0,0,0,0,0,0,0,0,0,0,0
DAMAN & DIU,2004,Service (Private),0,1,0,0,0,1,0,2,0,0,0,2,3
DAMAN & DIU,2004,Public Sector Undertaking,0,0,0,0,0,0,0,0,0,0,0,0,0
DAMAN & DIU,2004,Student,0,0,0,0,0,0,0,0,0,0,0,0,0
DAMAN & DIU,2004,Unemployed,0,0,0,0,0,0,0,0,0,0,0,0,0
DAMAN & DIU,2004,Self-employed (Business activity),0,0,0,0,0,0,0,0,0,0,0,0,0
DAMAN & DIU,2004,Professional Activity,0,0,0,0,0,0,0,0,0,0,0,0,0
DAMAN & DIU,2004,Farming/Agriculture Activity,0,0,1,1,0,2,0,0,0,0,0,0,2
DAMAN & DIU,2004,Others (Please Specify),0,0,0,0,0,0,0,0,0,0,0,0,0
DAMAN & DIU,2004,Retired Person,0,0,0,0,0,0,0,0,0,0,0,0,0
DAMAN & DIU,2004,Others (Please Specify),0,0,2,0,0,2,0,1,0,0,0,1,3
DAMAN & DIU,2004,Total,0,1,3,1,0,5,0,8,0,0,0,8,13
DAMAN & DIU,2004,Total Salaried,0,1,0,0,0,1,0,2,0,0,0,2,3
DAMAN & DIU,2004,Total Self-employed,0,0,1,1,0,2,0,0,0,0,0,0,2
DAMAN & DIU,2005,House Wife,0,0,0,0,0,0,0,2,2,0,0,4,4
DAMAN & DIU,2005,Service (Government),0,0,0,0,0,0,0,0,0,0,0,0,0
DAMAN & DIU,2005,Service (Private),0,6,1,1,0,8,0,0,0,0,0,0,8
DAMAN & DIU,2005,Public Sector Undertaking,0,0,0,1,0,1,0,0,0,0,0,0,1
DAMAN & DIU,2005,Student,1,0,0,0,0,1,0,0,0,0,0,0,1
DAMAN & DIU,2005,Unemployed,0,0,0,4,0,4,0,0,0,0,0,0,4
DAMAN & DIU,2005,Self-employed (Business activity),0,0,1,0,0,1,0,0,0,0,0,0,1
DAMAN & DIU,2005,Professional Activity,0,0,0,0,0,0,0,0,0,0,0,0,0
DAMAN & DIU,2005,Farming/Agriculture Activity,0,0,0,0,0,0,0,0,0,0,0,0,0
DAMAN & DIU,2005,Others (Please Specify),0,3,1,4,0,8,0,0,0,0,0,0,8
DAMAN & DIU,2005,Retired Person,0,0,0,0,0,0,0,0,0,0,0,0,0
DAMAN & DIU,2005,Others (Please Specify),0,1,1,0,0,2,0,3,0,0,0,3,5
DAMAN & DIU,2005,Total,1,10,4,10,0,25,0,5,2,0,0,7,32
DAMAN & DIU,2005,Total Salaried,0,6,1,2,0,9,0,0,0,0,0,0,9
DAMAN & DIU,2005,Total Self-employed,0,3,2,4,0,9,0,0,0,0,0,0,9
DAMAN & DIU,2006,House Wife,0,0,0,0,0,0,0,3,0,0,0,3,3
DAMAN & DIU,2006,Service (Government),0,0,0,0,0,0,0,0,0,0,0,0,0
DAMAN & DIU,2006,Service (Private),0,6,2,0,0,8,0,0,0,0,0,0,8
DAMAN & DIU,2006,Public Sector Undertaking,0,0,0,0,0,0,0,0,0,0,0,0,0
DAMAN & DIU,2006,Student,0,1,0,0,0,1,1,1,0,0,0,2,3
DAMAN & DIU,2006,Unemployed,0,0,0,0,0,0,0,0,0,0,0,0,0
DAMAN & DIU,2006,Self-employed (Business activity),0,0,1,0,0,1,0,0,0,0,0,0,1
DAMAN & DIU,2006,Professional Activity,0,0,0,0,0,0,0,0,0,0,0,0,0
DAMAN & DIU,2006,Farming/Agriculture Activity,0,0,0,0,0,0,0,0,0,0,0,0,0
DAMAN & DIU,2006,Others (Please Specify),0,0,2,0,0,2,0,0,0,0,0,0,2
DAMAN & DIU,2006,Retired Person,0,0,0,0,0,0,0,0,0,0,0,0,0
DAMAN & DIU,2006,Others (Please Specify),0,0,0,1,1,2,2,0,1,0,0,3,5
DAMAN & DIU,2006,Total,0,7,5,1,1,14,3,4,1,0,0,8,22
DAMAN & DIU,2006,Total Salaried,0,6,2,0,0,8,0,0,0,0,0,0,8
DAMAN & DIU,2006,Total Self-employed,0,0,3,0,0,3,0,0,0,0,0,0,3
DAMAN & DIU,2007,House Wife,0,0,0,0,0,0,0,3,2,0,0,5,5
DAMAN & DIU,2007,Service (Government),0,0,0,2,0,2,0,0,0,0,0,0,2
DAMAN & DIU,2007,Service (Private),0,3,1,0,0,4,0,1,0,0,0,1,5
DAMAN & DIU,2007,Public Sector Undertaking,0,0,0,0,0,0,0,0,0,0,0,0,0
DAMAN & DIU,2007,Student,0,0,0,0,0,0,0,0,0,0,0,0,0
DAMAN & DIU,2007,Unemployed,0,0,0,0,0,0,0,0,0,0,0,0,0
DAMAN & DIU,2007,Self-employed (Business activity),0,0,0,0,0,0,0,0,0,0,0,0,0
DAMAN & DIU,2007,Professional Activity,0,0,0,0,0,0,0,0,0,0,0,0,0
DAMAN & DIU,2007,Farming/Agriculture Activity,0,0,0,0,0,0,0,0,0,0,0,0,0
DAMAN & DIU,2007,Others (Please Specify),0,0,0,0,0,0,0,0,0,0,0,0,0
DAMAN & DIU,2007,Retired Person,0,0,0,0,0,0,0,0,0,0,0,0,0
DAMAN & DIU,2007,Others (Please Specify),0,0,0,0,0,0,0,3,0,0,0,3,3
DAMAN & DIU,2007,Total,0,3,1,2,0,6,0,7,2,0,0,9,15
DAMAN & DIU,2007,Total Salaried,0,3,1,2,0,6,0,1,0,0,0,1,7
DAMAN & DIU,2007,Total Self-employed,0,0,0,0,0,0,0,0,0,0,0,0,0
DAMAN & DIU,2008,House Wife,0,0,0,0,0,0,0,0,0,0,0,0,0
DAMAN & DIU,2008,Service (Government),0,0,0,1,0,1,0,0,0,0,0,0,1
DAMAN & DIU,2008,Service (Private),0,3,3,2,0,8,0,0,0,0,0,0,8
DAMAN & DIU,2008,Public Sector Undertaking,0,0,0,0,0,0,0,0,0,0,0,0,0
DAMAN & DIU,2008,Student,0,0,0,0,0,0,0,0,0,0,0,0,0
DAMAN & DIU,2008,Unemployed,0,0,0,2,0,2,0,1,0,0,0,1,3
DAMAN & DIU,2008,Self-employed (Business activity),0,0,0,1,0,1,0,0,0,0,0,0,1
DAMAN & DIU,2008,Professional Activity,0,0,0,0,0,0,0,0,0,0,0,0,0
DAMAN & DIU,2008,Farming/Agriculture Activity,0,0,0,0,0,0,0,0,0,0,0,0,0
DAMAN & DIU,2008,Others (Please Specify),0,0,1,0,0,1,0,0,0,0,0,0,1
DAMAN & DIU,2008,Retired Person,0,0,0,0,0,0,0,0,0,0,0,0,0
DAMAN & DIU,2008,Others (Please Specify),0,1,0,0,0,1,0,0,0,1,3,4,5
DAMAN & DIU,2008,Total,0,4,4,6,0,14,0,1,0,1,3,5,19
DAMAN & DIU,2008,Total Salaried,0,3,3,3,0,9,0,0,0,0,0,0,9
DAMAN & DIU,2008,Total Self-employed,0,0,1,1,0,2,0,0,0,0,0,0,2
DAMAN & DIU,2009,House Wife,0,0,0,0,0,0,0,0,3,1,0,4,4
DAMAN & DIU,2009,Service (Government),0,0,0,0,0,0,0,0,0,0,0,0,0
DAMAN & DIU,2009,Service (Private),0,6,0,0,0,6,0,0,1,0,0,1,7
DAMAN & DIU,2009,Public Sector Undertaking,0,0,0,0,0,0,0,1,0,0,0,1,1
DAMAN & DIU,2009,Student,0,1,0,1,0,2,1,0,0,0,0,1,3
DAMAN & DIU,2009,Unemployed,0,0,0,1,0,1,0,0,0,0,0,0,1
DAMAN & DIU,2009,Self-employed (Business activity),0,0,0,0,0,0,0,0,0,0,0,0,0
DAMAN & DIU,2009,Professional Activity,0,0,0,0,0,0,0,0,0,0,0,0,0
DAMAN & DIU,2009,Farming/Agriculture Activity,0,0,0,0,0,0,0,0,0,0,0,0,0
DAMAN & DIU,2009,Others (Please Specify),0,0,0,0,0,0,0,0,0,0,0,0,0
DAMAN & DIU,2009,Retired Person,0,0,0,0,0,0,0,0,0,0,0,0,0
DAMAN & DIU,2009,Others (Please Specify),0,1,2,1,2,6,0,0,1,0,0,1,7
DAMAN & DIU,2009,Total,0,8,2,3,2,15,1,1,5,1,0,8,23
DAMAN & DIU,2009,Total Salaried,0,6,0,0,0,6,0,1,1,0,0,2,8
DAMAN & DIU,2009,Total Self-employed,0,0,0,0,0,0,0,0,0,0,0,0,0
DAMAN & DIU,2010,House Wife,0,0,0,0,0,0,0,6,2,0,0,8,8
DAMAN & DIU,2010,Service (Government),0,0,1,0,0,1,0,0,0,0,0,0,1
DAMAN & DIU,2010,Service (Private),0,4,5,1,0,10,0,1,0,0,0,1,11
DAMAN & DIU,2010,Public Sector Undertaking,0,0,0,0,0,0,0,0,0,0,0,0,0
DAMAN & DIU,2010,Student,3,2,0,0,0,5,0,1,0,0,0,1,6
DAMAN & DIU,2010,Unemployed,0,0,0,0,0,0,0,0,0,0,0,0,0
DAMAN & DIU,2010,Self-employed (Business activity),0,0,0,0,0,0,0,0,0,0,0,0,0
DAMAN & DIU,2010,Professional Activity,0,0,0,0,0,0,0,0,0,0,0,0,0
DAMAN & DIU,2010,Farming/Agriculture Activity,0,0,0,0,0,0,0,0,0,0,0,0,0
DAMAN & DIU,2010,Others (Please Specify),0,0,0,0,0,0,0,0,0,0,0,0,0
DAMAN & DIU,2010,Retired Person,0,0,0,0,0,0,0,0,0,0,0,0,0
DAMAN & DIU,2010,Others (Please Specify),0,2,0,1,0,3,0,2,0,0,0,2,5
DAMAN & DIU,2010,Total,3,8,6,2,0,19,0,10,2,0,0,12,31
DAMAN & DIU,2010,Total Salaried,0,4,6,1,0,11,0,1,0,0,0,1,12
DAMAN & DIU,2010,Total Self-employed,0,0,0,0,0,0,0,0,0,0,0,0,0
DAMAN & DIU,2011,House Wife,0,0,0,0,0,0,0,5,1,1,0,7,7
DAMAN & DIU,2011,Service (Government),0,0,0,0,0,0,0,0,0,0,0,0,0
DAMAN & DIU,2011,Service (Private),0,6,4,3,0,13,0,3,0,0,0,3,16
DAMAN & DIU,2011,Public Sector Undertaking,0,0,0,0,0,0,0,0,0,0,0,0,0
DAMAN & DIU,2011,Student,1,0,0,0,0,1,0,4,0,0,0,4,5
DAMAN & DIU,2011,Unemployed,0,0,0,0,0,0,0,0,0,0,0,0,0
DAMAN & DIU,2011,Self-employed (Business activity),0,0,0,0,0,0,0,0,0,0,0,0,0
DAMAN & DIU,2011,Professional Activity,0,0,0,0,0,0,0,0,0,0,0,0,0
DAMAN & DIU,2011,Farming/Agriculture Activity,0,0,0,0,0,0,0,0,0,0,0,0,0
DAMAN & DIU,2011,Others (Please Specify),0,0,0,1,0,1,0,0,0,0,0,0,1
DAMAN & DIU,2011,Retired Person,0,0,0,0,0,0,0,0,0,0,0,0,0
DAMAN & DIU,2011,Others (Please Specify),0,1,2,0,0,3,0,1,0,0,0,1,4
DAMAN & DIU,2011,Total,1,7,6,4,0,18,0,13,1,1,0,15,33
DAMAN & DIU,2011,Total Salaried,0,6,4,3,0,13,0,3,0,0,0,3,16
DAMAN & DIU,2011,Total Self-employed,0,0,0,1,0,1,0,0,0,0,0,0,1
DAMAN & DIU,2012,House Wife,0,0,0,0,0,0,0,3,5,0,0,8,8
DAMAN & DIU,2012,Service (Government),0,0,0,0,0,0,0,0,0,0,0,0,0
DAMAN & DIU,2012,Service (Private),0,1,5,2,0,8,0,0,0,0,0,0,8
DAMAN & DIU,2012,Public Sector Undertaking,0,0,0,0,0,0,0,0,0,0,0,0,0
DAMAN & DIU,2012,Student,0,1,0,0,0,1,1,0,0,0,0,1,2
DAMAN & DIU,2012,Unemployed,0,0,1,0,0,1,0,0,0,0,0,0,1
DAMAN & DIU,2012,Self-employed (Business activity),0,0,0,0,0,0,0,0,0,0,0,0,0
DAMAN & DIU,2012,Professional Activity,0,0,0,0,0,0,0,0,0,0,0,0,0
DAMAN & DIU,2012,Farming/Agriculture Activity,0,0,0,0,0,0,0,0,0,0,0,0,0
DAMAN & DIU,2012,Others (Please Specify),0,0,1,0,0,1,0,0,0,0,0,0,1
DAMAN & DIU,2012,Retired Person,0,0,0,0,0,0,0,0,0,0,0,0,0
DAMAN & DIU,2012,Others (Please Specify),0,4,6,4,0,14,0,2,0,0,0,2,16
DAMAN & DIU,2012,Total,0,6,13,6,0,25,1,5,5,0,0,11,36
DAMAN & DIU,2012,Total Salaried,0,1,5,2,0,8,0,0,0,0,0,0,8
DAMAN & DIU,2012,Total Self-employed,0,0,1,0,0,1,0,0,0,0,0,0,1
DELHI (UT),2001,House Wife,0,0,0,0,0,0,0,174,118,27,8,327,327
DELHI (UT),2001,Service (Government),0,11,13,5,0,29,0,1,1,0,0,2,31
DELHI (UT),2001,Service (Private),0,68,51,27,1,147,0,12,1,0,0,13,160
DELHI (UT),2001,Public Sector Undertaking,0,10,6,2,1,19,0,1,0,0,0,1,20
DELHI (UT),2001,Student,9,42,4,0,0,55,14,35,0,0,0,49,104
DELHI (UT),2001,Unemployed,1,91,76,34,7,209,4,13,3,0,0,20,229
DELHI (UT),2001,Self-employed (Business activity),0,6,13,4,0,23,0,0,0,0,0,0,23
DELHI (UT),2001,Professional Activity,0,3,4,4,0,11,0,1,0,0,0,1,12
DELHI (UT),2001,Farming/Agriculture Activity,0,8,7,1,0,16,0,2,0,0,0,2,18
DELHI (UT),2001,Others (Please Specify),3,67,76,32,8,186,6,43,31,1,3,84,270
DELHI (UT),2001,Retired Person,0,0,0,0,1,1,0,0,0,0,0,0,1
DELHI (UT),2001,Others (Please Specify),2,9,10,6,7,34,4,0,3,3,0,10,44
DELHI (UT),2001,Total,15,315,260,115,25,730,28,282,157,31,11,509,1239
DELHI (UT),2001,Total Salaried,0,89,70,34,2,195,0,14,2,0,0,16,211
DELHI (UT),2001,Total Self-employed,3,84,100,41,8,236,6,46,31,1,3,87,323
DELHI (UT),2002,House Wife,0,0,0,0,0,0,0,139,93,16,2,250,250
DELHI (UT),2002,Service (Government),0,12,10,4,0,26,0,6,0,0,0,6,32
DELHI (UT),2002,Service (Private),0,49,53,20,0,122,0,8,6,0,0,14,136
DELHI (UT),2002,Public Sector Undertaking,0,1,5,3,0,9,0,0,0,0,0,0,9
DELHI (UT),2002,Student,10,37,0,0,0,47,14,37,7,0,0,58,105
DELHI (UT),2002,Unemployed,1,132,69,26,5,233,1,22,3,1,0,27,260
DELHI (UT),2002,Self-employed (Business activity),0,18,16,7,1,42,0,4,0,0,0,4,46
DELHI (UT),2002,Professional Activity,0,3,3,5,0,11,0,0,0,0,0,0,11
DELHI (UT),2002,Farming/Agriculture Activity,0,5,11,8,6,30,0,3,0,0,0,3,33
DELHI (UT),2002,Others (Please Specify),4,37,36,16,0,93,0,14,15,6,2,37,130
DELHI (UT),2002,Retired Person,0,0,1,1,4,6,0,0,0,0,0,0,6
DELHI (UT),2002,Others (Please Specify),0,7,14,3,0,24,1,8,2,0,0,11,35
DELHI (UT),2002,Total,15,301,218,93,16,643,16,241,126,23,4,410,1053
DELHI (UT),2002,Total Salaried,0,62,68,27,0,157,0,14,6,0,0,20,177
DELHI (UT),2002,Total Self-employed,4,63,66,36,7,176,0,21,15,6,2,44,220
DELHI (UT),2003,House Wife,0,0,0,0,0,0,0,115,77,26,3,221,221
DELHI (UT),2003,Service (Government),0,7,8,3,0,18,0,8,2,3,0,13,31
DELHI (UT),2003,Service (Private),0,46,46,14,2,108,0,13,7,0,0,20,128
DELHI (UT),2003,Public Sector Undertaking,0,2,6,2,0,10,0,1,0,0,0,1,11
DELHI (UT),2003,Student,9,43,0,0,0,52,12,50,3,0,0,65,117
DELHI (UT),2003,Unemployed,1,119,99,19,15,253,2,19,10,10,0,41,294
DELHI (UT),2003,Self-employed (Business activity),0,5,15,4,1,25,0,0,0,0,0,0,25
DELHI (UT),2003,Professional Activity,0,4,2,1,0,7,0,0,0,0,0,0,7
DELHI (UT),2003,Farming/Agriculture Activity,0,4,2,2,0,8,0,0,0,0,0,0,8
DELHI (UT),2003,Others (Please Specify),2,40,56,28,4,130,1,19,7,0,0,27,157
DELHI (UT),2003,Retired Person,0,0,0,0,0,0,0,0,0,0,0,0,0
DELHI (UT),2003,Others (Please Specify),6,58,44,17,5,130,4,10,6,2,2,24,154
DELHI (UT),2003,Total,18,328,278,90,27,741,19,235,112,41,5,412,1153
DELHI (UT),2003,Total Salaried,0,55,60,19,2,136,0,22,9,3,0,34,170
DELHI (UT),2003,Total Self-employed,2,53,75,35,5,170,1,19,7,0,0,27,197
DELHI (UT),2004,House Wife,0,0,0,0,0,0,0,158,78,16,14,266,266
DELHI (UT),2004,Service (Government),0,1,9,4,0,14,0,0,0,0,0,0,14
DELHI (UT),2004,Service (Private),0,88,84,24,3,199,0,4,2,0,0,6,205
DELHI (UT),2004,Public Sector Undertaking,0,5,3,2,1,11,0,3,1,0,0,4,15
DELHI (UT),2004,Student,15,42,0,0,0,57,12,41,0,0,0,53,110
DELHI (UT),2004,Unemployed,2,112,101,33,6,254,1,42,18,3,2,66,320
DELHI (UT),2004,Self-employed (Business activity),0,15,9,6,1,31,0,0,0,0,0,0,31
DELHI (UT),2004,Professional Activity,0,3,2,0,0,5,0,0,0,0,0,0,5
DELHI (UT),2004,Farming/Agriculture Activity,0,1,3,5,3,12,0,0,0,1,0,1,13
DELHI (UT),2004,Others (Please Specify),1,55,62,26,4,148,3,22,16,2,0,43,191
DELHI (UT),2004,Retired Person,0,0,0,0,2,2,0,0,0,0,0,0,2
DELHI (UT),2004,Others (Please Specify),1,20,25,20,0,66,1,13,2,2,0,18,84
DELHI (UT),2004,Total,19,342,298,120,20,799,17,283,117,24,16,457,1256
DELHI (UT),2004,Total Salaried,0,94,96,30,4,224,0,7,3,0,0,10,234
DELHI (UT),2004,Total Self-employed,1,74,76,37,8,196,3,22,16,3,0,44,240
DELHI (UT),2005,House Wife,0,0,0,0,0,0,0,162,102,23,7,294,294
DELHI (UT),2005,Service (Government),0,7,18,11,0,36,0,3,0,1,0,4,40
DELHI (UT),2005,Service (Private),0,76,58,29,2,165,1,14,3,0,0,18,183
DELHI (UT),2005,Public Sector Undertaking,0,1,2,1,0,4,0,1,0,0,0,1,5
DELHI (UT),2005,Student,4,50,5,0,0,59,5,33,1,0,0,39,98
DELHI (UT),2005,Unemployed,1,109,69,24,6,209,2,25,5,0,0,32,241
DELHI (UT),2005,Self-employed (Business activity),0,7,8,0,1,16,0,0,0,0,0,0,16
DELHI (UT),2005,Professional Activity,0,0,1,3,1,5,0,1,0,0,0,1,6
DELHI (UT),2005,Farming/Agriculture Activity,0,1,5,1,0,7,0,0,0,0,0,0,7
DELHI (UT),2005,Others (Please Specify),0,54,44,17,7,122,0,11,12,1,0,24,146
DELHI (UT),2005,Retired Person,0,0,0,0,3,3,0,0,0,0,0,0,3
DELHI (UT),2005,Others (Please Specify),3,65,54,25,4,151,5,31,17,1,1,55,206
DELHI (UT),2005,Total,8,370,264,111,24,777,13,281,140,26,8,468,1245
DELHI (UT),2005,Total Salaried,0,84,78,41,2,205,1,18,3,1,0,23,228
DELHI (UT),2005,Total Self-employed,0,62,58,21,9,150,0,12,12,1,0,25,175
DELHI (UT),2006,House Wife,0,0,0,0,0,0,0,194,111,24,2,331,331
DELHI (UT),2006,Service (Government),0,4,15,8,0,27,0,1,3,0,0,4,31
DELHI (UT),2006,Service (Private),0,116,94,37,1,248,0,15,2,0,0,17,265
DELHI (UT),2006,Public Sector Undertaking,0,10,11,1,0,22,1,2,0,0,0,3,25
DELHI (UT),2006,Student,3,52,0,0,0,55,9,53,1,0,0,63,118
DELHI (UT),2006,Unemployed,1,150,90,33,3,277,1,32,5,0,2,40,317
DELHI (UT),2006,Self-employed (Business activity),0,7,13,1,1,22,0,6,1,0,0,7,29
DELHI (UT),2006,Professional Activity,0,1,1,2,0,4,0,0,0,0,0,0,4
DELHI (UT),2006,Farming/Agriculture Activity,0,0,3,0,0,3,0,0,0,0,0,0,3
DELHI (UT),2006,Others (Please Specify),4,69,82,44,12,211,2,21,23,2,0,48,259
DELHI (UT),2006,Retired Person,0,9,5,2,1,17,0,0,0,0,0,0,17
DELHI (UT),2006,Others (Please Specify),1,31,26,11,5,74,3,11,2,2,1,19,93
DELHI (UT),2006,Total,9,449,340,139,23,960,16,335,148,28,5,532,1492
DELHI (UT),2006,Total Salaried,0,130,120,46,1,297,1,18,5,0,0,24,321
DELHI (UT),2006,Total Self-employed,4,77,99,47,13,240,2,27,24,2,0,55,295
DELHI (UT),2007,House Wife,0,0,0,0,0,0,0,158,86,12,7,263,263
DELHI (UT),2007,Service (Government),0,6,15,3,0,24,0,3,1,0,0,4,28
DELHI (UT),2007,Service (Private),1,100,90,25,3,219,0,22,6,1,0,29,248
DELHI (UT),2007,Public Sector Undertaking,0,4,5,3,0,12,0,2,0,0,0,2,14
DELHI (UT),2007,Student,9,61,5,0,0,75,7,53,0,0,0,60,135
DELHI (UT),2007,Unemployed,1,108,70,18,5,202,0,44,6,0,0,50,252
DELHI (UT),2007,Self-employed (Business activity),0,9,2,5,1,17,0,0,0,0,0,0,17
DELHI (UT),2007,Professional Activity,0,3,0,1,0,4,0,1,0,0,0,1,5
DELHI (UT),2007,Farming/Agriculture Activity,0,5,10,7,1,23,0,0,0,0,0,0,23
DELHI (UT),2007,Others (Please Specify),0,50,71,22,6,149,0,25,7,0,0,32,181
DELHI (UT),2007,Retired Person,0,0,0,0,5,5,0,0,0,0,0,0,5
DELHI (UT),2007,Others (Please Specify),2,85,107,31,11,236,8,38,22,5,1,74,310
DELHI (UT),2007,Total,13,431,375,115,32,966,15,346,128,18,8,515,1481
DELHI (UT),2007,Total Salaried,1,110,110,31,3,255,0,27,7,1,0,35,290
DELHI (UT),2007,Total Self-employed,0,67,83,35,8,193,0,26,7,0,0,33,226
DELHI (UT),2008,House Wife,0,0,0,0,0,0,0,166,89,19,2,276,276
DELHI (UT),2008,Service (Government),0,2,7,4,0,13,0,0,1,1,0,2,15
DELHI (UT),2008,Service (Private),0,78,82,24,2,186,0,18,7,2,0,27,213
DELHI (UT),2008,Public Sector Undertaking,0,16,12,3,4,35,0,3,0,0,0,3,38
DELHI (UT),2008,Student,13,63,1,0,0,77,13,79,6,0,0,98,175
DELHI (UT),2008,Unemployed,1,99,84,22,5,211,1,36,4,0,0,41,252
DELHI (UT),2008,Self-employed (Business activity),0,7,10,4,0,21,0,0,0,0,0,0,21
DELHI (UT),2008,Professional Activity,0,0,3,3,1,7,0,0,0,0,0,0,7
DELHI (UT),2008,Farming/Agriculture Activity,0,5,5,2,3,15,1,0,0,0,0,1,16
DELHI (UT),2008,Others (Please Specify),2,58,51,27,8,146,1,18,4,2,0,25,171
DELHI (UT),2008,Retired Person,0,0,0,1,1,2,0,0,0,0,0,0,2
DELHI (UT),2008,Others (Please Specify),0,43,31,7,1,82,2,27,4,1,1,35,117
DELHI (UT),2008,Total,16,371,286,97,25,795,18,347,115,25,3,508,1303
DELHI (UT),2008,Total Salaried,0,96,101,31,6,234,0,21,8,3,0,32,266
DELHI (UT),2008,Total Self-employed,2,70,69,36,12,189,2,18,4,2,0,26,215
DELHI (UT),2009,House Wife,0,0,0,0,0,0,0,198,98,21,6,323,323
DELHI (UT),2009,Service (Government),0,4,9,5,0,18,0,1,1,0,0,2,20
DELHI (UT),2009,Service (Private),0,88,99,21,2,210,0,16,3,2,0,21,231
DELHI (UT),2009,Public Sector Undertaking,0,9,11,4,0,24,0,2,0,0,0,2,26
DELHI (UT),2009,Student,10,87,2,0,0,99,7,58,1,0,0,66,165
DELHI (UT),2009,Unemployed,1,129,80,25,3,238,5,30,7,0,0,42,280
DELHI (UT),2009,Self-employed (Business activity),0,13,12,5,1,31,0,0,0,0,0,0,31
DELHI (UT),2009,Professional Activity,0,3,5,4,0,12,0,1,0,0,0,1,13
DELHI (UT),2009,Farming/Agriculture Activity,0,1,3,1,0,5,0,0,0,0,0,0,5
DELHI (UT),2009,Others (Please Specify),0,39,43,22,4,108,0,12,8,4,0,24,132
DELHI (UT),2009,Retired Person,0,0,0,0,7,7,0,0,0,0,0,0,7
DELHI (UT),2009,Others (Please Specify),4,84,61,21,11,181,7,42,7,6,1,63,244
DELHI (UT),2009,Total,15,457,325,108,28,933,19,360,125,33,7,544,1477
DELHI (UT),2009,Total Salaried,0,101,119,30,2,252,0,19,4,2,0,25,277
DELHI (UT),2009,Total Self-employed,0,56,63,32,5,156,0,13,8,4,0,25,181
DELHI (UT),2010,House Wife,0,0,0,0,0,0,0,197,117,31,7,352,352
DELHI (UT),2010,Service (Government),0,2,7,6,0,15,0,3,0,0,0,3,18
DELHI (UT),2010,Service (Private),0,90,78,22,11,201,0,18,3,1,0,22,223
DELHI (UT),2010,Public Sector Undertaking,0,12,23,4,0,39,0,5,0,0,0,5,44
DELHI (UT),2010,Student,11,75,1,0,0,87,18,56,3,2,0,79,166
DELHI (UT),2010,Unemployed,0,102,88,30,16,236,3,32,8,0,0,43,279
DELHI (UT),2010,Self-employed (Business activity),0,13,11,8,0,32,0,0,0,0,0,0,32
DELHI (UT),2010,Professional Activity,0,1,2,0,0,3,0,0,1,0,0,1,4
DELHI (UT),2010,Farming/Agriculture Activity,0,2,5,2,0,9,0,0,0,0,0,0,9
DELHI (UT),2010,Others (Please Specify),0,63,69,34,10,176,0,29,6,1,1,37,213
DELHI (UT),2010,Retired Person,0,0,0,0,4,4,0,0,0,0,0,0,4
DELHI (UT),2010,Others (Please Specify),5,69,55,24,6,159,3,23,12,1,1,40,199
DELHI (UT),2010,Total,16,429,339,130,47,961,24,363,150,36,9,582,1543
DELHI (UT),2010,Total Salaried,0,104,108,32,11,255,0,26,3,1,0,30,285
DELHI (UT),2010,Total Self-employed,0,79,87,44,10,220,0,29,7,1,1,38,258
DELHI (UT),2011,House Wife,0,0,0,0,0,0,0,158,101,20,11,290,290
DELHI (UT),2011,Service (Government),0,12,10,5,0,27,0,4,1,1,0,6,33
DELHI (UT),2011,Service (Private),0,97,100,28,2,227,0,21,5,2,0,28,255
DELHI (UT),2011,Public Sector Undertaking,0,20,6,3,0,29,0,1,0,0,0,1,30
DELHI (UT),2011,Student,12,102,0,0,0,114,11,75,0,0,0,86,200
DELHI (UT),2011,Unemployed,1,210,130,25,4,370,1,40,10,3,1,55,425
DELHI (UT),2011,Self-employed (Business activity),0,9,10,7,0,26,0,0,0,1,0,1,27
DELHI (UT),2011,Professional Activity,0,5,7,1,0,13,0,0,0,0,0,0,13
DELHI (UT),2011,Farming/Agriculture Activity,0,2,6,2,0,10,0,0,0,0,0,0,10
DELHI (UT),2011,Others (Please Specify),1,70,47,19,7,144,1,13,7,10,0,31,175
DELHI (UT),2011,Retired Person,0,0,0,0,11,11,0,0,0,0,0,0,11
DELHI (UT),2011,Others (Please Specify),4,95,51,37,10,197,6,31,11,1,1,50,247
DELHI (UT),2011,Total,18,622,367,127,34,1168,19,343,135,38,13,548,1716
DELHI (UT),2011,Total Salaried,0,129,116,36,2,283,0,26,6,3,0,35,318
DELHI (UT),2011,Total Self-employed,1,86,70,29,7,193,1,13,7,11,0,32,225
DELHI (UT),2012,House Wife,0,0,0,0,0,0,0,194,114,36,11,355,355
DELHI (UT),2012,Service (Government),0,4,10,10,0,24,0,0,0,1,0,1,25
DELHI (UT),2012,Service (Private),0,120,107,35,2,264,0,14,2,0,0,16,280
DELHI (UT),2012,Public Sector Undertaking,0,15,20,3,0,38,0,3,0,0,0,3,41
DELHI (UT),2012,Student,19,118,0,0,0,137,22,101,6,0,0,129,266
DELHI (UT),2012,Unemployed,3,177,109,27,4,320,4,43,2,0,0,49,369
DELHI (UT),2012,Self-employed (Business activity),0,11,30,1,2,44,0,0,0,0,0,0,44
DELHI (UT),2012,Professional Activity,0,3,3,1,0,7,0,0,3,0,0,3,10
DELHI (UT),2012,Farming/Agriculture Activity,0,12,3,6,0,21,0,0,0,0,0,0,21
DELHI (UT),2012,Others (Please Specify),1,71,60,25,10,167,1,14,8,1,1,25,192
DELHI (UT),2012,Retired Person,0,0,1,2,14,17,0,0,0,0,0,0,17
DELHI (UT),2012,Others (Please Specify),3,90,83,27,4,207,4,40,24,3,1,72,279
DELHI (UT),2012,Total,26,621,426,137,36,1246,31,409,159,41,13,653,1899
DELHI (UT),2012,Total Salaried,0,139,137,48,2,326,0,17,2,1,0,20,346
DELHI (UT),2012,Total Self-employed,1,97,96,33,12,239,1,14,11,1,1,28,267
LAKSHADWEEP,2001,House Wife,0,0,0,0,0,0,0,0,0,0,0,0,0
LAKSHADWEEP,2001,Service (Government),0,0,0,0,0,0,0,0,0,0,0,0,0
LAKSHADWEEP,2001,Service (Private),0,0,0,0,0,0,0,0,0,0,0,0,0
LAKSHADWEEP,2001,Public Sector Undertaking,0,0,0,0,0,0,0,0,0,0,0,0,0
LAKSHADWEEP,2001,Student,0,0,0,0,0,0,0,0,0,0,0,0,0
LAKSHADWEEP,2001,Unemployed,0,0,0,0,0,0,0,0,0,0,0,0,0
LAKSHADWEEP,2001,Self-employed (Business activity),0,0,0,0,0,0,0,0,0,0,0,0,0
LAKSHADWEEP,2001,Professional Activity,0,0,0,0,0,0,0,0,0,0,0,0,0
LAKSHADWEEP,2001,Farming/Agriculture Activity,0,0,0,0,0,0,0,0,0,0,0,0,0
LAKSHADWEEP,2001,Others (Please Specify),0,0,0,0,0,0,0,0,0,0,0,0,0
LAKSHADWEEP,2001,Retired Person,0,0,0,0,0,0,0,0,0,0,0,0,0
LAKSHADWEEP,2001,Others (Please Specify),0,0,0,0,0,0,0,0,0,0,0,0,0
LAKSHADWEEP,2001,Total,0,0,0,0,0,0,0,0,0,0,0,0,0
LAKSHADWEEP,2001,Total Salaried,0,0,0,0,0,0,0,0,0,0,0,0,0
LAKSHADWEEP,2001,Total Self-employed,0,0,0,0,0,0,0,0,0,0,0,0,0
LAKSHADWEEP,2002,House Wife,0,0,0,0,0,0,0,0,0,0,0,0,0
LAKSHADWEEP,2002,Service (Government),0,0,0,0,0,0,0,0,0,0,0,0,0
LAKSHADWEEP,2002,Service (Private),0,0,0,0,0,0,0,0,0,0,0,0,0
LAKSHADWEEP,2002,Public Sector Undertaking,0,0,0,0,0,0,0,0,0,0,0,0,0
LAKSHADWEEP,2002,Student,0,0,0,0,0,0,0,0,0,0,0,0,0
LAKSHADWEEP,2002,Unemployed,0,0,0,0,0,0,0,0,0,0,0,0,0
LAKSHADWEEP,2002,Self-employed (Business activity),0,0,0,0,0,0,0,0,0,0,0,0,0
LAKSHADWEEP,2002,Professional Activity,0,0,0,0,0,0,0,0,0,0,0,0,0
LAKSHADWEEP,2002,Farming/Agriculture Activity,0,0,0,0,0,0,0,0,0,0,0,0,0
LAKSHADWEEP,2002,Others (Please Specify),0,0,0,0,0,0,0,0,0,0,0,0,0
LAKSHADWEEP,2002,Retired Person,0,0,0,0,0,0,0,0,0,0,0,0,0
LAKSHADWEEP,2002,Others (Please Specify),0,0,0,0,0,0,0,0,0,0,0,0,0
LAKSHADWEEP,2002,Total,0,0,0,0,0,0,0,0,0,0,0,0,0
LAKSHADWEEP,2002,Total Salaried,0,0,0,0,0,0,0,0,0,0,0,0,0
LAKSHADWEEP,2002,Total Self-employed,0,0,0,0,0,0,0,0,0,0,0,0,0
LAKSHADWEEP,2003,House Wife,0,0,0,0,0,0,0,1,0,0,0,1,1
LAKSHADWEEP,2003,Service (Government),0,0,0,0,0,0,0,0,0,0,0,0,0
LAKSHADWEEP,2003,Service (Private),0,0,0,0,0,0,0,0,0,0,0,0,0
LAKSHADWEEP,2003,Public Sector Undertaking,0,0,0,0,0,0,0,0,0,0,0,0,0
LAKSHADWEEP,2003,Student,0,0,0,0,0,0,0,0,0,0,0,0,0
LAKSHADWEEP,2003,Unemployed,0,0,0,0,0,0,0,0,0,0,0,0,0
LAKSHADWEEP,2003,Self-employed (Business activity),0,0,0,0,0,0,0,0,0,0,0,0,0
LAKSHADWEEP,2003,Professional Activity,0,0,0,0,0,0,0,0,0,0,0,0,0
LAKSHADWEEP,2003,Farming/Agriculture Activity,0,0,0,0,0,0,0,0,0,0,0,0,0
LAKSHADWEEP,2003,Others (Please Specify),0,0,0,0,0,0,0,0,0,0,0,0,0
LAKSHADWEEP,2003,Retired Person,0,0,0,0,0,0,0,0,0,0,0,0,0
LAKSHADWEEP,2003,Others (Please Specify),0,0,0,0,1,1,0,0,0,0,0,0,1
LAKSHADWEEP,2003,Total,0,0,0,0,1,1,0,1,0,0,0,1,2
LAKSHADWEEP,2003,Total Salaried,0,0,0,0,0,0,0,0,0,0,0,0,0
LAKSHADWEEP,2003,Total Self-employed,0,0,0,0,0,0,0,0,0,0,0,0,0
LAKSHADWEEP,2004,House Wife,0,0,0,0,0,0,0,0,0,0,0,0,0
LAKSHADWEEP,2004,Service (Government),0,0,0,0,0,0,0,0,0,0,0,0,0
LAKSHADWEEP,2004,Service (Private),0,0,0,0,0,0,0,0,0,0,0,0,0
LAKSHADWEEP,2004,Public Sector Undertaking,0,0,0,0,0,0,0,0,0,0,0,0,0
LAKSHADWEEP,2004,Student,0,0,0,0,0,0,0,0,0,0,0,0,0
LAKSHADWEEP,2004,Unemployed,0,0,0,0,0,0,0,0,0,0,0,0,0
LAKSHADWEEP,2004,Self-employed (Business activity),0,0,0,0,0,0,0,0,0,0,0,0,0
LAKSHADWEEP,2004,Professional Activity,0,0,0,0,0,0,0,0,0,0,0,0,0
LAKSHADWEEP,2004,Farming/Agriculture Activity,0,0,0,0,0,0,0,0,0,0,0,0,0
LAKSHADWEEP,2004,Others (Please Specify),0,0,0,0,0,0,0,0,0,0,0,0,0
LAKSHADWEEP,2004,Retired Person,0,0,0,0,0,0,0,0,0,0,0,0,0
LAKSHADWEEP,2004,Others (Please Specify),0,0,0,0,0,0,0,0,0,0,0,0,0
LAKSHADWEEP,2004,Total,0,0,0,0,0,0,0,0,0,0,0,0,0
LAKSHADWEEP,2004,Total Salaried,0,0,0,0,0,0,0,0,0,0,0,0,0
LAKSHADWEEP,2004,Total Self-employed,0,0,0,0,0,0,0,0,0,0,0,0,0
LAKSHADWEEP,2005,House Wife,0,0,0,0,0,0,0,0,0,0,0,0,0
LAKSHADWEEP,2005,Service (Government),0,0,0,0,0,0,0,0,0,0,0,0,0
LAKSHADWEEP,2005,Service (Private),0,0,0,0,0,0,0,0,0,0,0,0,0
LAKSHADWEEP,2005,Public Sector Undertaking,0,0,0,0,0,0,0,0,0,0,0,0,0
LAKSHADWEEP,2005,Student,0,0,0,0,0,0,0,0,0,0,0,0,0
LAKSHADWEEP,2005,Unemployed,0,0,0,0,0,0,0,0,0,0,0,0,0
LAKSHADWEEP,2005,Self-employed (Business activity),0,0,0,0,0,0,0,0,0,0,0,0,0
LAKSHADWEEP,2005,Professional Activity,0,0,0,0,0,0,0,0,0,0,0,0,0
LAKSHADWEEP,2005,Farming/Agriculture Activity,0,0,0,0,0,0,0,0,0,0,0,0,0
LAKSHADWEEP,2005,Others (Please Specify),0,0,0,0,0,0,0,0,0,0,0,0,0
LAKSHADWEEP,2005,Retired Person,0,0,0,0,0,0,0,0,0,0,0,0,0
LAKSHADWEEP,2005,Others (Please Specify),0,0,0,0,0,0,0,0,0,0,0,0,0
LAKSHADWEEP,2005,Total,0,0,0,0,0,0,0,0,0,0,0,0,0
LAKSHADWEEP,2005,Total Salaried,0,0,0,0,0,0,0,0,0,0,0,0,0
LAKSHADWEEP,2005,Total Self-employed,0,0,0,0,0,0,0,0,0,0,0,0,0
LAKSHADWEEP,2006,House Wife,0,0,0,0,0,0,0,1,0,0,0,1,1
LAKSHADWEEP,2006,Service (Government),0,0,1,0,0,1,0,0,0,0,0,0,1
LAKSHADWEEP,2006,Service (Private),0,0,0,0,0,0,0,0,0,0,0,0,0
LAKSHADWEEP,2006,Public Sector Undertaking,0,0,0,0,0,0,0,0,0,0,0,0,0
LAKSHADWEEP,2006,Student,0,0,0,0,0,0,0,0,0,0,0,0,0
LAKSHADWEEP,2006,Unemployed,0,0,0,0,0,0,0,0,0,0,0,0,0
LAKSHADWEEP,2006,Self-employed (Business activity),0,0,0,0,0,0,0,0,0,0,0,0,0
LAKSHADWEEP,2006,Professional Activity,0,0,0,0,0,0,0,0,0,0,0,0,0
LAKSHADWEEP,2006,Farming/Agriculture Activity,0,0,0,0,0,0,0,0,0,0,0,0,0
LAKSHADWEEP,2006,Others (Please Specify),0,0,0,0,0,0,0,0,0,0,0,0,0
LAKSHADWEEP,2006,Retired Person,0,0,0,0,0,0,0,0,0,0,0,0,0
LAKSHADWEEP,2006,Others (Please Specify),0,0,0,0,0,0,0,0,0,0,0,0,0
LAKSHADWEEP,2006,Total,0,0,1,0,0,1,0,1,0,0,0,1,2
LAKSHADWEEP,2006,Total Salaried,0,0,1,0,0,1,0,0,0,0,0,0,1
LAKSHADWEEP,2006,Total Self-employed,0,0,0,0,0,0,0,0,0,0,0,0,0
LAKSHADWEEP,2007,House Wife,0,0,0,0,0,0,0,0,0,2,0,2,2
LAKSHADWEEP,2007,Service (Government),0,0,1,0,0,1,0,0,0,0,0,0,1
LAKSHADWEEP,2007,Service (Private),0,0,0,0,0,0,0,0,0,0,0,0,0
LAKSHADWEEP,2007,Public Sector Undertaking,0,0,0,0,0,0,0,0,0,0,0,0,0
LAKSHADWEEP,2007,Student,0,0,0,0,0,0,0,0,0,0,0,0,0
LAKSHADWEEP,2007,Unemployed,0,0,0,0,0,0,0,0,0,0,0,0,0
LAKSHADWEEP,2007,Self-employed (Business activity),0,0,0,0,0,0,0,0,0,0,0,0,0
LAKSHADWEEP,2007,Professional Activity,0,0,0,0,0,0,0,0,0,0,0,0,0
LAKSHADWEEP,2007,Farming/Agriculture Activity,0,0,0,0,0,0,0,0,0,0,0,0,0
LAKSHADWEEP,2007,Others (Please Specify),0,0,0,0,0,0,0,0,0,0,0,0,0
LAKSHADWEEP,2007,Retired Person,0,0,0,0,0,0,0,0,0,0,0,0,0
LAKSHADWEEP,2007,Others (Please Specify),0,0,0,0,0,0,0,0,0,0,0,0,0
LAKSHADWEEP,2007,Total,0,0,1,0,0,1,0,0,0,2,0,2,3
LAKSHADWEEP,2007,Total Salaried,0,0,1,0,0,1,0,0,0,0,0,0,1
LAKSHADWEEP,2007,Total Self-employed,0,0,0,0,0,0,0,0,0,0,0,0,0
LAKSHADWEEP,2008,House Wife,0,0,0,0,0,0,0,0,0,0,0,0,0
LAKSHADWEEP,2008,Service (Government),0,0,0,0,0,0,0,0,0,0,0,0,0
LAKSHADWEEP,2008,Service (Private),0,0,0,0,0,0,0,0,0,0,0,0,0
LAKSHADWEEP,2008,Public Sector Undertaking,0,0,0,0,0,0,0,0,0,0,0,0,0
LAKSHADWEEP,2008,Student,0,0,0,0,0,0,0,0,0,0,0,0,0
LAKSHADWEEP,2008,Unemployed,0,0,0,0,0,0,0,0,0,0,0,0,0
LAKSHADWEEP,2008,Self-employed (Business activity),0,0,0,0,0,0,0,0,0,0,0,0,0
LAKSHADWEEP,2008,Professional Activity,0,0,0,0,0,0,0,0,0,0,0,0,0
LAKSHADWEEP,2008,Farming/Agriculture Activity,0,0,0,0,0,0,0,0,0,0,0,0,0
LAKSHADWEEP,2008,Others (Please Specify),0,0,0,0,0,0,0,0,0,0,0,0,0
LAKSHADWEEP,2008,Retired Person,0,0,0,0,0,0,0,0,0,0,0,0,0
LAKSHADWEEP,2008,Others (Please Specify),0,0,0,0,0,0,0,0,0,0,0,0,0
LAKSHADWEEP,2008,Total,0,0,0,0,0,0,0,0,0,0,0,0,0
LAKSHADWEEP,2008,Total Salaried,0,0,0,0,0,0,0,0,0,0,0,0,0
LAKSHADWEEP,2008,Total Self-employed,0,0,0,0,0,0,0,0,0,0,0,0,0
LAKSHADWEEP,2009,House Wife,0,0,0,0,0,0,0,0,1,0,0,1,1
LAKSHADWEEP,2009,Service (Government),0,0,0,0,0,0,0,0,0,0,0,0,0
LAKSHADWEEP,2009,Service (Private),0,0,0,0,0,0,0,0,0,0,0,0,0
LAKSHADWEEP,2009,Public Sector Undertaking,0,0,0,0,0,0,0,0,0,0,0,0,0
LAKSHADWEEP,2009,Student,0,0,0,0,0,0,0,0,0,0,0,0,0
LAKSHADWEEP,2009,Unemployed,0,0,0,0,0,0,0,0,0,0,0,0,0
LAKSHADWEEP,2009,Self-employed (Business activity),0,0,0,0,0,0,0,0,0,0,0,0,0
LAKSHADWEEP,2009,Professional Activity,0,0,0,0,0,0,0,0,0,0,0,0,0
LAKSHADWEEP,2009,Farming/Agriculture Activity,0,0,0,0,0,0,0,0,0,0,0,0,0
LAKSHADWEEP,2009,Others (Please Specify),0,0,0,0,0,0,0,0,0,0,0,0,0
LAKSHADWEEP,2009,Retired Person,0,0,0,0,0,0,0,0,0,0,0,0,0
LAKSHADWEEP,2009,Others (Please Specify),0,0,0,0,0,0,0,0,0,0,0,0,0
LAKSHADWEEP,2009,Total,0,0,0,0,0,0,0,0,1,0,0,1,1
LAKSHADWEEP,2009,Total Salaried,0,0,0,0,0,0,0,0,0,0,0,0,0
LAKSHADWEEP,2009,Total Self-employed,0,0,0,0,0,0,0,0,0,0,0,0,0
LAKSHADWEEP,2010,House Wife,0,0,0,0,0,0,0,0,1,0,0,1,1
LAKSHADWEEP,2010,Service (Government),0,0,0,0,0,0,0,0,0,0,0,0,0
LAKSHADWEEP,2010,Service (Private),0,0,0,0,0,0,0,0,0,0,0,0,0
LAKSHADWEEP,2010,Public Sector Undertaking,0,0,0,0,0,0,0,0,0,0,0,0,0
LAKSHADWEEP,2010,Student,0,0,0,0,0,0,0,0,0,0,0,0,0
LAKSHADWEEP,2010,Unemployed,0,0,0,0,0,0,0,0,0,0,0,0,0
LAKSHADWEEP,2010,Self-employed (Business activity),0,0,0,0,0,0,0,0,0,0,0,0,0
LAKSHADWEEP,2010,Professional Activity,0,0,0,0,0,0,0,0,0,0,0,0,0
LAKSHADWEEP,2010,Farming/Agriculture Activity,0,0,0,0,0,0,0,0,0,0,0,0,0
LAKSHADWEEP,2010,Others (Please Specify),0,0,0,0,0,0,0,0,0,0,0,0,0
LAKSHADWEEP,2010,Retired Person,0,0,0,0,0,0,0,0,0,0,0,0,0
LAKSHADWEEP,2010,Others (Please Specify),0,0,0,0,0,0,0,0,0,0,0,0,0
LAKSHADWEEP,2010,Total,0,0,0,0,0,0,0,0,1,0,0,1,1
LAKSHADWEEP,2010,Total Salaried,0,0,0,0,0,0,0,0,0,0,0,0,0
LAKSHADWEEP,2010,Total Self-employed,0,0,0,0,0,0,0,0,0,0,0,0,0
LAKSHADWEEP,2011,House Wife,0,0,0,0,0,0,0,0,0,0,0,0,0
LAKSHADWEEP,2011,Service (Government),0,0,0,0,0,0,0,0,0,0,0,0,0
LAKSHADWEEP,2011,Service (Private),0,0,0,0,0,0,0,0,0,0,0,0,0
LAKSHADWEEP,2011,Public Sector Undertaking,0,0,0,0,0,0,0,0,0,0,0,0,0
LAKSHADWEEP,2011,Student,0,0,0,0,0,0,0,0,0,0,0,0,0
LAKSHADWEEP,2011,Unemployed,0,0,0,0,0,0,0,0,0,0,0,0,0
LAKSHADWEEP,2011,Self-employed (Business activity),0,0,0,0,0,0,0,0,0,0,0,0,0
LAKSHADWEEP,2011,Professional Activity,0,0,0,0,0,0,0,0,0,0,0,0,0
LAKSHADWEEP,2011,Farming/Agriculture Activity,0,0,0,0,0,0,0,0,0,0,0,0,0
LAKSHADWEEP,2011,Others (Please Specify),0,0,0,0,0,0,0,0,0,0,0,0,0
LAKSHADWEEP,2011,Retired Person,0,0,0,0,0,0,0,0,0,0,0,0,0
LAKSHADWEEP,2011,Others (Please Specify),0,0,0,0,0,0,0,0,0,0,0,0,0
LAKSHADWEEP,2011,Total,0,0,0,0,0,0,0,0,0,0,0,0,0
LAKSHADWEEP,2011,Total Salaried,0,0,0,0,0,0,0,0,0,0,0,0,0
LAKSHADWEEP,2011,Total Self-employed,0,0,0,0,0,0,0,0,0,0,0,0,0
LAKSHADWEEP,2012,House Wife,0,0,0,0,0,0,0,0,0,0,0,0,0
LAKSHADWEEP,2012,Service (Government),0,0,0,0,0,0,0,0,0,0,0,0,0
LAKSHADWEEP,2012,Service (Private),0,0,0,0,0,0,0,0,0,0,0,0,0
LAKSHADWEEP,2012,Public Sector Undertaking,0,0,0,0,0,0,0,0,0,0,0,0,0
LAKSHADWEEP,2012,Student,0,0,0,0,0,0,0,0,0,0,0,0,0
LAKSHADWEEP,2012,Unemployed,0,0,0,0,0,0,0,0,0,0,0,0,0
LAKSHADWEEP,2012,Self-employed (Business activity),0,0,0,0,0,0,0,0,0,0,0,0,0
LAKSHADWEEP,2012,Professional Activity,0,0,0,0,0,0,0,0,0,0,0,0,0
LAKSHADWEEP,2012,Farming/Agriculture Activity,0,0,0,0,0,0,0,0,0,0,0,0,0
LAKSHADWEEP,2012,Others (Please Specify),0,0,0,0,0,0,0,0,0,0,0,0,0
LAKSHADWEEP,2012,Retired Person,0,0,0,0,0,0,0,0,0,0,0,0,0
LAKSHADWEEP,2012,Others (Please Specify),0,0,1,0,0,1,0,0,0,0,0,0,1
LAKSHADWEEP,2012,Total,0,0,1,0,0,1,0,0,0,0,0,0,1
LAKSHADWEEP,2012,Total Salaried,0,0,0,0,0,0,0,0,0,0,0,0,0
LAKSHADWEEP,2012,Total Self-employed,0,0,0,0,0,0,0,0,0,0,0,0,0
PUDUCHERRY,2001,House Wife,0,0,0,0,0,0,0,63,46,18,7,134,134
PUDUCHERRY,2001,Service (Government),0,0,5,0,0,5,0,0,0,1,0,1,6
PUDUCHERRY,2001,Service (Private),0,26,44,22,2,94,0,5,1,0,0,6,100
PUDUCHERRY,2001,Public Sector Undertaking,0,0,1,3,0,4,0,0,0,1,0,1,5
PUDUCHERRY,2001,Student,2,7,0,0,0,9,4,18,0,0,0,22,31
PUDUCHERRY,2001,Unemployed,0,14,6,5,26,51,2,27,3,0,0,32,83
PUDUCHERRY,2001,Self-employed (Business activity),0,7,5,4,1,17,0,0,0,0,0,0,17
PUDUCHERRY,2001,Professional Activity,0,0,0,0,0,0,0,0,0,0,0,0,0
PUDUCHERRY,2001,Farming/Agriculture Activity,0,10,28,35,10,83,0,5,1,2,0,8,91
PUDUCHERRY,2001,Others (Please Specify),0,18,26,15,1,60,0,2,0,0,0,2,62
PUDUCHERRY,2001,Retired Person,0,0,0,0,0,0,0,0,0,0,0,0,0
PUDUCHERRY,2001,Others (Please Specify),0,0,0,0,0,0,0,0,0,0,0,0,0
PUDUCHERRY,2001,Total,2,82,115,84,40,323,6,120,51,22,7,206,529
PUDUCHERRY,2001,Total Salaried,0,26,50,25,2,103,0,5,1,2,0,8,111
PUDUCHERRY,2001,Total Self-employed,0,35,59,54,12,160,0,7,1,2,0,10,170
PUDUCHERRY,2002,House Wife,0,0,0,0,0,0,0,35,34,22,12,103,103
PUDUCHERRY,2002,Service (Government),0,3,5,9,1,18,0,0,1,0,0,1,19
PUDUCHERRY,2002,Service (Private),0,48,84,54,17,203,0,7,2,0,1,10,213
PUDUCHERRY,2002,Public Sector Undertaking,0,0,5,2,0,7,0,0,0,0,0,0,7
PUDUCHERRY,2002,Student,5,8,0,0,0,13,3,12,0,0,0,15,28
PUDUCHERRY,2002,Unemployed,0,18,11,2,9,40,0,19,1,0,0,20,60
PUDUCHERRY,2002,Self-employed (Business activity),0,2,8,6,2,18,0,0,0,0,0,0,18
PUDUCHERRY,2002,Professional Activity,0,0,0,0,0,0,0,0,0,0,0,0,0
PUDUCHERRY,2002,Farming/Agriculture Activity,0,14,35,26,8,83,0,1,3,0,1,5,88
PUDUCHERRY,2002,Others (Please Specify),0,5,9,8,2,24,0,0,0,0,0,0,24
PUDUCHERRY,2002,Retired Person,0,0,2,2,0,4,0,0,0,1,2,3,7
PUDUCHERRY,2002,Others (Please Specify),0,0,0,0,0,0,0,0,0,0,0,0,0
PUDUCHERRY,2002,Total,5,98,159,109,39,410,3,74,41,23,16,157,567
PUDUCHERRY,2002,Total Salaried,0,51,94,65,18,228,0,7,3,0,1,11,239
PUDUCHERRY,2002,Total Self-employed,0,21,52,40,12,125,0,1,3,0,1,5,130
PUDUCHERRY,2003,House Wife,0,0,0,0,0,0,0,49,28,14,17,108,108
PUDUCHERRY,2003,Service (Government),0,1,3,4,0,8,0,1,1,0,0,2,10
PUDUCHERRY,2003,Service (Private),0,9,5,2,1,17,0,10,0,0,0,10,27
PUDUCHERRY,2003,Public Sector Undertaking,0,1,5,4,1,11,0,0,0,0,0,0,11
PUDUCHERRY,2003,Student,3,12,0,0,0,15,0,15,0,0,0,15,30
PUDUCHERRY,2003,Unemployed,0,18,10,9,8,45,0,40,1,0,1,42,87
PUDUCHERRY,2003,Self-employed (Business activity),0,4,8,4,4,20,0,1,0,0,0,1,21
PUDUCHERRY,2003,Professional Activity,1,21,33,17,1,73,0,1,0,0,0,1,74
PUDUCHERRY,2003,Farming/Agriculture Activity,0,1,10,7,3,21,0,2,0,0,0,2,23
PUDUCHERRY,2003,Others (Please Specify),0,47,72,38,17,174,0,7,2,4,0,13,187
PUDUCHERRY,2003,Retired Person,0,0,0,0,0,0,0,0,0,0,0,0,0
PUDUCHERRY,2003,Others (Please Specify),0,0,0,3,1,4,0,0,0,0,0,0,4
PUDUCHERRY,2003,Total,4,114,146,88,36,388,0,126,32,18,18,194,582
PUDUCHERRY,2003,Total Salaried,0,11,13,10,2,36,0,11,1,0,0,12,48
PUDUCHERRY,2003,Total Self-employed,1,73,123,66,25,288,0,11,2,4,0,17,305
PUDUCHERRY,2004,House Wife,0,0,0,0,0,0,0,38,45,14,8,105,105
PUDUCHERRY,2004,Service (Government),0,1,7,11,0,19,0,2,0,2,0,4,23
PUDUCHERRY,2004,Service (Private),0,13,10,5,0,28,0,3,0,0,0,3,31
PUDUCHERRY,2004,Public Sector Undertaking,0,0,0,0,0,0,0,0,0,0,0,0,0
PUDUCHERRY,2004,Student,1,7,0,0,0,8,4,17,0,0,0,21,29
PUDUCHERRY,2004,Unemployed,0,21,9,9,19,58,0,26,6,2,5,39,97
PUDUCHERRY,2004,Self-employed (Business activity),0,3,8,8,0,19,0,0,1,0,0,1,20
PUDUCHERRY,2004,Professional Activity,0,7,13,3,2,25,0,0,0,0,0,0,25
PUDUCHERRY,2004,Farming/Agriculture Activity,0,21,44,48,6,119,0,11,11,2,2,26,145
PUDUCHERRY,2004,Others (Please Specify),0,1,5,6,1,13,0,0,1,0,0,1,14
PUDUCHERRY,2004,Retired Person,0,0,0,2,2,4,0,0,0,0,0,0,4
PUDUCHERRY,2004,Others (Please Specify),0,8,25,10,2,45,0,0,1,0,0,1,46
PUDUCHERRY,2004,Total,1,82,121,102,32,338,4,97,65,20,15,201,539
PUDUCHERRY,2004,Total Salaried,0,14,17,16,0,47,0,5,0,2,0,7,54
PUDUCHERRY,2004,Total Self-employed,0,32,70,65,9,176,0,11,13,2,2,28,204
PUDUCHERRY,2005,House Wife,0,0,0,0,0,0,0,48,51,18,9,126,126
PUDUCHERRY,2005,Service (Government),0,1,5,6,0,12,0,0,0,1,0,1,13
PUDUCHERRY,2005,Service (Private),0,16,33,25,1,75,0,10,1,0,0,11,86
PUDUCHERRY,2005,Public Sector Undertaking,0,0,1,0,1,2,0,0,0,0,0,0,2
PUDUCHERRY,2005,Student,1,5,1,0,0,7,2,14,0,0,0,16,23
PUDUCHERRY,2005,Unemployed,0,22,12,21,16,71,0,28,2,0,11,41,112
PUDUCHERRY,2005,Self-employed (Business activity),0,2,5,1,2,10,0,0,0,0,0,0,10
PUDUCHERRY,2005,Professional Activity,0,1,5,2,0,8,0,0,0,0,0,0,8
PUDUCHERRY,2005,Farming/Agriculture Activity,0,28,65,45,6,144,0,1,2,0,0,3,147
PUDUCHERRY,2005,Others (Please Specify),0,0,0,0,0,0,0,0,0,0,0,0,0
PUDUCHERRY,2005,Retired Person,0,0,0,1,3,4,0,0,0,0,0,0,4
PUDUCHERRY,2005,Others (Please Specify),0,0,2,4,1,7,0,0,0,0,0,0,7
PUDUCHERRY,2005,Total,1,75,129,105,30,340,2,101,56,19,20,198,538
PUDUCHERRY,2005,Total Salaried,0,17,39,31,2,89,0,10,1,1,0,12,101
PUDUCHERRY,2005,Total Self-employed,0,31,75,48,8,162,0,1,2,0,0,3,165
PUDUCHERRY,2006,House Wife,0,0,0,0,0,0,0,47,31,10,8,96,96
PUDUCHERRY,2006,Service (Government),0,1,9,7,0,17,0,1,2,0,0,3,20
PUDUCHERRY,2006,Service (Private),0,18,29,15,2,64,0,5,2,0,0,7,71
PUDUCHERRY,2006,Public Sector Undertaking,0,0,1,2,1,4,0,0,0,0,0,0,4
PUDUCHERRY,2006,Student,5,10,0,0,0,15,8,29,0,0,0,37,52
PUDUCHERRY,2006,Unemployed,0,14,8,9,14,45,0,20,1,2,5,28,73
PUDUCHERRY,2006,Self-employed (Business activity),0,4,10,6,1,21,0,0,0,0,0,0,21
PUDUCHERRY,2006,Professional Activity,0,0,0,0,0,0,0,0,0,0,0,0,0
PUDUCHERRY,2006,Farming/Agriculture Activity,0,35,76,50,8,169,0,1,2,3,0,6,175
PUDUCHERRY,2006,Others (Please Specify),0,0,1,0,0,1,0,0,0,0,0,0,1
PUDUCHERRY,2006,Retired Person,0,0,0,0,2,2,0,0,0,0,0,0,2
PUDUCHERRY,2006,Others (Please Specify),0,2,3,4,2,11,0,0,0,0,0,0,11
PUDUCHERRY,2006,Total,5,84,137,93,30,349,8,103,38,15,13,177,526
PUDUCHERRY,2006,Total Salaried,0,19,39,24,3,85,0,6,4,0,0,10,95
PUDUCHERRY,2006,Total Self-employed,0,39,87,56,9,191,0,1,2,3,0,6,197
PUDUCHERRY,2007,House Wife,0,0,0,0,0,0,0,48,20,4,6,78,78
PUDUCHERRY,2007,Service (Government),0,0,4,6,0,10,0,3,1,0,0,4,14
PUDUCHERRY,2007,Service (Private),0,6,10,4,0,20,0,3,4,1,0,8,28
PUDUCHERRY,2007,Public Sector Undertaking,0,0,0,0,0,0,0,0,0,0,0,0,0
PUDUCHERRY,2007,Student,1,8,0,0,0,9,5,14,4,0,1,24,33
PUDUCHERRY,2007,Unemployed,0,22,28,9,9,68,0,39,17,2,5,63,131
PUDUCHERRY,2007,Self-employed (Business activity),0,2,6,10,2,20,0,0,0,0,0,0,20
PUDUCHERRY,2007,Professional Activity,0,0,0,0,0,0,0,0,0,0,0,0,0
PUDUCHERRY,2007,Farming/Agriculture Activity,0,33,82,54,12,181,0,9,6,1,0,16,197
PUDUCHERRY,2007,Others (Please Specify),0,0,0,0,0,0,1,4,0,0,0,5,5
PUDUCHERRY,2007,Retired Person,0,0,0,0,0,0,0,0,0,0,0,0,0
PUDUCHERRY,2007,Others (Please Specify),1,2,3,5,0,11,0,0,0,0,0,0,11
PUDUCHERRY,2007,Total,2,73,133,88,23,319,6,120,52,8,12,198,517
PUDUCHERRY,2007,Total Salaried,0,6,14,10,0,30,0,6,5,1,0,12,42
PUDUCHERRY,2007,Total Self-employed,0,35,88,64,14,201,1,13,6,1,0,21,222
PUDUCHERRY,2008,House Wife,0,0,0,0,0,0,0,45,32,8,12,97,97
PUDUCHERRY,2008,Service (Government),0,3,2,4,0,9,0,2,3,0,1,6,15
PUDUCHERRY,2008,Service (Private),0,2,3,3,1,9,0,2,0,0,0,2,11
PUDUCHERRY,2008,Public Sector Undertaking,0,0,0,0,0,0,0,3,0,0,0,3,3
PUDUCHERRY,2008,Student,2,10,3,0,0,15,0,9,0,0,0,9,24
PUDUCHERRY,2008,Unemployed,0,22,18,9,13,62,0,33,8,0,0,41,103
PUDUCHERRY,2008,Self-employed (Business activity),0,1,3,3,0,7,0,0,0,0,0,0,7
PUDUCHERRY,2008,Professional Activity,0,0,0,0,0,0,0,0,0,0,0,0,0
PUDUCHERRY,2008,Farming/Agriculture Activity,0,2,9,3,0,14,0,2,1,0,0,3,17
PUDUCHERRY,2008,Others (Please Specify),0,47,84,72,12,215,0,9,2,1,0,12,227
PUDUCHERRY,2008,Retired Person,0,1,0,0,0,1,0,0,0,0,0,0,1
PUDUCHERRY,2008,Others (Please Specify),0,2,0,0,0,2,0,0,0,0,0,0,2
PUDUCHERRY,2008,Total,2,90,122,94,26,334,0,105,46,9,13,173,507
PUDUCHERRY,2008,Total Salaried,0,5,5,7,1,18,0,7,3,0,1,11,29
PUDUCHERRY,2008,Total Self-employed,0,50,96,78,12,236,0,11,3,1,0,15,251
PUDUCHERRY,2009,House Wife,0,0,0,0,0,0,0,50,32,23,6,111,111
PUDUCHERRY,2009,Service (Government),0,2,3,6,0,11,0,0,1,0,0,1,12
PUDUCHERRY,2009,Service (Private),0,7,10,1,1,19,0,12,1,0,0,13,32
PUDUCHERRY,2009,Public Sector Undertaking,0,1,0,3,0,4,0,0,0,0,0,0,4
PUDUCHERRY,2009,Student,2,7,0,0,0,9,4,13,0,0,0,17,26
PUDUCHERRY,2009,Unemployed,0,16,14,20,26,76,0,24,4,2,7,37,113
PUDUCHERRY,2009,Self-employed (Business activity),0,2,3,3,1,9,0,0,0,0,0,0,9
PUDUCHERRY,2009,Professional Activity,0,18,18,13,0,49,0,2,2,1,0,5,54
PUDUCHERRY,2009,Farming/Agriculture Activity,0,38,43,56,9,146,0,2,5,1,0,8,154
PUDUCHERRY,2009,Others (Please Specify),0,0,1,1,0,2,0,0,0,0,0,0,2
PUDUCHERRY,2009,Retired Person,0,0,0,0,1,1,0,0,0,0,0,0,1
PUDUCHERRY,2009,Others (Please Specify),0,0,0,0,0,0,0,0,0,0,0,0,0
PUDUCHERRY,2009,Total,2,91,92,103,38,326,4,103,45,27,13,192,518
PUDUCHERRY,2009,Total Salaried,0,10,13,10,1,34,0,12,2,0,0,14,48
PUDUCHERRY,2009,Total Self-employed,0,58,65,73,10,206,0,4,7,2,0,13,219
PUDUCHERRY,2010,House Wife,0,0,0,0,0,0,0,44,30,10,11,95,95
PUDUCHERRY,2010,Service (Government),0,1,4,2,1,8,0,2,1,0,0,3,11
PUDUCHERRY,2010,Service (Private),0,10,9,2,0,21,0,12,5,0,0,17,38
PUDUCHERRY,2010,Public Sector Undertaking,0,0,2,2,0,4,0,0,2,0,0,2,6
PUDUCHERRY,2010,Student,2,4,0,0,0,6,2,10,0,0,0,12,18
PUDUCHERRY,2010,Unemployed,0,17,14,13,16,60,0,29,4,0,7,40,100
PUDUCHERRY,2010,Self-employed (Business activity),0,3,8,3,0,14,0,0,0,0,0,0,14
PUDUCHERRY,2010,Professional Activity,0,34,98,68,5,205,0,2,0,2,1,5,210
PUDUCHERRY,2010,Farming/Agriculture Activity,0,0,1,3,0,4,0,0,0,0,0,0,4
PUDUCHERRY,2010,Others (Please Specify),0,1,5,2,0,8,1,0,0,0,0,1,9
PUDUCHERRY,2010,Retired Person,0,0,0,0,3,3,0,0,0,0,0,0,3
PUDUCHERRY,2010,Others (Please Specify),0,0,0,0,0,0,0,0,0,0,0,0,0
PUDUCHERRY,2010,Total,2,70,141,95,25,333,3,99,42,12,19,175,508
PUDUCHERRY,2010,Total Salaried,0,11,15,6,1,33,0,14,8,0,0,22,55
PUDUCHERRY,2010,Total Self-employed,0,38,112,76,5,231,1,2,0,2,1,6,237
PUDUCHERRY,2011,House Wife,0,0,0,0,0,0,0,45,30,15,7,97,97
PUDUCHERRY,2011,Service (Government),0,1,4,5,0,10,0,1,0,0,0,1,11
PUDUCHERRY,2011,Service (Private),0,15,12,13,2,42,0,6,2,0,0,8,50
PUDUCHERRY,2011,Public Sector Undertaking,0,2,1,2,0,5,0,1,0,1,0,2,7
PUDUCHERRY,2011,Student,2,14,0,0,0,16,7,13,0,0,0,20,36
PUDUCHERRY,2011,Unemployed,0,13,15,19,25,72,0,19,2,1,10,32,104
PUDUCHERRY,2011,Self-employed (Business activity),0,10,17,18,1,46,0,1,0,0,0,1,47
PUDUCHERRY,2011,Professional Activity,0,32,79,54,5,170,0,0,0,0,0,0,170
PUDUCHERRY,2011,Farming/Agriculture Activity,0,0,0,0,0,0,0,0,0,0,0,0,0
PUDUCHERRY,2011,Others (Please Specify),0,6,16,11,2,35,0,0,0,0,0,0,35
PUDUCHERRY,2011,Retired Person,0,0,0,0,0,0,0,0,0,0,0,0,0
PUDUCHERRY,2011,Others (Please Specify),0,0,0,0,0,0,0,0,0,0,0,0,0
PUDUCHERRY,2011,Total,2,93,144,122,35,396,7,86,34,17,17,161,557
PUDUCHERRY,2011,Total Salaried,0,18,17,20,2,57,0,8,2,1,0,11,68
PUDUCHERRY,2011,Total Self-employed,0,48,112,83,8,251,0,1,0,0,0,1,252
PUDUCHERRY,2012,House Wife,0,0,0,0,0,0,0,32,42,17,12,103,103
PUDUCHERRY,2012,Service (Government),0,5,5,5,1,16,0,2,1,1,0,4,20
PUDUCHERRY,2012,Service (Private),0,4,5,2,0,11,0,9,0,0,0,9,20
PUDUCHERRY,2012,Public Sector Undertaking,0,0,0,0,0,0,0,2,0,0,0,2,2
PUDUCHERRY,2012,Student,0,23,0,0,0,23,4,17,1,0,0,22,45
PUDUCHERRY,2012,Unemployed,0,14,11,13,26,64,0,10,2,1,6,19,83
PUDUCHERRY,2012,Self-employed (Business activity),0,1,7,5,3,16,0,0,2,0,0,2,18
PUDUCHERRY,2012,Professional Activity,0,23,47,29,6,105,0,0,1,0,0,1,106
PUDUCHERRY,2012,Farming/Agriculture Activity,0,0,0,0,0,0,0,0,0,0,0,0,0
PUDUCHERRY,2012,Others (Please Specify),0,22,52,48,7,129,0,0,5,1,0,6,135
PUDUCHERRY,2012,Retired Person,0,0,0,0,6,6,0,0,0,0,0,0,6
PUDUCHERRY,2012,Others (Please Specify),1,0,0,1,0,2,0,1,0,0,0,1,3
PUDUCHERRY,2012,Total,1,92,127,103,49,372,4,73,54,20,18,169,541
PUDUCHERRY,2012,Total Salaried,0,9,10,7,1,27,0,13,1,1,0,15,42
PUDUCHERRY,2012,Total Self-employed,0,46,106,82,16,250,0,0,8,1,0,9,259
TOTAL (UTs),2001,House Wife,0,0,0,0,0,0,1,281,182,52,18,534,534
TOTAL (UTs),2001,Service (Government),0,15,29,13,0,57,0,1,1,1,0,3,60
TOTAL (UTs),2001,Service (Private),0,115,112,59,5,291,0,18,2,0,0,20,311
TOTAL (UTs),2001,Public Sector Undertaking,0,12,8,6,1,27,0,1,0,1,0,2,29
TOTAL (UTs),2001,Student,12,55,4,0,0,71,20,64,0,0,0,84,155
TOTAL (UTs),2001,Unemployed,1,111,85,39,33,269,6,40,6,0,0,52,321
TOTAL (UTs),2001,Self-employed (Business activity),0,14,18,8,1,41,0,0,0,0,0,0,41
TOTAL (UTs),2001,Professional Activity,0,3,5,4,0,12,0,1,0,0,0,1,13
TOTAL (UTs),2001,Farming/Agriculture Activity,0,22,39,39,21,121,0,7,1,2,0,10,131
TOTAL (UTs),2001,Others (Please Specify),4,92,113,53,10,272,6,46,31,2,3,88,360
TOTAL (UTs),2001,Retired Person,0,0,0,0,4,4,0,0,0,0,0,0,4
TOTAL (UTs),2001,Others (Please Specify),2,17,16,8,8,51,4,5,9,3,0,21,72
TOTAL (UTs),2001,Total,19,456,429,229,83,1216,37,464,232,61,21,815,2031
TOTAL (UTs),2001,Total Salaried,0,142,149,78,6,375,0,20,3,2,0,25,400
TOTAL (UTs),2001,Total Self-employed,4,131,175,104,32,446,6,54,32,4,3,99,545
TOTAL (UTs),2002,House Wife,0,0,0,0,0,0,0,219,148,47,21,435,435
TOTAL (UTs),2002,Service (Government),0,18,26,21,1,66,0,6,2,0,0,8,74
TOTAL (UTs),2002,Service (Private),0,122,169,91,24,406,0,15,9,0,1,25,431
TOTAL (UTs),2002,Public Sector Undertaking,0,1,10,5,0,16,0,0,0,0,0,0,16
TOTAL (UTs),2002,Student,18,53,0,0,0,71,19,61,8,0,0,88,159
TOTAL (UTs),2002,Unemployed,2,152,81,28,14,277,2,44,4,1,0,51,328
TOTAL (UTs),2002,Self-employed (Business activity),0,21,25,13,3,62,0,4,0,0,0,4,66
TOTAL (UTs),2002,Professional Activity,0,3,3,5,0,11,0,0,0,0,0,0,11
TOTAL (UTs),2002,Farming/Agriculture Activity,0,25,55,41,22,143,0,4,3,0,1,8,151
TOTAL (UTs),2002,Others (Please Specify),4,44,49,24,2,123,0,14,15,6,2,37,160
TOTAL (UTs),2002,Retired Person,0,0,3,3,7,13,0,0,0,1,2,3,16
TOTAL (UTs),2002,Others (Please Specify),0,23,27,5,1,56,1,11,3,0,0,15,71
TOTAL (UTs),2002,Total,24,462,448,236,74,1244,22,378,192,55,27,674,1918
TOTAL (UTs),2002,Total Salaried,0,141,205,117,25,488,0,21,11,0,1,33,521
TOTAL (UTs),2002,Total Self-employed,4,93,132,83,27,339,0,22,18,6,3,49,388
TOTAL (UTs),2003,House Wife,0,0,0,0,0,0,0,200,129,54,23,406,406
TOTAL (UTs),2003,Service (Government),0,10,25,14,1,50,0,10,3,3,0,16,66
TOTAL (UTs),2003,Service (Private),0,82,82,29,6,199,0,24,7,0,0,31,230
TOTAL (UTs),2003,Public Sector Undertaking,0,4,13,6,1,24,0,1,0,0,0,1,25
TOTAL (UTs),2003,Student,14,60,0,0,0,74,17,77,3,0,0,97,171
TOTAL (UTs),2003,Unemployed,1,150,115,28,25,319,2,67,12,10,1,92,411
TOTAL (UTs),2003,Self-employed (Business activity),0,10,23,8,5,46,0,1,0,0,0,1,47
TOTAL (UTs),2003,Professional Activity,1,26,37,18,1,83,0,1,0,0,0,1,84
TOTAL (UTs),2003,Farming/Agriculture Activity,0,15,15,17,8,55,0,2,0,0,0,2,57
TOTAL (UTs),2003,Others (Please Specify),2,88,129,67,21,307,1,26,9,4,0,40,347
TOTAL (UTs),2003,Retired Person,0,0,0,2,2,4,0,0,0,0,0,0,4
TOTAL (UTs),2003,Others (Please Specify),8,65,51,23,8,155,4,12,6,2,2,26,181
TOTAL (UTs),2003,Total,26,510,490,212,78,1316,24,421,169,73,26,713,2029
TOTAL (UTs),2003,Total Salaried,0,96,120,49,8,273,0,35,10,3,0,48,321
TOTAL (UTs),2003,Total Self-employed,3,139,204,110,35,491,1,30,9,4,0,44,535
TOTAL (UTs),2004,House Wife,0,0,0,0,0,0,0,230,141,34,24,429,429
TOTAL (UTs),2004,Service (Government),0,6,26,22,0,54,0,2,2,3,0,7,61
TOTAL (UTs),2004,Service (Private),0,123,112,37,7,279,0,11,2,0,0,13,292
TOTAL (UTs),2004,Public Sector Undertaking,0,5,3,2,1,11,0,3,1,0,0,4,15
TOTAL (UTs),2004,Student,16,62,0,0,0,78,17,75,0,0,0,92,170
TOTAL (UTs),2004,Unemployed,2,143,114,43,25,327,1,70,24,5,7,107,434
TOTAL (UTs),2004,Self-employed (Business activity),0,20,24,14,1,59,0,0,1,0,0,1,60
TOTAL (UTs),2004,Professional Activity,0,11,15,5,2,33,0,0,0,0,0,0,33
TOTAL (UTs),2004,Farming/Agriculture Activity,0,25,50,56,12,143,0,11,11,3,2,27,170
TOTAL (UTs),2004,Others (Please Specify),1,60,73,37,7,178,3,23,17,2,0,45,223
TOTAL (UTs),2004,Retired Person,0,0,0,2,6,8,0,0,0,0,0,0,8
TOTAL (UTs),2004,Others (Please Specify),1,34,56,30,4,125,1,17,3,3,0,24,149
TOTAL (UTs),2004,Total,20,489,473,248,65,1295,22,442,202,50,33,749,2044
TOTAL (UTs),2004,Total Salaried,0,134,141,61,8,344,0,16,5,3,0,24,368
TOTAL (UTs),2004,Total Self-employed,1,116,162,112,22,413,3,34,29,5,2,73,486
TOTAL (UTs),2005,House Wife,0,0,0,0,0,0,0,236,174,61,21,492,492
TOTAL (UTs),2005,Service (Government),0,10,28,25,0,63,0,5,1,3,0,9,72
TOTAL (UTs),2005,Service (Private),0,115,111,75,15,316,1,29,4,0,0,34,350
TOTAL (UTs),2005,Public Sector Undertaking,0,1,8,2,1,12,0,1,0,0,0,1,13
TOTAL (UTs),2005,Student,9,60,6,0,0,75,10,54,1,0,0,65,140
TOTAL (UTs),2005,Unemployed,1,145,86,50,22,304,2,63,7,0,12,84,388
TOTAL (UTs),2005,Self-employed (Business activity),3,18,16,2,4,43,0,0,0,0,0,0,43
TOTAL (UTs),2005,Professional Activity,0,1,6,5,1,13,0,1,0,0,0,1,14
TOTAL (UTs),2005,Farming/Agriculture Activity,0,32,78,51,10,171,0,1,3,0,0,4,175
TOTAL (UTs),2005,Others (Please Specify),0,62,51,25,7,145,0,14,13,1,0,28,173
TOTAL (UTs),2005,Retired Person,0,0,0,1,6,7,0,0,0,0,0,0,7
TOTAL (UTs),2005,Others (Please Specify),4,75,62,31,11,183,6,37,17,1,1,62,245
TOTAL (UTs),2005,Total,17,519,452,267,77,1332,19,441,220,66,34,780,2112
TOTAL (UTs),2005,Total Salaried,0,126,147,102,16,391,1,35,5,3,0,44,435
TOTAL (UTs),2005,Total Self-employed,3,113,151,83,22,372,0,16,16,1,0,33,405
TOTAL (UTs),2006,House Wife,0,0,0,0,0,0,0,273,164,40,15,492,492
TOTAL (UTs),2006,Service (Government),0,10,32,21,0,63,0,2,5,0,0,7,70
TOTAL (UTs),2006,Service (Private),0,157,161,70,10,398,0,23,4,0,0,27,425
TOTAL (UTs),2006,Public Sector Undertaking,0,10,12,3,1,26,1,2,0,0,0,3,29
TOTAL (UTs),2006,Student,9,76,0,0,0,85,21,92,1,0,0,114,199
TOTAL (UTs),2006,Unemployed,1,176,115,43,17,352,2,55,6,2,7,72,424
TOTAL (UTs),2006,Self-employed (Business activity),0,13,25,9,3,50,0,6,1,0,0,7,57
TOTAL (UTs),2006,Professional Activity,0,1,1,2,0,4,0,0,0,0,0,0,4
TOTAL (UTs),2006,Farming/Agriculture Activity,0,39,83,54,15,191,0,1,2,3,0,6,197
TOTAL (UTs),2006,Others (Please Specify),4,69,85,44,12,214,2,21,23,2,0,48,262
TOTAL (UTs),2006,Retired Person,0,9,5,2,3,19,0,0,0,0,0,0,19
TOTAL (UTs),2006,Others (Please Specify),4,35,29,16,13,97,5,11,3,2,1,22,119
TOTAL (UTs),2006,Total,18,595,548,264,74,1499,31,486,209,49,23,798,2297
TOTAL (UTs),2006,Total Salaried,0,177,205,94,11,487,1,27,9,0,0,37,524
TOTAL (UTs),2006,Total Self-employed,4,122,194,109,30,459,2,28,26,5,0,61,520
TOTAL (UTs),2007,House Wife,0,0,0,0,0,0,0,244,134,31,18,427,427
TOTAL (UTs),2007,Service (Government),0,7,27,16,0,50,0,8,2,0,0,10,60
TOTAL (UTs),2007,Service (Private),1,133,127,41,5,307,0,27,10,2,0,39,346
TOTAL (UTs),2007,Public Sector Undertaking,0,4,5,3,0,12,0,2,0,0,0,2,14
TOTAL (UTs),2007,Student,12,89,5,0,0,106,16,80,4,0,1,101,207
TOTAL (UTs),2007,Unemployed,1,147,104,32,15,299,0,83,23,2,5,113,412
TOTAL (UTs),2007,Self-employed (Business activity),0,11,11,17,3,42,0,0,0,0,0,0,42
TOTAL (UTs),2007,Professional Activity,0,3,0,1,0,4,0,1,0,0,0,1,5
TOTAL (UTs),2007,Farming/Agriculture Activity,0,46,101,70,20,237,0,9,6,1,0,16,253
TOTAL (UTs),2007,Others (Please Specify),0,52,76,26,7,161,1,29,7,0,0,37,198
TOTAL (UTs),2007,Retired Person,0,0,0,1,14,15,0,0,0,0,0,0,15
TOTAL (UTs),2007,Others (Please Specify),3,92,115,40,13,263,10,50,22,5,1,88,351
TOTAL (UTs),2007,Total,17,584,571,247,77,1496,27,533,208,41,25,834,2330
TOTAL (UTs),2007,Total Salaried,1,144,159,60,5,369,0,37,12,2,0,51,420
TOTAL (UTs),2007,Total Self-employed,0,112,188,114,30,444,1,39,13,1,0,54,498
TOTAL (UTs),2008,House Wife,0,0,0,0,0,0,0,239,147,40,19,445,445
TOTAL (UTs),2008,Service (Government),0,7,13,14,0,34,0,2,4,1,1,8,42
TOTAL (UTs),2008,Service (Private),0,112,114,42,6,274,0,28,7,2,0,37,311
TOTAL (UTs),2008,Public Sector Undertaking,0,16,12,3,4,35,0,6,0,0,0,6,41
TOTAL (UTs),2008,Student,15,83,4,0,0,102,13,101,6,0,0,120,222
TOTAL (UTs),2008,Unemployed,1,133,110,39,20,303,1,70,12,0,0,83,386
TOTAL (UTs),2008,Self-employed (Business activity),0,10,18,11,0,39,0,0,0,0,0,0,39
TOTAL (UTs),2008,Professional Activity,0,0,3,4,1,8,0,0,0,0,0,0,8
TOTAL (UTs),2008,Farming/Agriculture Activity,0,13,28,15,8,64,1,2,1,0,0,4,68
TOTAL (UTs),2008,Others (Please Specify),2,105,138,100,21,366,1,27,6,3,0,37,403
TOTAL (UTs),2008,Retired Person,0,1,0,3,5,9,0,0,0,0,0,0,9
TOTAL (UTs),2008,Others (Please Specify),1,49,34,11,2,97,2,32,4,2,4,44,141
TOTAL (UTs),2008,Total,19,529,474,242,67,1331,18,507,187,48,24,784,2115
TOTAL (UTs),2008,Total Salaried,0,135,139,59,10,343,0,36,11,3,1,51,394
TOTAL (UTs),2008,Total Self-employed,2,128,187,130,30,477,2,29,7,3,0,41,518
TOTAL (UTs),2009,House Wife,0,0,0,0,0,0,0,278,154,51,21,504,504
TOTAL (UTs),2009,Service (Government),0,6,20,23,1,50,0,1,3,0,0,4,54
TOTAL (UTs),2009,Service (Private),0,127,125,35,5,292,0,28,10,2,0,40,332
TOTAL (UTs),2009,Public Sector Undertaking,0,15,17,8,0,40,0,3,0,0,0,3,43
TOTAL (UTs),2009,Student,13,105,2,1,0,121,20,89,1,0,0,110,231
TOTAL (UTs),2009,Unemployed,1,148,97,47,29,322,5,54,11,2,7,79,401
TOTAL (UTs),2009,Self-employed (Business activity),0,15,18,10,3,46,0,0,0,0,0,0,46
TOTAL (UTs),2009,Professional Activity,0,21,24,17,0,62,0,3,2,1,0,6,68
TOTAL (UTs),2009,Farming/Agriculture Activity,0,46,58,68,13,185,0,2,5,1,0,8,193
TOTAL (UTs),2009,Others (Please Specify),0,44,46,24,4,118,0,14,9,4,1,28,146
TOTAL (UTs),2009,Retired Person,0,0,0,0,10,10,0,0,0,0,0,0,10
TOTAL (UTs),2009,Others (Please Specify),4,86,63,22,13,188,7,43,8,6,1,65,253
TOTAL (UTs),2009,Total,18,613,470,255,78,1434,32,515,203,67,30,847,2281
TOTAL (UTs),2009,Total Salaried,0,148,162,66,6,382,0,32,13,2,0,47,429
TOTAL (UTs),2009,Total Self-employed,0,126,146,119,20,411,0,19,16,6,1,42,453
TOTAL (UTs),2010,House Wife,0,0,0,0,0,0,0,283,175,49,22,529,529
TOTAL (UTs),2010,Service (Government),0,8,22,15,1,46,0,7,1,0,0,8,54
TOTAL (UTs),2010,Service (Private),0,130,120,38,14,302,0,33,8,1,0,42,344
TOTAL (UTs),2010,Public Sector Undertaking,0,13,25,7,0,45,0,5,2,0,0,7,52
TOTAL (UTs),2010,Student,20,89,1,0,0,110,21,85,3,2,0,111,221
TOTAL (UTs),2010,Unemployed,0,136,103,43,32,314,3,68,12,0,7,90,404
TOTAL (UTs),2010,Self-employed (Business activity),0,17,23,12,1,53,0,0,0,0,0,0,53
TOTAL (UTs),2010,Professional Activity,0,35,100,68,5,208,0,2,1,2,1,6,214
TOTAL (UTs),2010,Farming/Agriculture Activity,0,5,13,8,5,31,0,0,0,0,0,0,31
TOTAL (UTs),2010,Others (Please Specify),0,65,79,37,11,192,2,34,6,1,1,44,236
TOTAL (UTs),2010,Retired Person,0,0,0,0,16,16,0,0,0,0,0,0,16
TOTAL (UTs),2010,Others (Please Specify),5,76,57,27,11,176,3,26,12,1,1,43,219
TOTAL (UTs),2010,Total,25,574,543,255,96,1493,29,543,220,56,32,880,2373
TOTAL (UTs),2010,Total Salaried,0,151,167,60,15,393,0,45,11,1,0,57,450
TOTAL (UTs),2010,Total Self-employed,0,122,215,125,22,484,2,36,7,3,2,50,534
TOTAL (UTs),2011,House Wife,0,0,0,0,0,0,0,229,154,42,19,444,444
TOTAL (UTs),2011,Service (Government),0,20,21,16,1,58,0,7,2,2,0,11,69
TOTAL (UTs),2011,Service (Private),0,142,144,61,5,352,0,41,11,4,1,57,409
TOTAL (UTs),2011,Public Sector Undertaking,0,22,7,5,0,34,0,2,0,1,0,3,37
TOTAL (UTs),2011,Student,16,132,0,0,0,148,22,113,0,1,0,136,284
TOTAL (UTs),2011,Unemployed,1,234,151,47,29,462,1,61,12,5,11,90,552
TOTAL (UTs),2011,Self-employed (Business activity),0,19,33,31,1,84,0,3,0,1,0,4,88
TOTAL (UTs),2011,Professional Activity,0,37,86,55,5,183,0,0,0,0,0,0,183
TOTAL (UTs),2011,Farming/Agriculture Activity,0,6,9,7,1,23,0,0,0,0,0,0,23
TOTAL (UTs),2011,Others (Please Specify),1,87,74,34,10,206,1,14,8,11,1,35,241
TOTAL (UTs),2011,Retired Person,0,0,0,0,16,16,0,0,1,0,0,1,17
TOTAL (UTs),2011,Others (Please Specify),4,98,54,39,13,208,6,35,12,1,1,55,263
TOTAL (UTs),2011,Total,22,797,579,295,81,1774,30,505,200,68,33,836,2610
TOTAL (UTs),2011,Total Salaried,0,184,172,82,6,444,0,50,13,7,1,71,515
TOTAL (UTs),2011,Total Self-employed,1,149,202,127,17,496,1,17,8,12,1,39,535
TOTAL (UTs),2012,House Wife,0,0,0,0,0,0,0,255,182,57,31,525,525
TOTAL (UTs),2012,Service (Government),0,11,25,28,2,66,0,3,2,3,0,8,74
TOTAL (UTs),2012,Service (Private),0,160,164,53,9,386,0,27,2,0,0,29,415
TOTAL (UTs),2012,Public Sector Undertaking,0,16,22,4,0,42,0,6,0,0,0,6,48
TOTAL (UTs),2012,Student,23,147,0,0,0,170,29,139,7,0,0,175,345
TOTAL (UTs),2012,Unemployed,3,205,124,40,31,403,4,57,4,1,6,72,475
TOTAL (UTs),2012,Self-employed (Business activity),0,15,38,8,5,66,0,0,2,0,0,2,68
TOTAL (UTs),2012,Professional Activity,0,26,50,30,6,112,0,0,4,0,0,4,116
TOTAL (UTs),2012,Farming/Agriculture Activity,0,12,6,8,1,27,0,0,0,0,0,0,27
TOTAL (UTs),2012,Others (Please Specify),1,102,120,74,19,316,1,20,13,2,1,37,353
TOTAL (UTs),2012,Retired Person,0,0,1,2,21,24,0,0,0,0,0,0,24
TOTAL (UTs),2012,Others (Please Specify),4,97,90,32,5,228,4,48,24,3,1,80,308
TOTAL (UTs),2012,Total,31,791,640,279,99,1840,38,555,240,66,39,938,2778
TOTAL (UTs),2012,Total Salaried,0,187,211,85,11,494,0,36,4,3,0,43,537
TOTAL (UTs),2012,Total Self-employed,1,155,214,120,31,521,1,20,19,2,1,43,564
TOTAL (ALL INDIA),2001,House Wife,0,0,0,0,0,0,70,10160,7259,2986,1184,21659,21659
TOTAL (ALL INDIA),2001,Service (Government),0,386,780,587,21,1774,0,202,232,71,14,519,2293
TOTAL (ALL INDIA),2001,Service (Private),24,2222,2993,1714,365,7318,60,710,485,298,110,1663,8981
TOTAL (ALL INDIA),2001,Public Sector Undertaking,0,640,644,471,127,1882,0,255,222,96,14,587,2469
TOTAL (ALL INDIA),2001,Student,683,2234,164,27,0,3108,546,1730,66,22,2,2366,5474
TOTAL (ALL INDIA),2001,Unemployed,53,2917,2997,1853,595,8415,57,895,601,194,90,1837,10252
TOTAL (ALL INDIA),2001,Self-employed (Business activity),39,1174,1899,1261,279,4652,25,204,182,148,64,623,5275
TOTAL (ALL INDIA),2001,Professional Activity,21,606,960,542,166,2295,11,108,99,76,23,317,2612
TOTAL (ALL INDIA),2001,Farming/Agriculture Activity,88,3830,5119,3414,1378,13829,80,1028,889,451,138,2586,16415
TOTAL (ALL INDIA),2001,Others (Please Specify),279,3606,4628,3170,1520,13203,249,1933,1467,900,456,5005,18208
TOTAL (ALL INDIA),2001,Retired Person,0,27,32,140,501,700,0,6,20,46,112,184,884
TOTAL (ALL INDIA),2001,Others (Please Specify),311,2339,3287,2229,972,9138,411,1698,1423,883,431,4846,13984
TOTAL (ALL INDIA),2001,Total,1498,19981,23503,15408,5924,66314,1509,18929,12945,6171,2638,42192,108506
TOTAL (ALL INDIA),2001,Total Salaried,24,3248,4417,2772,513,10974,60,1167,939,465,138,2769,13743
TOTAL (ALL INDIA),2001,Total Self-employed,427,9216,12606,8387,3343,33979,365,3273,2637,1575,681,8531,42510
TOTAL (ALL INDIA),2002,House Wife,0,0,0,0,0,0,30,10484,7654,3284,1278,22730,22730
TOTAL (ALL INDIA),2002,Service (Government),0,417,771,499,21,1708,0,167,202,125,8,502,2210
TOTAL (ALL INDIA),2002,Service (Private),11,2278,2932,1660,256,7137,14,654,486,224,76,1454,8591
TOTAL (ALL INDIA),2002,Public Sector Undertaking,0,589,684,466,71,1810,0,218,199,99,7,523,2333
TOTAL (ALL INDIA),2002,Student,586,2258,199,19,0,3062,679,1527,86,1,0,2293,5355
TOTAL (ALL INDIA),2002,Unemployed,37,3127,2988,1599,619,8370,41,961,560,182,66,1810,10180
TOTAL (ALL INDIA),2002,Self-employed (Business activity),14,1339,2209,1578,429,5569,11,194,170,132,48,555,6124
TOTAL (ALL INDIA),2002,Professional Activity,1,614,899,550,172,2236,0,67,83,78,13,241,2477
TOTAL (ALL INDIA),2002,Farming/Agriculture Activity,30,4134,5651,3958,1535,15308,28,1107,864,503,161,2663,17971
TOTAL (ALL INDIA),2002,Others (Please Specify),276,3706,4997,3174,1603,13756,416,1612,1217,730,399,4374,18130
TOTAL (ALL INDIA),2002,Retired Person,0,5,19,176,524,724,0,0,14,28,97,139,863
TOTAL (ALL INDIA),2002,Others (Please Specify),351,2450,3462,2276,1113,9652,355,1380,1166,516,384,3801,13453
TOTAL (ALL INDIA),2002,Total,1306,20917,24811,15955,6343,69332,1574,18371,12701,5902,2537,41085,110417
TOTAL (ALL INDIA),2002,Total Salaried,11,3284,4387,2625,348,10655,14,1039,887,448,91,2479,13134
TOTAL (ALL INDIA),2002,Total Self-employed,321,9793,13756,9260,3739,36869,455,2980,2334,1443,621,7833,44702
TOTAL (ALL INDIA),2003,House Wife,0,0,0,0,0,0,22,10049,7840,3821,1569,23301,23301
TOTAL (ALL INDIA),2003,Service (Government),1,491,793,581,23,1889,1,191,178,74,0,444,2333
TOTAL (ALL INDIA),2003,Service (Private),22,1996,2805,1591,234,6648,2,664,528,235,32,1461,8109
TOTAL (ALL INDIA),2003,Public Sector Undertaking,1,710,885,758,48,2402,3,243,157,80,5,488,2890
TOTAL (ALL INDIA),2003,Student,575,2485,288,37,2,3387,599,1916,174,15,0,2704,6091
TOTAL (ALL INDIA),2003,Unemployed,51,3292,3039,1250,533,8165,38,888,492,245,85,1748,9913
TOTAL (ALL INDIA),2003,Self-employed (Business activity),13,1214,1996,1565,402,5190,16,189,162,95,26,488,5678
TOTAL (ALL INDIA),2003,Professional Activity,6,831,1109,683,164,2793,1,94,101,60,16,272,3065
TOTAL (ALL INDIA),2003,Farming/Agriculture Activity,49,3794,5413,3799,1646,14701,71,1026,823,423,120,2463,17164
TOTAL (ALL INDIA),2003,Others (Please Specify),223,4035,5078,3643,1675,14654,203,1614,1010,662,385,3874,18528
TOTAL (ALL INDIA),2003,Retired Person,0,10,32,164,694,900,0,9,10,54,89,162,1062
TOTAL (ALL INDIA),2003,Others (Please Specify),337,2839,3241,2040,1035,9492,342,1248,863,457,315,3225,12717
TOTAL (ALL INDIA),2003,Total,1278,21697,24679,16111,6456,70221,1298,18131,12338,6221,2642,40630,110851
TOTAL (ALL INDIA),2003,Total Salaried,24,3197,4483,2930,305,10939,6,1098,863,389,37,2393,13332
TOTAL (ALL INDIA),2003,Total Self-employed,291,9874,13596,9690,3887,37338,291,2923,2096,1240,547,7097,44435
TOTAL (ALL INDIA),2004,House Wife,0,0,0,0,0,0,48,10625,7779,3390,1328,23170,23170
TOTAL (ALL INDIA),2004,Service (Government),0,371,779,455,17,1622,0,98,96,58,0,252,1874
TOTAL (ALL INDIA),2004,Service (Private),11,1954,2773,1609,216,6563,6,535,394,175,27,1137,7700
TOTAL (ALL INDIA),2004,Public Sector Undertaking,0,532,731,501,41,1805,0,138,155,82,8,383,2188
TOTAL (ALL INDIA),2004,Student,649,2289,170,0,0,3108,626,1830,44,1,1,2502,5610
TOTAL (ALL INDIA),2004,Unemployed,42,3081,2819,1424,453,7819,30,868,500,218,103,1719,9538
TOTAL (ALL INDIA),2004,Self-employed (Business activity),18,1405,2124,1486,396,5429,3,134,133,71,7,348,5777
TOTAL (ALL INDIA),2004,Professional Activity,5,706,936,660,144,2451,1,83,83,44,27,238,2689
TOTAL (ALL INDIA),2004,Farming/Agriculture Activity,26,4075,5997,4147,1684,15929,50,915,773,409,165,2312,18241
TOTAL (ALL INDIA),2004,Others (Please Specify),161,4038,5362,3991,1654,15206,206,1676,1159,750,408,4199,19405
TOTAL (ALL INDIA),2004,Retired Person,0,0,28,120,675,823,0,0,0,42,74,116,939
TOTAL (ALL INDIA),2004,Others (Please Specify),555,3166,4131,2672,1372,11896,476,1617,1330,834,413,4670,16566
TOTAL (ALL INDIA),2004,Total,1467,21617,25850,17065,6652,72651,1446,18519,12446,6074,2561,41046,113697
TOTAL (ALL INDIA),2004,Total Salaried,11,2857,4283,2565,274,9990,6,771,645,315,35,1772,11762
TOTAL (ALL INDIA),2004,Total Self-employed,210,10224,14419,10284,3878,39015,260,2808,2148,1274,607,7097,46112
TOTAL (ALL INDIA),2005,House Wife,0,0,0,0,0,0,30,10704,7960,3968,1479,24141,24141
TOTAL (ALL INDIA),2005,Service (Government),0,300,620,514,5,1439,0,85,119,49,1,254,1693
TOTAL (ALL INDIA),2005,Service (Private),20,2514,2987,1766,201,7488,34,637,417,174,64,1326,8814
TOTAL (ALL INDIA),2005,Public Sector Undertaking,0,466,750,519,33,1768,0,150,147,70,8,375,2143
TOTAL (ALL INDIA),2005,Student,584,2145,157,3,0,2889,585,1585,78,1,0,2249,5138
TOTAL (ALL INDIA),2005,Unemployed,41,3101,2534,1086,364,7126,15,937,458,158,104,1672,8798
TOTAL (ALL INDIA),2005,Self-employed (Business activity),24,1470,2289,1556,371,5710,3,192,183,108,48,534,6244
TOTAL (ALL INDIA),2005,Professional Activity,17,627,985,710,152,2491,5,108,49,50,20,232,2723
TOTAL (ALL INDIA),2005,Farming/Agriculture Activity,54,3636,5678,3910,1695,14973,41,759,754,417,187,2158,17131
TOTAL (ALL INDIA),2005,Others (Please Specify),179,3961,5274,3711,1886,15011,145,1570,956,739,338,3748,18759
TOTAL (ALL INDIA),2005,Retired Person,0,16,10,164,630,820,0,4,4,15,71,94,914
TOTAL (ALL INDIA),2005,Others (Please Specify),409,3587,4648,3297,1260,13201,369,1680,1126,640,400,4215,17416
TOTAL (ALL INDIA),2005,Total,1328,21823,25932,17236,6597,72916,1227,18411,12251,6389,2720,40998,113914
TOTAL (ALL INDIA),2005,Total Salaried,20,3280,4357,2799,239,10695,34,872,683,293,73,1955,12650
TOTAL (ALL INDIA),2005,Total Self-employed,274,9694,14226,9887,4104,38185,194,2629,1942,1314,593,6672,44857
TOTAL (ALL INDIA),2006,House Wife,0,0,0,0,0,0,40,11317,8379,4031,1296,25063,25063
TOTAL (ALL INDIA),2006,Service (Government),5,434,815,568,12,1834,0,122,129,54,8,313,2147
TOTAL (ALL INDIA),2006,Service (Private),6,2170,3101,1955,231,7463,0,902,457,200,19,1578,9041
TOTAL (ALL INDIA),2006,Public Sector Undertaking,2,610,935,421,57,2025,3,153,110,106,4,376,2401
TOTAL (ALL INDIA),2006,Student,562,2421,107,25,8,3123,636,2009,84,5,0,2734,5857
TOTAL (ALL INDIA),2006,Unemployed,11,3260,2666,1075,403,7415,7,843,370,168,83,1471,8886
TOTAL (ALL INDIA),2006,Self-employed (Business activity),5,1599,3056,1525,319,6504,2,145,209,65,9,430,6934
TOTAL (ALL INDIA),2006,Professional Activity,16,852,1359,973,208,3408,5,112,77,35,6,235,3643
TOTAL (ALL INDIA),2006,Farming/Agriculture Activity,56,3535,5761,3704,1608,14664,58,922,847,429,140,2396,17060
TOTAL (ALL INDIA),2006,Others (Please Specify),181,4643,5878,4430,1814,16946,182,1477,1071,584,542,3856,20802
TOTAL (ALL INDIA),2006,Retired Person,1,36,39,137,752,965,0,1,6,12,135,154,1119
TOTAL (ALL INDIA),2006,Others (Please Specify),349,3197,4092,2532,1185,11355,337,1456,1151,572,288,3804,15159
TOTAL (ALL INDIA),2006,Total,1194,22757,27809,17345,6597,75702,1270,19459,12890,6261,2530,42410,118112
TOTAL (ALL INDIA),2006,Total Salaried,13,3214,4851,2944,300,11322,3,1177,696,360,31,2267,13589
TOTAL (ALL INDIA),2006,Total Self-employed,258,10629,16054,10632,3949,41522,247,2656,2204,1113,697,6917,48439
TOTAL (ALL INDIA),2007,House Wife,0,0,0,0,0,0,49,10925,8184,3644,1360,24162,24162
TOTAL (ALL INDIA),2007,Service (Government),0,365,658,525,10,1558,1,123,107,53,15,299,1857
TOTAL (ALL INDIA),2007,Service (Private),31,2397,3440,2043,334,8245,6,977,513,260,67,1823,10068
TOTAL (ALL INDIA),2007,Public Sector Undertaking,0,546,995,587,83,2211,6,196,111,122,1,436,2647
TOTAL (ALL INDIA),2007,Student,603,2644,159,8,2,3416,637,2090,91,6,8,2832,6248
TOTAL (ALL INDIA),2007,Unemployed,29,2786,2423,1181,270,6689,32,943,597,192,58,1822,8511
TOTAL (ALL INDIA),2007,Self-employed (Business activity),1,1592,3220,1768,275,6856,1,156,204,57,6,424,7280
TOTAL (ALL INDIA),2007,Professional Activity,4,780,1228,783,191,2986,9,114,83,31,12,249,3235
TOTAL (ALL INDIA),2007,Farming/Agriculture Activity,46,3266,5467,4066,1664,14509,49,797,707,414,156,2123,16632
TOTAL (ALL INDIA),2007,Others (Please Specify),150,5365,6660,4965,2119,19259,192,1915,1540,934,404,4985,24244
TOTAL (ALL INDIA),2007,Retired Person,0,37,69,149,664,919,2,8,7,23,89,129,1048
TOTAL (ALL INDIA),2007,Others (Please Specify),320,3668,4232,3038,1389,12647,311,1470,1137,722,418,4058,16705
TOTAL (ALL INDIA),2007,Total,1184,23446,28551,19113,7001,79295,1295,19714,13281,6458,2594,43342,122637
TOTAL (ALL INDIA),2007,Total Salaried,31,3308,5093,3155,427,12014,13,1296,731,435,83,2558,14572
TOTAL (ALL INDIA),2007,Total Self-employed,201,11003,16575,11582,4249,43610,251,2982,2534,1436,578,7781,51391
TOTAL (ALL INDIA),2008,House Wife,0,0,0,0,0,0,51,10799,8581,3554,1382,24367,24367
TOTAL (ALL INDIA),2008,Service (Government),0,325,778,612,14,1729,0,131,136,61,13,341,2070
TOTAL (ALL INDIA),2008,Service (Private),7,2564,3682,2123,306,8682,8,1002,541,219,49,1819,10501
TOTAL (ALL INDIA),2008,Public Sector Undertaking,4,636,1036,777,138,2591,3,219,137,122,35,516,3107
TOTAL (ALL INDIA),2008,Student,514,2627,188,35,4,3368,573,2053,62,4,0,2692,6060
TOTAL (ALL INDIA),2008,Unemployed,43,2955,2521,1325,327,7171,28,922,609,244,27,1830,9001
TOTAL (ALL INDIA),2008,Self-employed (Business activity),2,1489,3210,1544,350,6595,4,151,197,56,13,421,7016
TOTAL (ALL INDIA),2008,Professional Activity,5,743,1298,786,198,3030,5,174,127,49,20,375,3405
TOTAL (ALL INDIA),2008,Farming/Agriculture Activity,32,3464,5416,3728,1505,14145,39,752,756,368,136,2051,16196
TOTAL (ALL INDIA),2008,Others (Please Specify),216,5568,6301,4475,1890,18450,158,2071,1247,769,386,4631,23081
TOTAL (ALL INDIA),2008,Retired Person,0,13,35,148,558,754,0,3,6,20,103,132,886
TOTAL (ALL INDIA),2008,Others (Please Specify),342,4012,5054,3266,1355,14029,347,1979,1644,907,421,5298,19327
TOTAL (ALL INDIA),2008,Total,1165,24396,29519,18819,6645,80544,1216,20256,14043,6373,2585,44473,125017
TOTAL (ALL INDIA),2008,Total Salaried,11,3525,5496,3512,458,13002,11,1352,814,402,97,2676,15678
TOTAL (ALL INDIA),2008,Total Self-employed,255,11264,16225,10533,3943,42220,206,3148,2327,1242,555,7478,49698
TOTAL (ALL INDIA),2009,House Wife,0,0,0,0,0,0,62,11029,8613,3843,1545,25092,25092
TOTAL (ALL INDIA),2009,Service (Government),0,279,628,484,25,1416,0,126,111,59,2,298,1714
TOTAL (ALL INDIA),2009,Service (Private),3,2770,3925,2067,388,9153,2,750,510,241,64,1567,10720
TOTAL (ALL INDIA),2009,Public Sector Undertaking,0,722,957,660,136,2475,1,176,145,100,17,439,2914
TOTAL (ALL INDIA),2009,Student,649,2934,173,12,0,3768,629,2272,89,3,0,2993,6761
TOTAL (ALL INDIA),2009,Unemployed,37,2931,3435,1540,445,8388,30,693,433,277,95,1528,9916
TOTAL (ALL INDIA),2009,Self-employed (Business activity),24,1774,2750,2082,566,7196,2,199,229,103,19,552,7748
TOTAL (ALL INDIA),2009,Professional Activity,20,871,1238,954,199,3282,0,156,125,55,16,352,3634
TOTAL (ALL INDIA),2009,Farming/Agriculture Activity,46,3464,5820,4045,1576,14951,27,931,808,482,169,2417,17368
TOTAL (ALL INDIA),2009,Others (Please Specify),217,4585,6106,4256,1744,16908,297,1836,1606,872,350,4961,21869
TOTAL (ALL INDIA),2009,Retired Person,1,17,29,189,600,836,0,10,46,31,108,195,1031
TOTAL (ALL INDIA),2009,Others (Please Specify),504,3399,4274,3307,1614,13098,400,1996,1438,941,511,5286,18384
TOTAL (ALL INDIA),2009,Total,1501,23746,29335,19596,7293,81471,1450,20174,14153,7007,2896,45680,127151
TOTAL (ALL INDIA),2009,Total Salaried,3,3771,5510,3211,549,13044,3,1052,766,400,83,2304,15348
TOTAL (ALL INDIA),2009,Total Self-employed,307,10694,15914,11337,4085,42337,326,3122,2768,1512,554,8282,50619
TOTAL (ALL INDIA),2010,House Wife,0,0,0,0,0,0,58,11008,8564,3798,1630,25058,25058
TOTAL (ALL INDIA),2010,Service (Government),0,305,649,456,27,1437,0,205,145,52,3,405,1842
TOTAL (ALL INDIA),2010,Service (Private),14,2904,3605,2188,288,8999,9,770,492,193,39,1503,10502
TOTAL (ALL INDIA),2010,Public Sector Undertaking,18,648,1036,630,124,2456,1,175,178,74,16,444,2900
TOTAL (ALL INDIA),2010,Student,717,3134,137,42,7,4037,693,2568,71,10,0,3342,7379
TOTAL (ALL INDIA),2010,Unemployed,52,2964,3182,1483,563,8244,31,895,548,192,123,1789,10033
TOTAL (ALL INDIA),2010,Self-employed (Business activity),3,1891,2564,1692,454,6604,12,216,191,100,31,550,7154
TOTAL (ALL INDIA),2010,Professional Activity,4,1024,1479,908,291,3706,8,139,134,55,17,353,4059
TOTAL (ALL INDIA),2010,Farming/Agriculture Activity,58,3416,5082,3616,1420,13592,46,889,759,453,225,2372,15964
TOTAL (ALL INDIA),2010,Others (Please Specify),313,6074,7729,5535,2244,21895,236,2479,1953,1140,449,6257,28152
TOTAL (ALL INDIA),2010,Retired Person,0,16,17,141,578,752,0,12,2,31,101,146,898
TOTAL (ALL INDIA),2010,Others (Please Specify),461,4011,4964,4077,1945,15458,396,1882,1365,1023,534,5200,20658
TOTAL (ALL INDIA),2010,Total,1640,26387,30444,20768,7941,87180,1490,21238,14402,7121,3168,47419,134599
TOTAL (ALL INDIA),2010,Total Salaried,32,3857,5290,3274,439,12892,10,1150,815,319,58,2352,15244
TOTAL (ALL INDIA),2010,Total Self-employed,378,12405,16854,11751,4409,45797,302,3723,3037,1748,722,9532,55329
TOTAL (ALL INDIA),2011,House Wife,0,0,0,0,0,0,81,10730,8541,3710,1534,24596,24596
TOTAL (ALL INDIA),2011,Service (Government),0,268,612,439,11,1330,1,128,117,40,10,296,1626
TOTAL (ALL INDIA),2011,Service (Private),7,2965,3932,2205,357,9466,4,781,622,245,54,1706,11172
TOTAL (ALL INDIA),2011,Public Sector Undertaking,8,587,831,607,82,2115,4,266,210,80,9,569,2684
TOTAL (ALL INDIA),2011,Student,620,3384,171,13,0,4188,566,2838,92,9,3,3508,7696
TOTAL (ALL INDIA),2011,Unemployed,65,2918,3479,1722,393,8577,43,921,532,275,71,1842,10419
TOTAL (ALL INDIA),2011,Self-employed (Business activity),2,1903,2585,1743,413,6646,15,216,201,91,7,530,7176
TOTAL (ALL INDIA),2011,Professional Activity,1,1092,1472,946,254,3765,3,181,127,85,45,441,4206
TOTAL (ALL INDIA),2011,Farming/Agriculture Activity,24,2967,4509,3227,1344,12071,19,762,693,391,91,1956,14027
TOTAL (ALL INDIA),2011,Others (Please Specify),236,5464,7487,5192,2339,20718,265,2189,1774,1087,459,5774,26492
TOTAL (ALL INDIA),2011,Retired Person,0,19,23,146,534,722,0,18,6,31,80,135,857
TOTAL (ALL INDIA),2011,Others (Please Specify),611,5037,6299,4267,2027,18241,460,2380,1900,985,668,6393,24634
TOTAL (ALL INDIA),2011,Total,1574,26604,31400,20507,7754,87839,1461,21410,14815,7029,3031,47746,135585
TOTAL (ALL INDIA),2011,Total Salaried,15,3820,5375,3251,450,12911,9,1175,949,365,73,2571,15482
TOTAL (ALL INDIA),2011,Total Self-employed,263,11426,16053,11108,4350,43200,302,3348,2795,1654,602,8701,51901
TOTAL (ALL INDIA),2012,House Wife,0,0,0,0,0,0,28,9585,7282,3550,1459,21904,21904
TOTAL (ALL INDIA),2012,Service (Government),0,267,560,504,27,1358,6,125,127,47,3,308,1666
TOTAL (ALL INDIA),2012,Service (Private),21,3278,3928,2120,341,9688,22,774,532,214,43,1585,11273
TOTAL (ALL INDIA),2012,Public Sector Undertaking,0,480,703,451,82,1716,9,110,187,79,9,394,2110
TOTAL (ALL INDIA),2012,Student,537,2777,141,22,0,3477,571,2469,122,7,8,3177,6654
TOTAL (ALL INDIA),2012,Unemployed,38,2451,2682,1775,504,7450,30,693,460,228,66,1477,8927
TOTAL (ALL INDIA),2012,Self-employed (Business activity),10,1327,2087,1506,442,5372,4,118,129,73,10,334,5706
TOTAL (ALL INDIA),2012,Professional Activity,7,856,1217,835,229,3144,1,136,116,46,13,312,3456
TOTAL (ALL INDIA),2012,Farming/Agriculture Activity,6,2624,4374,3456,1491,11951,18,607,674,356,148,1803,13754
TOTAL (ALL INDIA),2012,Others (Please Specify),194,5316,7079,4819,2010,19418,211,1803,1240,737,342,4333,23751
TOTAL (ALL INDIA),2012,Retired Person,0,9,19,184,520,732,5,9,2,14,71,101,833
TOTAL (ALL INDIA),2012,Others (Please Specify),307,4013,5696,3525,1926,15467,289,1966,1258,856,618,4987,20454
TOTAL (ALL INDIA),2012,Total,1120,23398,28486,19197,7572,79773,1194,18395,12129,6207,2790,40715,120488
TOTAL (ALL INDIA),2012,Total Salaried,21,4025,5191,3075,450,12762,37,1009,846,340,55,2287,15049
