State/UT,Year,Cause,Male upto 14 years,Male 15-29 years,Male 30-44 years,Male 45-59 years,Male 60 years and above,Total Male,Female upto 14 years,Female 15-29 years,Female 30-44 years,Female 45-59 years,Female 60 years and above,Total Female,Total
ANDHRA PRADESH,2001,By Over Alcoholism,0,18,19,19,2,58,0,5,3,2,2,12,70
ANDHRA PRADESH,2001,By Drowning,38,114,139,66,28,385,26,198,87,53,34,398,783
ANDHRA PRADESH,2001,By Fire/Self Immolation,16,102,172,125,24,439,28,358,189,68,24,667,1106
ANDHRA PRADESH,2001,By Fire-Arms,0,8,5,2,0,15,0,14,11,4,0,29,44
ANDHRA PRADESH,2001,By Hanging,19,410,481,289,65,1264,50,323,205,128,39,745,2009
ANDHRA PRADESH,2001,By Consuming Insecticides,53,649,701,657,149,2209,60,595,456,222,29,1362,3571
ANDHRA PRADESH,2001,By Consuming Other Poison,19,352,351,240,32,994,6,235,145,122,25,533,1527
ANDHRA PRADESH,2001,By Self Infliction of injury,0,22,17,7,3,49,0,28,15,6,4,53,102
ANDHRA PRADESH,2001,By Jumping from (Building),0,0,3,1,1,5,0,2,1,0,0,3,8
ANDHRA PRADESH,2001,By Jumping from (Other sites),6,7,5,0,0,18,0,0,1,0,0,1,19
ANDHRA PRADESH,2001,By Jumping off Moving Vehicles/Trains,1,0,39,14,14,68,0,0,0,0,0,0,68
ANDHRA PRADESH,2001,By Machine,0,2,0,0,1,3,0,0,1,0,0,1,4
ANDHRA PRADESH,2001,By Overdose of sleeping pills,0,9,8,4,0,21,0,3,2,0,1,6,27
ANDHRA PRADESH,2001,By touching electric wires,0,10,19,2,3,34,0,0,0,3,1,4,38
ANDHRA PRADESH,2001,By coming under running vehicles/trains,6,131,161,98,37,433,7,30,26,21,15,99,532
ANDHRA PRADESH,2001,By Other means (please specify),15,224,93,42,10,384,8,80,56,68,18,230,614
ANDHRA PRADESH,2001,Total,173,2058,2213,1566,369,6379,185,1871,1198,697,192,4143,10522
ANDHRA PRADESH,2001,Total (Poison),72,1023,1069,904,184,3252,66,858,616,350,58,1948,5200
ANDHRA PRADESH,2001,Total (Jumping),6,7,8,1,1,23,0,2,2,0,0,4,27
ANDHRA PRADESH,2002,By Over Alcoholism,0,25,40,45,8,118,0,1,1,4,1,7,125
ANDHRA PRADESH,2002,By Drowning,22,123,161,114,40,460,14,150,129,39,40,372,832
ANDHRA PRADESH,2002,By Fire/Self Immolation,6,123,145,118,20,412,22,367,257,91,18,755,1167
ANDHRA PRADESH,2002,By Fire-Arms,1,8,18,5,2,34,1,3,15,9,0,28,62
ANDHRA PRADESH,2002,By Hanging,14,493,671,341,93,1612,26,337,183,83,31,660,2272
ANDHRA PRADESH,2002,By Consuming Insecticides,30,759,900,694,138,2521,49,584,466,163,59,1321,3842
ANDHRA PRADESH,2002,By Consuming Other Poison,9,334,420,402,121,1286,12,248,231,127,46,664,1950
ANDHRA PRADESH,2002,By Self Infliction of injury,0,6,7,1,2,16,0,5,0,0,0,5,21
ANDHRA PRADESH,2002,By Jumping from (Building),3,1,39,7,2,52,1,1,7,5,0,14,66
ANDHRA PRADESH,2002,By Jumping from (Other sites),0,8,1,2,0,11,0,2,0,0,0,2,13
ANDHRA PRADESH,2002,By Jumping off Moving Vehicles/Trains,1,18,30,23,16,88,0,3,4,2,0,9,97
ANDHRA PRADESH,2002,By Machine,0,0,0,1,0,1,0,1,0,0,0,1,2
ANDHRA PRADESH,2002,By Overdose of sleeping pills,1,11,17,0,5,34,0,10,3,1,2,16,50
ANDHRA PRADESH,2002,By touching electric wires,1,5,17,6,0,29,0,3,1,1,0,5,34
ANDHRA PRADESH,2002,By coming under running vehicles/trains,3,170,188,108,61,530,0,31,20,11,9,71,601
ANDHRA PRADESH,2002,By Other means,10,89,177,68,23,367,14,58,57,36,27,192,559
ANDHRA PRADESH,2002,Total,101,2173,2831,1935,531,7571,139,1804,1374,572,233,4122,11693
ANDHRA PRADESH,2002,Total (Poison),39,1099,1327,1097,261,3823,61,837,697,290,105,1990,5813
ANDHRA PRADESH,2002,Total (Jumping),3,9,40,9,2,63,1,3,7,5,0,16,79
ANDHRA PRADESH,2003,By Over Alcoholism,0,9,39,15,7,70,0,0,2,0,2,4,74
ANDHRA PRADESH,2003,By Drowning,36,151,167,87,30,471,18,89,61,21,18,207,678
ANDHRA PRADESH,2003,By Fire/Self Immolation,10,123,152,93,15,393,25,333,202,90,12,662,1055
ANDHRA PRADESH,2003,By Fire-Arms,0,2,3,2,0,7,0,5,2,9,0,16,23
ANDHRA PRADESH,2003,By Hanging,17,483,601,440,95,1636,32,326,256,91,30,735,2371
ANDHRA PRADESH,2003,By Consuming Insecticides,52,861,1164,634,181,2892,61,573,433,231,64,1362,4254
ANDHRA PRADESH,2003,By Consuming Other Poison,13,253,285,249,58,858,31,212,145,80,37,505,1363
ANDHRA PRADESH,2003,By Self Infliction of injury,0,6,7,4,1,18,1,3,1,0,0,5,23
ANDHRA PRADESH,2003,By Jumping from (Building),0,9,11,5,2,27,1,2,2,0,0,5,32
ANDHRA PRADESH,2003,By Jumping from (Other sites),0,16,22,9,5,52,0,1,4,5,0,10,62
ANDHRA PRADESH,2003,By Jumping off Moving Vehicles/Trains,0,14,20,4,0,38,0,6,2,5,3,16,54
ANDHRA PRADESH,2003,By Machine,1,2,2,1,0,6,0,0,0,0,0,0,6
ANDHRA PRADESH,2003,By Overdose of sleeping pills,0,9,9,20,19,57,0,9,9,5,5,28,85
ANDHRA PRADESH,2003,By touching electric wires,6,24,16,14,5,65,1,3,5,1,0,10,75
ANDHRA PRADESH,2003,By coming under running vehicles/trains,3,200,188,73,49,513,2,24,24,23,11,84,597
ANDHRA PRADESH,2003,By Other means (please specify),17,108,160,95,30,410,25,99,56,48,19,247,657
ANDHRA PRADESH,2003,Total,155,2270,2846,1745,497,7513,197,1685,1204,609,201,3896,11409
ANDHRA PRADESH,2003,Total (Poison),65,1120,1456,887,240,3768,93,788,579,311,101,1872,5640
ANDHRA PRADESH,2003,Total (Jumping),0,25,33,14,7,79,1,3,6,5,0,15,94
ANDHRA PRADESH,2004,By Over Alcoholism,0,9,19,20,7,55,0,1,1,0,0,2,57
ANDHRA PRADESH,2004,By Drowning,14,97,146,66,25,348,8,93,67,28,34,230,578
ANDHRA PRADESH,2004,By Fire/Self Immolation,7,133,125,58,19,342,20,263,134,51,16,484,826
ANDHRA PRADESH,2004,By Fire-Arms,0,0,4,3,1,8,0,2,2,0,0,4,12
ANDHRA PRADESH,2004,By Hanging,12,623,828,489,169,2121,20,399,266,109,45,839,2960
ANDHRA PRADESH,2004,By Consuming Insecticides,30,946,1267,822,297,3362,61,702,470,298,117,1648,5010
ANDHRA PRADESH,2004,By Consuming Other Poison,6,418,539,346,132,1441,17,297,215,83,36,648,2089
ANDHRA PRADESH,2004,By Self Infliction of injury,0,3,2,1,0,6,0,2,1,0,0,3,9
ANDHRA PRADESH,2004,By Jumping from (Building),1,2,1,1,0,5,2,4,2,1,0,9,14
ANDHRA PRADESH,2004,By Jumping from (Other sites),0,2,2,0,1,5,0,4,5,0,0,9,14
ANDHRA PRADESH,2004,By Jumping off Moving Vehicles/Trains,1,25,45,37,0,108,0,1,2,0,0,3,111
ANDHRA PRADESH,2004,By Machine,0,0,2,0,1,3,0,0,1,0,0,1,4
ANDHRA PRADESH,2004,By Overdose of sleeping pills,0,51,42,22,7,122,1,12,29,10,0,52,174
ANDHRA PRADESH,2004,By touching electric wires,0,23,33,11,0,67,0,2,7,0,0,9,76
ANDHRA PRADESH,2004,By coming under running vehicles/trains,1,84,154,126,83,448,1,31,57,44,32,165,613
ANDHRA PRADESH,2004,By Other means (please specify),23,146,239,173,60,641,12,146,85,65,30,338,979
ANDHRA PRADESH,2004,Total,95,2562,3448,2175,802,9082,142,1959,1344,689,310,4444,13526
ANDHRA PRADESH,2004,Total (Poison),36,1367,1808,1169,429,4809,78,1001,686,381,153,2299,7108
ANDHRA PRADESH,2004,Total (Jumping),1,4,3,1,1,10,2,8,7,1,0,18,28
ANDHRA PRADESH,2005,By Over Alcoholism,0,23,56,34,8,121,0,0,0,0,0,0,121
ANDHRA PRADESH,2005,By Drowning,19,118,146,129,76,488,27,119,90,62,33,331,819
ANDHRA PRADESH,2005,By Fire/Self Immolation,10,132,155,71,54,422,25,312,206,99,46,688,1110
ANDHRA PRADESH,2005,By Fire-Arms,0,6,18,10,4,38,2,7,6,1,0,16,54
ANDHRA PRADESH,2005,By Hanging,19,559,726,426,194,1924,17,419,222,84,57,799,2723
ANDHRA PRADESH,2005,By Consuming Insecticides,39,1050,1356,934,334,3713,47,701,567,247,150,1712,5425
ANDHRA PRADESH,2005,By Consuming Other Poison,19,207,236,156,67,685,20,173,107,147,84,531,1216
ANDHRA PRADESH,2005,By Self Infliction of injury,0,5,1,3,1,10,0,0,0,0,0,0,10
ANDHRA PRADESH,2005,By Jumping from (Building),1,8,11,6,1,27,2,5,1,0,0,8,35
ANDHRA PRADESH,2005,By Jumping from (Other sites),0,1,7,2,0,10,0,0,2,2,0,4,14
ANDHRA PRADESH,2005,By Jumping off Moving Vehicles/Trains,2,71,108,54,18,253,0,31,18,8,2,59,312
ANDHRA PRADESH,2005,By Machine,0,1,0,0,0,1,0,0,0,0,0,0,1
ANDHRA PRADESH,2005,By Overdose of sleeping pills,0,3,3,18,1,25,0,8,3,6,10,27,52
ANDHRA PRADESH,2005,By touching electric wires,0,24,29,13,0,66,0,0,1,1,3,5,71
ANDHRA PRADESH,2005,By coming under running vehicles/trains,11,90,149,142,96,488,5,29,36,18,8,96,584
ANDHRA PRADESH,2005,By Other means (please specify),23,146,177,158,90,594,16,100,101,58,26,301,895
ANDHRA PRADESH,2005,Total,143,2444,3178,2156,944,8865,161,1904,1360,733,419,4577,13442
ANDHRA PRADESH,2005,Total (Poison),58,1262,1593,1093,402,4408,67,874,674,394,234,2243,6651
ANDHRA PRADESH,2005,Total (Jumping),1,9,18,8,1,37,2,5,3,2,0,12,49
ANDHRA PRADESH,2006,By Over Alcoholism,0,27,66,43,13,149,0,1,2,0,0,3,152
ANDHRA PRADESH,2006,By Drowning,28,153,179,90,41,491,18,112,73,60,43,306,797
ANDHRA PRADESH,2006,By Fire/Self Immolation,6,122,157,76,26,387,21,315,197,71,25,629,1016
ANDHRA PRADESH,2006,By Fire-Arms,0,2,6,2,0,10,2,3,3,1,0,9,19
ANDHRA PRADESH,2006,By Hanging,27,647,661,391,137,1863,36,435,283,105,37,896,2759
ANDHRA PRADESH,2006,By Consuming Insecticides,36,1077,1442,858,233,3646,51,783,531,212,124,1701,5347
ANDHRA PRADESH,2006,By Consuming Other Poison,18,292,323,262,79,974,41,187,136,56,21,441,1415
ANDHRA PRADESH,2006,By Self Infliction of injury,7,1,1,1,0,10,0,0,1,1,1,3,13
ANDHRA PRADESH,2006,By Jumping from (Building),1,6,8,10,1,26,0,4,1,1,0,6,32
ANDHRA PRADESH,2006,By Jumping from (Other sites),0,33,53,47,7,140,0,3,6,1,2,12,152
ANDHRA PRADESH,2006,By Jumping off Moving Vehicles/Trains,0,23,22,24,0,69,0,7,3,0,0,10,79
ANDHRA PRADESH,2006,By Machine,0,0,0,0,0,0,0,2,0,0,0,2,2
ANDHRA PRADESH,2006,By Overdose of sleeping pills,6,6,19,9,2,42,0,14,8,3,0,25,67
ANDHRA PRADESH,2006,By touching electric wires,3,25,30,9,2,69,1,2,0,2,0,5,74
ANDHRA PRADESH,2006,By coming under running vehicles/trains,3,153,180,136,99,571,2,28,23,26,17,96,667
ANDHRA PRADESH,2006,By Other means (please specify),34,129,131,74,48,416,23,91,90,44,21,269,685
ANDHRA PRADESH,2006,Total,169,2696,3278,2032,688,8863,195,1987,1357,583,291,4413,13276
ANDHRA PRADESH,2006,Total (Poison),61,1370,1766,1121,312,4630,92,970,668,269,146,2145,6775
ANDHRA PRADESH,2006,Total (Jumping),1,39,61,57,8,166,0,7,7,2,2,18,184
ANDHRA PRADESH,2007,By Over Alcoholism,0,18,61,56,4,139,0,1,0,0,0,1,140
ANDHRA PRADESH,2007,By Drowning,23,195,195,110,53,576,40,86,119,57,45,347,923
ANDHRA PRADESH,2007,By Fire/Self Immolation,12,177,253,87,40,569,33,400,255,112,41,841,1410
ANDHRA PRADESH,2007,By Fire-Arms,0,1,4,3,0,8,3,3,9,1,2,18,26
ANDHRA PRADESH,2007,By Hanging,14,619,699,420,123,1875,30,517,267,142,44,1000,2875
ANDHRA PRADESH,2007,By Consuming Insecticides,40,995,1326,885,453,3699,43,654,483,288,134,1602,5301
ANDHRA PRADESH,2007,By Consuming Other Poison,17,443,548,376,82,1466,28,261,164,112,43,608,2074
ANDHRA PRADESH,2007,By Self Infliction of injury,0,4,6,5,0,15,0,4,3,0,1,8,23
ANDHRA PRADESH,2007,By Jumping from (Building),1,4,12,13,5,35,3,6,1,3,0,13,48
ANDHRA PRADESH,2007,By Jumping from (Other sites),4,21,6,24,10,65,0,9,6,3,0,18,83
ANDHRA PRADESH,2007,By Jumping off Moving Vehicles/Trains,0,18,13,11,5,47,0,4,3,0,0,7,54
ANDHRA PRADESH,2007,By Machine,0,0,1,0,0,1,0,0,0,0,0,0,1
ANDHRA PRADESH,2007,By Overdose of sleeping pills,2,9,12,4,2,29,1,3,11,2,0,17,46
ANDHRA PRADESH,2007,By touching electric wires,0,15,27,4,0,46,0,2,3,3,4,12,58
ANDHRA PRADESH,2007,By coming under running vehicles/trains,3,204,308,157,108,780,2,42,24,29,14,111,891
ANDHRA PRADESH,2007,By Other means (please specify),5,213,189,149,43,599,11,147,102,52,18,330,929
ANDHRA PRADESH,2007,Total,121,2936,3660,2304,928,9949,194,2139,1450,804,346,4933,14882
ANDHRA PRADESH,2007,Total (Poison),57,1442,1880,1266,535,5180,71,919,650,400,178,2218,7398
ANDHRA PRADESH,2007,Total (Jumping),5,25,18,37,15,100,3,15,7,6,0,31,131
ANDHRA PRADESH,2008,By Over Alcoholism,0,75,88,49,9,221,0,0,5,0,0,5,226
ANDHRA PRADESH,2008,By Drowning,12,145,169,78,48,452,17,90,93,53,26,279,731
ANDHRA PRADESH,2008,By Fire/Self Immolation,4,211,232,91,28,566,19,339,256,86,22,722,1288
ANDHRA PRADESH,2008,By Fire-Arms,0,6,5,4,0,15,0,1,5,6,0,12,27
ANDHRA PRADESH,2008,By Hanging,19,611,885,425,135,2075,22,330,319,158,48,877,2952
ANDHRA PRADESH,2008,By Consuming Insecticides,31,1005,1328,815,310,3489,44,650,466,190,90,1440,4929
ANDHRA PRADESH,2008,By Consuming Other Poison,6,276,475,587,69,1413,5,267,263,161,64,760,2173
ANDHRA PRADESH,2008,By Self Infliction of injury,0,1,7,3,6,17,0,0,3,0,0,3,20
ANDHRA PRADESH,2008,By Jumping from (Building),2,12,10,5,2,31,0,3,1,3,0,7,38
ANDHRA PRADESH,2008,By Jumping from (Other sites),1,6,9,6,2,24,0,0,1,2,0,3,27
ANDHRA PRADESH,2008,By Jumping off Moving Vehicles/Trains,0,1,8,17,0,26,1,4,0,0,0,5,31
ANDHRA PRADESH,2008,By Machine,0,3,2,1,0,6,0,1,0,0,0,1,7
ANDHRA PRADESH,2008,By Overdose of sleeping pills,0,8,4,5,1,18,0,13,11,1,0,25,43
ANDHRA PRADESH,2008,By touching electric wires,0,17,17,14,2,50,2,5,5,4,1,17,67
ANDHRA PRADESH,2008,By coming under running vehicles/trains,4,172,125,127,57,485,3,36,14,14,2,69,554
ANDHRA PRADESH,2008,By Other means (please specify),12,165,305,250,101,833,9,143,142,60,54,408,1241
ANDHRA PRADESH,2008,Total,91,2714,3669,2477,770,9721,122,1882,1584,738,307,4633,14354
ANDHRA PRADESH,2008,Total (Poison),37,1282,1810,1405,385,4919,49,917,732,351,154,2203,7122
ANDHRA PRADESH,2008,Total (Jumping),3,18,19,11,4,55,0,3,2,5,0,10,65
ANDHRA PRADESH,2009,By Over Alcoholism,0,106,92,51,14,263,0,2,7,2,1,12,275
ANDHRA PRADESH,2009,By Drowning,16,122,170,72,34,414,14,75,75,50,36,250,664
ANDHRA PRADESH,2009,By Fire/Self Immolation,6,192,315,195,31,739,15,360,263,122,53,813,1552
ANDHRA PRADESH,2009,By Fire-Arms,0,2,3,2,0,7,0,0,1,3,1,5,12
ANDHRA PRADESH,2009,By Hanging,3,582,787,478,125,1975,15,462,285,202,45,1009,2984
ANDHRA PRADESH,2009,By Consuming Insecticides,13,814,1322,862,300,3311,24,457,382,245,88,1196,4507
ANDHRA PRADESH,2009,By Consuming Other Poison,9,437,555,555,149,1705,29,336,222,99,34,720,2425
ANDHRA PRADESH,2009,By Self Infliction of injury,0,4,5,5,4,18,0,8,10,0,0,18,36
ANDHRA PRADESH,2009,By Jumping from (Building),1,25,26,15,4,71,1,22,6,4,1,34,105
ANDHRA PRADESH,2009,By Jumping from (Other sites),1,2,6,11,9,29,0,1,0,0,1,2,31
ANDHRA PRADESH,2009,By Jumping off Moving Vehicles/Trains,0,6,3,2,0,11,0,2,0,1,0,3,14
ANDHRA PRADESH,2009,By Machine,0,1,2,8,1,12,0,1,0,0,0,1,13
ANDHRA PRADESH,2009,By Overdose of sleeping pills,0,8,12,6,0,26,3,11,5,4,1,24,50
ANDHRA PRADESH,2009,By touching electric wires,2,15,24,27,3,71,8,7,5,2,0,22,93
ANDHRA PRADESH,2009,By coming under running vehicles/trains,2,177,137,121,34,471,2,44,23,17,7,93,564
ANDHRA PRADESH,2009,By Other means (please specify),14,234,263,176,77,764,16,146,136,78,35,411,1175
ANDHRA PRADESH,2009,Total,67,2727,3722,2586,785,9887,127,1934,1420,829,303,4613,14500
ANDHRA PRADESH,2009,Total (Poison),22,1255,1882,1422,453,5034,53,801,614,344,122,1934,6968
ANDHRA PRADESH,2009,Total (Jumping),2,27,32,26,13,100,1,23,6,4,2,36,136
ANDHRA PRADESH,2010,By Over Alcoholism,0,90,82,54,23,249,0,2,5,12,6,25,274
ANDHRA PRADESH,2010,By Drowning,13,206,214,166,57,656,24,125,126,45,51,371,1027
ANDHRA PRADESH,2010,By Fire/Self Immolation,11,225,313,172,58,779,27,420,244,98,39,828,1607
ANDHRA PRADESH,2010,By Fire-Arms,0,36,25,16,5,82,0,42,18,0,1,61,143
ANDHRA PRADESH,2010,By Hanging,16,705,707,453,148,2029,16,443,268,95,42,864,2893
ANDHRA PRADESH,2010,By Consuming Insecticides,27,1187,1231,817,208,3470,24,612,454,194,110,1394,4864
ANDHRA PRADESH,2010,By Consuming Other Poison,5,395,470,335,159,1364,12,218,169,91,95,585,1949
ANDHRA PRADESH,2010,By Self Infliction of injury,0,20,51,22,3,96,1,10,9,5,2,27,123
ANDHRA PRADESH,2010,By Jumping from (Building),1,30,53,8,1,93,0,9,14,2,4,29,122
ANDHRA PRADESH,2010,By Jumping from (Other sites),0,19,37,10,1,67,0,10,13,0,1,24,91
ANDHRA PRADESH,2010,By Jumping off Moving Vehicles/Trains,0,12,10,2,1,25,0,2,3,0,0,5,30
ANDHRA PRADESH,2010,By Machine,0,3,4,2,1,10,0,0,1,0,0,1,11
ANDHRA PRADESH,2010,By Overdose of sleeping pills,0,59,51,21,3,134,0,29,20,9,0,58,192
ANDHRA PRADESH,2010,By touching electric wires,3,46,40,31,5,125,0,7,13,2,2,24,149
ANDHRA PRADESH,2010,By coming under running vehicles/trains,7,245,235,182,91,760,4,46,46,19,16,131,891
ANDHRA PRADESH,2010,By Other means (please specify),12,252,339,275,130,1008,22,170,169,106,60,527,1535
ANDHRA PRADESH,2010,Total,95,3530,3862,2566,894,10947,130,2145,1572,678,429,4954,15901
ANDHRA PRADESH,2010,Total (Poison),32,1602,1752,1174,370,4930,37,840,632,290,207,2006,6936
ANDHRA PRADESH,2010,Total (Jumping),1,49,90,18,2,160,0,19,27,2,5,53,213
ANDHRA PRADESH,2011,By Over Alcoholism,0,17,57,28,27,129,0,1,0,0,3,4,133
ANDHRA PRADESH,2011,By Drowning,26,168,167,126,107,594,14,169,102,52,41,378,972
ANDHRA PRADESH,2011,By Fire/Self Immolation,6,188,254,227,45,720,19,472,256,93,37,877,1597
ANDHRA PRADESH,2011,By Fire-Arms,0,6,2,2,0,10,0,8,4,2,0,14,24
ANDHRA PRADESH,2011,By Hanging,15,590,768,689,134,2196,22,425,312,162,53,974,3170
ANDHRA PRADESH,2011,By Consuming Insecticides,31,785,1022,700,286,2824,31,567,333,157,55,1143,3967
ANDHRA PRADESH,2011,By Consuming Other Poison,10,631,731,527,163,2062,27,438,377,133,69,1044,3106
ANDHRA PRADESH,2011,By Self Infliction of injury,0,13,13,5,4,35,0,1,3,1,0,5,40
ANDHRA PRADESH,2011,By Jumping from (Building),1,10,7,12,1,31,2,10,5,8,3,28,59
ANDHRA PRADESH,2011,By Jumping from (Other sites),1,6,11,9,1,28,0,7,1,0,0,8,36
ANDHRA PRADESH,2011,By Jumping off Moving Vehicles/Trains,0,0,2,0,0,2,0,0,0,0,0,0,2
ANDHRA PRADESH,2011,By Machine,0,0,2,0,1,3,0,0,0,0,0,0,3
ANDHRA PRADESH,2011,By Overdose of sleeping pills,0,42,12,14,10,78,6,30,20,9,2,67,145
ANDHRA PRADESH,2011,By touching electric wires,0,9,8,1,1,19,0,0,0,0,0,0,19
ANDHRA PRADESH,2011,By coming under running vehicles/trains,0,150,231,185,82,648,2,50,73,16,20,161,809
ANDHRA PRADESH,2011,By Other means (please specify),22,213,264,185,57,741,20,106,69,30,29,254,995
ANDHRA PRADESH,2011,Total,112,2828,3551,2710,919,10120,143,2284,1555,663,312,4957,15077
ANDHRA PRADESH,2011,Total (Poison),41,1429,1766,1232,453,4921,58,1006,713,291,124,2192,7113
ANDHRA PRADESH,2011,Total (Jumping),2,16,18,21,2,59,2,17,6,8,3,36,95
ANDHRA PRADESH,2012,By Over Alcoholism,0,31,86,23,37,177,0,3,4,1,3,11,188
ANDHRA PRADESH,2012,By Drowning,17,149,172,144,102,584,15,121,76,43,38,293,877
ANDHRA PRADESH,2012,By Fire/Self Immolation,6,174,231,118,36,565,24,381,232,85,49,771,1336
ANDHRA PRADESH,2012,By Fire-Arms,0,5,8,0,0,13,0,2,0,0,0,2,15
ANDHRA PRADESH,2012,By Hanging,9,606,827,701,134,2277,16,417,249,124,23,829,3106
ANDHRA PRADESH,2012,By Consuming Insecticides,11,716,953,611,192,2483,20,480,322,165,68,1055,3538
ANDHRA PRADESH,2012,By Consuming Other Poison,6,335,631,292,244,1508,49,391,356,165,75,1036,2544
ANDHRA PRADESH,2012,By Self Infliction of injury,0,17,16,11,2,46,3,13,23,5,0,44,90
ANDHRA PRADESH,2012,By Jumping from (Building),0,17,18,12,3,50,4,14,14,1,1,34,84
ANDHRA PRADESH,2012,By Jumping from (Other sites),0,7,15,5,1,28,1,3,1,0,1,6,34
ANDHRA PRADESH,2012,By Jumping off Moving Vehicles/Trains,0,3,0,2,0,5,0,1,0,0,0,1,6
ANDHRA PRADESH,2012,By Machine,0,0,0,3,0,3,0,0,0,0,0,0,3
ANDHRA PRADESH,2012,By Overdose of sleeping pills,0,18,17,23,5,63,0,34,26,22,4,86,149
ANDHRA PRADESH,2012,By touching electric wires,0,20,8,9,6,43,0,1,5,0,0,6,49
ANDHRA PRADESH,2012,By coming under running vehicles/trains,4,294,353,198,107,956,1,63,33,31,17,145,1101
ANDHRA PRADESH,2012,By Other means (please specify),12,151,293,188,82,726,10,122,125,88,47,392,1118
ANDHRA PRADESH,2012,Total,65,2543,3628,2340,951,9527,143,2046,1466,730,326,4711,14238
ANDHRA PRADESH,2012,Total (Poison),17,1068,1600,914,438,4037,72,884,701,335,143,2135,6172
ANDHRA PRADESH,2012,Total (Jumping),0,24,33,17,4,78,5,17,15,1,2,40,118
ARUNACHAL PRADESH,2001,By Over Alcoholism,0,0,0,0,0,0,0,0,0,0,0,0,0
ARUNACHAL PRADESH,2001,By Drowning,0,1,0,0,0,1,0,1,1,0,0,2,3
ARUNACHAL PRADESH,2001,By Fire/Self Immolation,0,0,1,0,0,1,0,2,1,0,0,3,4
ARUNACHAL PRADESH,2001,By Fire-Arms,0,1,0,0,0,1,0,0,0,0,0,0,1
ARUNACHAL PRADESH,2001,By Hanging,1,20,35,10,0,66,2,17,6,1,0,26,92
ARUNACHAL PRADESH,2001,By Consuming Insecticides,0,1,0,0,0,1,0,0,0,0,0,0,1
ARUNACHAL PRADESH,2001,By Consuming Other Poison,1,1,2,1,1,6,0,2,1,0,0,3,9
ARUNACHAL PRADESH,2001,By Self Infliction of injury,0,0,0,0,0,0,0,0,0,0,0,0,0
ARUNACHAL PRADESH,2001,By Jumping from (Building),0,0,0,0,0,0,0,0,0,0,0,0,0
ARUNACHAL PRADESH,2001,By Jumping from (Other sites),0,0,0,0,0,0,0,0,0,0,0,0,0
ARUNACHAL PRADESH,2001,By Jumping off Moving Vehicles/Trains,0,0,0,0,0,0,0,0,0,0,0,0,0
ARUNACHAL PRADESH,2001,By Machine,0,0,0,0,0,0,0,0,0,0,0,0,0
ARUNACHAL PRADESH,2001,By Overdose of sleeping pills,0,0,0,0,0,0,0,0,0,0,0,0,0
ARUNACHAL PRADESH,2001,By touching electric wires,0,0,0,0,0,0,0,1,0,0,0,1,1
ARUNACHAL PRADESH,2001,By coming under running vehicles/trains,0,0,0,0,0,0,0,0,0,0,0,0,0
ARUNACHAL PRADESH,2001,By Other means (please specify),0,0,0,0,0,0,0,0,0,0,0,0,0
ARUNACHAL PRADESH,2001,Total,2,24,38,11,1,76,2,23,9,1,0,35,111
ARUNACHAL PRADESH,2001,Total (Poison),1,2,2,1,1,7,0,2,1,0,0,3,10
ARUNACHAL PRADESH,2001,Total (Jumping),0,0,0,0,0,0,0,0,0,0,0,0,0
ARUNACHAL PRADESH,2002,By Over Alcoholism,0,0,0,0,0,0,0,0,0,0,0,0,0
ARUNACHAL PRADESH,2002,By Drowning,0,2,6,0,1,9,0,0,0,0,0,0,9
ARUNACHAL PRADESH,2002,By Fire/Self Immolation,0,0,1,0,0,1,0,3,0,0,0,3,4
ARUNACHAL PRADESH,2002,By Fire-Arms,0,0,1,0,0,1,0,0,0,0,0,0,1
ARUNACHAL PRADESH,2002,By Hanging,1,17,27,9,2,56,1,20,8,1,1,31,87
ARUNACHAL PRADESH,2002,By Consuming Insecticides,0,1,0,0,0,1,1,2,0,0,0,3,4
ARUNACHAL PRADESH,2002,By Consuming Other Poison,0,0,3,0,0,3,0,3,3,0,0,6,9
ARUNACHAL PRADESH,2002,By Self Infliction of injury,0,0,0,0,0,0,0,0,0,0,0,0,0
ARUNACHAL PRADESH,2002,By Jumping from (Building),0,0,0,0,0,0,0,0,0,0,0,0,0
ARUNACHAL PRADESH,2002,By Jumping from (Other sites),0,0,0,0,0,0,0,0,0,0,0,0,0
ARUNACHAL PRADESH,2002,By Jumping off Moving Vehicles/Trains,0,0,0,0,0,0,0,0,0,0,0,0,0
ARUNACHAL PRADESH,2002,By Machine,0,0,0,0,0,0,0,0,0,0,0,0,0
ARUNACHAL PRADESH,2002,By Overdose of sleeping pills,0,0,0,0,0,0,0,0,0,0,0,0,0
ARUNACHAL PRADESH,2002,By touching electric wires,0,0,0,0,0,0,0,0,0,0,0,0,0
ARUNACHAL PRADESH,2002,By coming under running vehicles/trains,0,0,0,0,0,0,0,0,0,0,0,0,0
ARUNACHAL PRADESH,2002,By Other means,0,0,0,0,0,0,0,0,0,0,0,0,0
ARUNACHAL PRADESH,2002,Total,1,20,38,9,3,71,2,28,11,1,1,43,114
ARUNACHAL PRADESH,2002,Total (Poison),0,1,3,0,0,4,1,5,3,0,0,9,13
ARUNACHAL PRADESH,2002,Total (Jumping),0,0,0,0,0,0,0,0,0,0,0,0,0
ARUNACHAL PRADESH,2003,By Over Alcoholism,0,0,0,0,0,0,0,0,0,0,0,0,0
ARUNACHAL PRADESH,2003,By Drowning,0,0,1,0,0,1,0,0,0,0,0,0,1
ARUNACHAL PRADESH,2003,By Fire/Self Immolation,0,0,0,0,0,0,0,0,2,0,0,2,2
ARUNACHAL PRADESH,2003,By Fire-Arms,0,0,1,0,0,1,0,0,0,0,0,0,1
ARUNACHAL PRADESH,2003,By Hanging,3,10,21,12,1,47,1,12,7,2,0,22,69
ARUNACHAL PRADESH,2003,By Consuming Insecticides,0,0,0,0,0,0,0,0,1,0,0,1,1
ARUNACHAL PRADESH,2003,By Consuming Other Poison,0,1,3,0,1,5,0,2,0,0,0,2,7
ARUNACHAL PRADESH,2003,By Self Infliction of injury,0,0,0,0,0,0,0,0,0,0,0,0,0
ARUNACHAL PRADESH,2003,By Jumping from (Building),0,0,0,0,0,0,0,0,0,0,0,0,0
ARUNACHAL PRADESH,2003,By Jumping from (Other sites),0,0,0,0,0,0,0,0,0,0,0,0,0
ARUNACHAL PRADESH,2003,By Jumping off Moving Vehicles/Trains,0,0,0,0,0,0,0,0,0,0,0,0,0
ARUNACHAL PRADESH,2003,By Machine,0,0,0,0,0,0,0,0,0,0,0,0,0
ARUNACHAL PRADESH,2003,By Overdose of sleeping pills,0,0,0,0,0,0,0,0,0,0,0,0,0
ARUNACHAL PRADESH,2003,By touching electric wires,0,0,0,0,0,0,0,0,0,0,0,0,0
ARUNACHAL PRADESH,2003,By coming under running vehicles/trains,0,0,0,0,0,0,0,0,0,0,0,0,0
ARUNACHAL PRADESH,2003,By Other means (please specify),0,0,0,0,0,0,0,0,0,0,0,0,0
ARUNACHAL PRADESH,2003,Total,3,11,26,12,2,54,1,14,10,2,0,27,81
ARUNACHAL PRADESH,2003,Total (Poison),0,1,3,0,1,5,0,2,1,0,0,3,8
ARUNACHAL PRADESH,2003,Total (Jumping),0,0,0,0,0,0,0,0,0,0,0,0,0
ARUNACHAL PRADESH,2004,By Over Alcoholism,0,0,0,0,0,0,0,0,0,0,0,0,0
ARUNACHAL PRADESH,2004,By Drowning,0,2,1,0,0,3,0,0,0,0,0,0,3
ARUNACHAL PRADESH,2004,By Fire/Self Immolation,0,0,1,0,0,1,0,0,2,0,0,2,3
ARUNACHAL PRADESH,2004,By Fire-Arms,0,1,1,0,0,2,0,0,1,0,0,1,3
ARUNACHAL PRADESH,2004,By Hanging,1,13,19,4,0,37,4,12,8,0,0,24,61
ARUNACHAL PRADESH,2004,By Consuming Insecticides,0,0,0,1,0,1,0,0,0,0,0,0,1
ARUNACHAL PRADESH,2004,By Consuming Other Poison,0,2,2,1,0,5,0,1,2,0,0,3,8
ARUNACHAL PRADESH,2004,By Self Infliction of injury,0,0,0,0,0,0,0,0,0,0,0,0,0
ARUNACHAL PRADESH,2004,By Jumping from (Building),0,0,0,0,0,0,0,0,0,0,0,0,0
ARUNACHAL PRADESH,2004,By Jumping from (Other sites),0,0,0,0,0,0,0,0,0,0,0,0,0
ARUNACHAL PRADESH,2004,By Jumping off Moving Vehicles/Trains,0,0,0,0,0,0,0,0,0,0,0,0,0
ARUNACHAL PRADESH,2004,By Machine,0,0,0,0,0,0,0,0,0,0,0,0,0
ARUNACHAL PRADESH,2004,By Overdose of sleeping pills,0,0,0,0,0,0,0,0,0,0,0,0,0
ARUNACHAL PRADESH,2004,By touching electric wires,0,0,0,0,0,0,0,0,0,0,0,0,0
ARUNACHAL PRADESH,2004,By coming under running vehicles/trains,0,0,0,0,0,0,0,0,0,0,0,0,0
ARUNACHAL PRADESH,2004,By Other means (please specify),0,0,0,0,0,0,0,0,0,0,0,0,0
ARUNACHAL PRADESH,2004,Total,1,18,24,6,0,49,4,13,13,0,0,30,79
ARUNACHAL PRADESH,2004,Total (Poison),0,2,2,2,0,6,0,1,2,0,0,3,9
ARUNACHAL PRADESH,2004,Total (Jumping),0,0,0,0,0,0,0,0,0,0,0,0,0
ARUNACHAL PRADESH,2005,By Over Alcoholism,0,0,0,0,0,0,0,0,0,0,0,0,0
ARUNACHAL PRADESH,2005,By Drowning,0,0,2,0,1,3,0,0,0,0,0,0,3
ARUNACHAL PRADESH,2005,By Fire/Self Immolation,0,0,0,0,0,0,0,0,1,0,0,1,1
ARUNACHAL PRADESH,2005,By Fire-Arms,0,0,0,0,0,0,0,0,0,0,0,0,0
ARUNACHAL PRADESH,2005,By Hanging,0,12,25,3,3,43,0,8,7,1,0,16,59
ARUNACHAL PRADESH,2005,By Consuming Insecticides,0,1,1,0,0,2,0,1,0,0,1,2,4
ARUNACHAL PRADESH,2005,By Consuming Other Poison,0,0,0,0,0,0,0,1,1,0,0,2,2
ARUNACHAL PRADESH,2005,By Self Infliction of injury,0,0,0,0,0,0,0,0,0,0,0,0,0
ARUNACHAL PRADESH,2005,By Jumping from (Building),0,0,0,0,0,0,0,0,0,0,0,0,0
ARUNACHAL PRADESH,2005,By Jumping from (Other sites),0,0,0,1,0,1,0,0,0,0,0,0,1
ARUNACHAL PRADESH,2005,By Jumping off Moving Vehicles/Trains,0,0,0,0,0,0,0,0,0,0,0,0,0
ARUNACHAL PRADESH,2005,By Machine,0,0,0,0,0,0,0,0,0,0,0,0,0
ARUNACHAL PRADESH,2005,By Overdose of sleeping pills,0,0,0,0,0,0,0,0,0,0,0,0,0
ARUNACHAL PRADESH,2005,By touching electric wires,0,0,0,0,0,0,0,0,0,0,0,0,0
ARUNACHAL PRADESH,2005,By coming under running vehicles/trains,0,0,0,0,0,0,0,0,0,0,0,0,0
ARUNACHAL PRADESH,2005,By Other means (please specify),0,0,0,0,0,0,0,0,0,0,0,0,0
ARUNACHAL PRADESH,2005,Total,0,13,28,4,4,49,0,10,9,1,1,21,70
ARUNACHAL PRADESH,2005,Total (Poison),0,1,1,0,0,2,0,2,1,0,1,4,6
ARUNACHAL PRADESH,2005,Total (Jumping),0,0,0,1,0,1,0,0,0,0,0,0,1
ARUNACHAL PRADESH,2006,By Over Alcoholism,0,0,0,0,0,0,0,0,0,0,0,0,0
ARUNACHAL PRADESH,2006,By Drowning,0,0,2,1,0,3,0,2,0,0,0,2,5
ARUNACHAL PRADESH,2006,By Fire/Self Immolation,0,0,0,0,0,0,0,1,0,0,0,1,1
ARUNACHAL PRADESH,2006,By Fire-Arms,0,1,2,0,0,3,0,0,0,0,0,0,3
ARUNACHAL PRADESH,2006,By Hanging,1,19,41,18,0,79,3,12,12,3,0,30,109
ARUNACHAL PRADESH,2006,By Consuming Insecticides,0,0,0,0,0,0,0,0,0,0,0,0,0
ARUNACHAL PRADESH,2006,By Consuming Other Poison,0,0,0,0,0,0,0,0,0,0,0,0,0
ARUNACHAL PRADESH,2006,By Self Infliction of injury,0,0,0,0,0,0,0,0,0,0,0,0,0
ARUNACHAL PRADESH,2006,By Jumping from (Building),0,0,0,0,0,0,0,0,0,0,0,0,0
ARUNACHAL PRADESH,2006,By Jumping from (Other sites),0,0,0,0,0,0,0,0,0,0,0,0,0
ARUNACHAL PRADESH,2006,By Jumping off Moving Vehicles/Trains,0,0,0,0,0,0,0,0,0,0,0,0,0
ARUNACHAL PRADESH,2006,By Machine,0,0,0,0,0,0,0,0,0,0,0,0,0
ARUNACHAL PRADESH,2006,By Overdose of sleeping pills,0,0,0,0,0,0,0,0,0,0,0,0,0
ARUNACHAL PRADESH,2006,By touching electric wires,0,0,0,0,0,0,0,0,0,0,0,0,0
ARUNACHAL PRADESH,2006,By coming under running vehicles/trains,0,0,0,0,0,0,0,0,0,0,0,0,0
ARUNACHAL PRADESH,2006,By Other means (please specify),0,8,0,2,1,11,0,0,0,0,0,0,11
ARUNACHAL PRADESH,2006,Total,1,28,45,21,1,96,3,15,12,3,0,33,129
ARUNACHAL PRADESH,2006,Total (Poison),0,0,0,0,0,0,0,0,0,0,0,0,0
ARUNACHAL PRADESH,2006,Total (Jumping),0,0,0,0,0,0,0,0,0,0,0,0,0
ARUNACHAL PRADESH,2007,By Over Alcoholism,0,0,0,1,0,1,0,0,0,0,0,0,1
ARUNACHAL PRADESH,2007,By Drowning,1,0,2,2,0,5,0,0,0,0,0,0,5
ARUNACHAL PRADESH,2007,By Fire/Self Immolation,0,0,0,0,0,0,0,0,0,0,0,0,0
ARUNACHAL PRADESH,2007,By Fire-Arms,0,5,7,0,0,12,0,0,2,0,0,2,14
ARUNACHAL PRADESH,2007,By Hanging,1,30,26,4,3,64,3,12,3,2,0,20,84
ARUNACHAL PRADESH,2007,By Consuming Insecticides,0,0,0,0,0,0,0,0,0,0,0,0,0
ARUNACHAL PRADESH,2007,By Consuming Other Poison,0,1,2,0,0,3,0,1,3,0,0,4,7
ARUNACHAL PRADESH,2007,By Self Infliction of injury,0,0,0,0,0,0,0,0,0,0,0,0,0
ARUNACHAL PRADESH,2007,By Jumping from (Building),0,0,0,0,0,0,0,0,0,0,0,0,0
ARUNACHAL PRADESH,2007,By Jumping from (Other sites),0,0,0,0,0,0,0,1,0,0,0,1,1
ARUNACHAL PRADESH,2007,By Jumping off Moving Vehicles/Trains,0,0,0,0,0,0,0,0,0,0,0,0,0
ARUNACHAL PRADESH,2007,By Machine,0,0,0,0,0,0,0,0,0,0,0,0,0
ARUNACHAL PRADESH,2007,By Overdose of sleeping pills,0,0,0,0,0,0,0,0,0,0,0,0,0
ARUNACHAL PRADESH,2007,By touching electric wires,0,0,0,0,0,0,0,0,0,0,0,0,0
ARUNACHAL PRADESH,2007,By coming under running vehicles/trains,0,0,0,0,0,0,0,0,0,0,0,0,0
ARUNACHAL PRADESH,2007,By Other means (please specify),0,3,7,3,0,13,2,0,2,0,0,4,17
ARUNACHAL PRADESH,2007,Total,2,39,44,10,3,98,5,14,10,2,0,31,129
ARUNACHAL PRADESH,2007,Total (Poison),0,1,2,0,0,3,0,1,3,0,0,4,7
ARUNACHAL PRADESH,2007,Total (Jumping),0,0,0,0,0,0,0,1,0,0,0,1,1
ARUNACHAL PRADESH,2008,By Over Alcoholism,0,0,0,0,0,0,0,0,0,0,0,0,0
ARUNACHAL PRADESH,2008,By Drowning,0,0,1,0,0,1,0,0,0,0,0,0,1
ARUNACHAL PRADESH,2008,By Fire/Self Immolation,0,0,0,0,0,0,0,0,0,0,0,0,0
ARUNACHAL PRADESH,2008,By Fire-Arms,0,1,1,0,0,2,0,0,0,0,0,0,2
ARUNACHAL PRADESH,2008,By Hanging,2,39,22,7,0,70,0,19,13,1,0,33,103
ARUNACHAL PRADESH,2008,By Consuming Insecticides,0,0,0,0,0,0,0,0,0,0,0,0,0
ARUNACHAL PRADESH,2008,By Consuming Other Poison,0,2,1,0,0,3,0,0,0,0,0,0,3
ARUNACHAL PRADESH,2008,By Self Infliction of injury,0,0,0,0,0,0,0,0,0,0,0,0,0
ARUNACHAL PRADESH,2008,By Jumping from (Building),0,1,0,0,0,1,0,0,0,0,0,0,1
ARUNACHAL PRADESH,2008,By Jumping from (Other sites),0,0,0,0,0,0,0,0,0,0,0,0,0
ARUNACHAL PRADESH,2008,By Jumping off Moving Vehicles/Trains,0,0,0,0,0,0,0,0,0,0,0,0,0
ARUNACHAL PRADESH,2008,By Machine,0,0,0,0,0,0,0,0,0,0,0,0,0
ARUNACHAL PRADESH,2008,By Overdose of sleeping pills,0,0,0,0,0,0,0,0,0,0,0,0,0
ARUNACHAL PRADESH,2008,By touching electric wires,0,0,0,0,0,0,0,0,0,0,0,0,0
ARUNACHAL PRADESH,2008,By coming under running vehicles/trains,0,0,0,0,0,0,0,0,0,0,0,0,0
ARUNACHAL PRADESH,2008,By Other means (please specify),0,0,0,0,0,0,0,0,0,0,0,0,0
ARUNACHAL PRADESH,2008,Total,2,43,25,7,0,77,0,19,13,1,0,33,110
ARUNACHAL PRADESH,2008,Total (Poison),0,2,1,0,0,3,0,0,0,0,0,0,3
ARUNACHAL PRADESH,2008,Total (Jumping),0,1,0,0,0,1,0,0,0,0,0,0,1
ARUNACHAL PRADESH,2009,By Over Alcoholism,0,0,0,0,0,0,0,0,0,0,0,0,0
ARUNACHAL PRADESH,2009,By Drowning,0,0,1,0,0,1,0,0,0,0,0,0,1
ARUNACHAL PRADESH,2009,By Fire/Self Immolation,0,0,0,0,0,0,0,0,0,0,0,0,0
ARUNACHAL PRADESH,2009,By Fire-Arms,0,1,1,0,0,2,0,0,0,0,0,0,2
ARUNACHAL PRADESH,2009,By Hanging,2,39,22,7,0,70,0,19,13,1,0,33,103
ARUNACHAL PRADESH,2009,By Consuming Insecticides,0,0,0,0,0,0,0,0,0,0,0,0,0
ARUNACHAL PRADESH,2009,By Consuming Other Poison,0,2,1,0,0,3,0,0,0,0,0,0,3
ARUNACHAL PRADESH,2009,By Self Infliction of injury,0,0,0,0,0,0,0,0,0,0,0,0,0
ARUNACHAL PRADESH,2009,By Jumping from (Building),0,1,0,0,0,1,0,0,0,0,0,0,1
ARUNACHAL PRADESH,2009,By Jumping from (Other sites),0,0,0,0,0,0,0,0,0,0,0,0,0
ARUNACHAL PRADESH,2009,By Jumping off Moving Vehicles/Trains,0,0,0,0,0,0,0,0,0,0,0,0,0
ARUNACHAL PRADESH,2009,By Machine,0,0,0,0,0,0,0,0,0,0,0,0,0
ARUNACHAL PRADESH,2009,By Overdose of sleeping pills,0,0,0,0,0,0,0,0,0,0,0,0,0
ARUNACHAL PRADESH,2009,By touching electric wires,0,0,0,0,0,0,0,0,0,0,0,0,0
ARUNACHAL PRADESH,2009,By coming under running vehicles/trains,0,0,0,0,0,0,0,0,0,0,0,0,0
ARUNACHAL PRADESH,2009,By Other means (please specify),0,0,0,0,0,0,0,0,0,0,0,0,0
ARUNACHAL PRADESH,2009,Total,2,43,25,7,0,77,0,19,13,1,0,33,110
ARUNACHAL PRADESH,2009,Total (Poison),0,2,1,0,0,3,0,0,0,0,0,0,3
ARUNACHAL PRADESH,2009,Total (Jumping),0,1,0,0,0,1,0,0,0,0,0,0,1
ARUNACHAL PRADESH,2010,By Over Alcoholism,0,0,0,0,0,0,0,0,0,0,0,0,0
ARUNACHAL PRADESH,2010,By Drowning,0,3,4,1,1,9,0,0,1,0,0,1,10
ARUNACHAL PRADESH,2010,By Fire/Self Immolation,0,0,0,0,0,0,0,0,0,0,0,0,0
ARUNACHAL PRADESH,2010,By Fire-Arms,0,1,0,0,0,1,0,0,0,0,0,0,1
ARUNACHAL PRADESH,2010,By Hanging,3,20,18,2,1,44,2,18,7,2,0,29,73
ARUNACHAL PRADESH,2010,By Consuming Insecticides,0,0,0,0,0,0,0,0,0,0,0,0,0
ARUNACHAL PRADESH,2010,By Consuming Other Poison,0,2,1,0,0,3,0,1,0,0,0,1,4
ARUNACHAL PRADESH,2010,By Self Infliction of injury,0,0,0,0,0,0,0,0,0,0,0,0,0
ARUNACHAL PRADESH,2010,By Jumping from (Building),0,3,0,0,0,3,0,0,0,0,0,0,3
ARUNACHAL PRADESH,2010,By Jumping from (Other sites),0,0,1,0,0,1,0,0,0,0,0,0,1
ARUNACHAL PRADESH,2010,By Jumping off Moving Vehicles/Trains,0,0,0,0,0,0,0,0,0,0,0,0,0
ARUNACHAL PRADESH,2010,By Machine,0,0,0,0,0,0,0,0,0,0,0,0,0
ARUNACHAL PRADESH,2010,By Overdose of sleeping pills,0,0,0,0,0,0,0,0,0,0,0,0,0
ARUNACHAL PRADESH,2010,By touching electric wires,0,0,0,0,0,0,0,0,0,0,0,0,0
ARUNACHAL PRADESH,2010,By coming under running vehicles/trains,0,13,4,0,0,17,2,7,0,0,0,9,26
ARUNACHAL PRADESH,2010,By Other means (please specify),1,5,4,3,0,13,0,0,0,0,0,0,13
ARUNACHAL PRADESH,2010,Total,4,47,32,6,2,91,4,26,8,2,0,40,131
ARUNACHAL PRADESH,2010,Total (Poison),0,2,1,0,0,3,0,1,0,0,0,1,4
ARUNACHAL PRADESH,2010,Total (Jumping),0,3,1,0,0,4,0,0,0,0,0,0,4
ARUNACHAL PRADESH,2011,By Over Alcoholism,0,0,2,1,0,3,0,0,0,0,0,0,3
ARUNACHAL PRADESH,2011,By Drowning,1,4,3,0,0,8,1,0,1,0,0,2,10
ARUNACHAL PRADESH,2011,By Fire/Self Immolation,0,0,1,1,0,2,0,0,0,0,0,0,2
ARUNACHAL PRADESH,2011,By Fire-Arms,0,0,1,1,0,2,0,0,0,0,0,0,2
ARUNACHAL PRADESH,2011,By Hanging,2,30,17,15,1,65,4,17,8,1,1,31,96
ARUNACHAL PRADESH,2011,By Consuming Insecticides,0,0,0,0,0,0,0,0,0,0,0,0,0
ARUNACHAL PRADESH,2011,By Consuming Other Poison,0,1,3,0,0,4,0,1,0,0,0,1,5
ARUNACHAL PRADESH,2011,By Self Infliction of injury,0,0,0,0,1,1,0,0,0,0,0,0,1
ARUNACHAL PRADESH,2011,By Jumping from (Building),1,0,0,0,0,1,0,0,0,0,0,0,1
ARUNACHAL PRADESH,2011,By Jumping from (Other sites),0,2,1,0,0,3,0,1,0,0,0,1,4
ARUNACHAL PRADESH,2011,By Jumping off Moving Vehicles/Trains,0,0,0,0,0,0,0,0,0,0,0,0,0
ARUNACHAL PRADESH,2011,By Machine,0,0,0,0,0,0,0,0,0,0,0,0,0
ARUNACHAL PRADESH,2011,By Overdose of sleeping pills,0,0,0,0,0,0,0,0,0,0,0,0,0
ARUNACHAL PRADESH,2011,By touching electric wires,0,0,4,1,0,5,0,0,0,0,0,0,5
ARUNACHAL PRADESH,2011,By coming under running vehicles/trains,0,0,0,0,0,0,0,0,0,0,0,0,0
ARUNACHAL PRADESH,2011,By Other means (please specify),0,1,2,1,1,5,0,0,0,0,0,0,5
ARUNACHAL PRADESH,2011,Total,4,38,34,20,3,99,5,19,9,1,1,35,134
ARUNACHAL PRADESH,2011,Total (Poison),0,1,3,0,1,5,0,1,0,0,0,1,6
ARUNACHAL PRADESH,2011,Total (Jumping),1,2,1,0,0,4,0,1,0,0,0,1,5
ARUNACHAL PRADESH,2012,By Over Alcoholism,0,1,3,1,0,5,0,1,0,0,0,1,6
ARUNACHAL PRADESH,2012,By Drowning,1,5,3,2,0,11,0,2,1,0,0,3,14
ARUNACHAL PRADESH,2012,By Fire/Self Immolation,0,0,0,0,0,0,0,1,0,0,0,1,1
ARUNACHAL PRADESH,2012,By Fire-Arms,0,0,1,0,0,1,0,0,0,0,0,0,1
ARUNACHAL PRADESH,2012,By Hanging,0,15,25,20,1,61,0,12,7,1,0,20,81
ARUNACHAL PRADESH,2012,By Consuming Insecticides,0,3,1,1,0,5,0,2,0,0,0,2,7
ARUNACHAL PRADESH,2012,By Consuming Other Poison,0,0,0,0,0,0,0,1,0,0,0,1,1
ARUNACHAL PRADESH,2012,By Self Infliction of injury,0,0,0,0,0,0,0,0,0,0,0,0,0
ARUNACHAL PRADESH,2012,By Jumping from (Building),0,0,0,0,0,0,0,0,0,0,0,0,0
ARUNACHAL PRADESH,2012,By Jumping from (Other sites),0,0,0,0,0,0,0,0,0,0,0,0,0
ARUNACHAL PRADESH,2012,By Jumping off Moving Vehicles/Trains,0,0,0,0,0,0,0,0,0,0,0,0,0
ARUNACHAL PRADESH,2012,By Machine,0,0,0,0,0,0,0,0,0,0,0,0,0
ARUNACHAL PRADESH,2012,By Overdose of sleeping pills,0,0,0,0,0,0,0,0,0,0,0,0,0
ARUNACHAL PRADESH,2012,By touching electric wires,0,0,0,0,0,0,0,0,0,0,0,0,0
ARUNACHAL PRADESH,2012,By coming under running vehicles/trains,0,0,0,0,0,0,0,0,0,0,0,0,0
ARUNACHAL PRADESH,2012,By Other means (please specify),0,4,6,7,0,17,0,1,1,0,0,2,19
ARUNACHAL PRADESH,2012,Total,1,28,39,31,1,100,0,20,9,1,0,30,130
ARUNACHAL PRADESH,2012,Total (Poison),0,3,1,1,0,5,0,3,0,0,0,3,8
ARUNACHAL PRADESH,2012,Total (Jumping),0,0,0,0,0,0,0,0,0,0,0,0,0
ASSAM,2001,By Over Alcoholism,1,5,7,3,0,16,0,15,10,0,0,25,41
ASSAM,2001,By Drowning,12,46,63,37,15,173,9,30,28,20,3,90,263
ASSAM,2001,By Fire/Self Immolation,0,2,3,1,0,6,0,0,0,0,0,0,6
ASSAM,2001,By Fire-Arms,0,0,2,0,0,2,0,0,0,0,0,0,2
ASSAM,2001,By Hanging,6,309,359,226,27,927,3,182,109,53,5,352,1279
ASSAM,2001,By Consuming Insecticides,0,15,1,2,0,18,2,13,3,4,0,22,40
ASSAM,2001,By Consuming Other Poison,5,114,130,55,12,316,2,96,82,24,4,208,524
ASSAM,2001,By Self Infliction of injury,0,0,0,0,0,0,0,0,1,2,0,3,3
ASSAM,2001,By Jumping from (Building),0,1,0,1,0,2,0,0,0,0,0,0,2
ASSAM,2001,By Jumping from (Other sites),0,1,0,0,0,1,0,0,0,0,0,0,1
ASSAM,2001,By Jumping off Moving Vehicles/Trains,0,29,34,17,2,82,1,8,6,5,1,21,103
ASSAM,2001,By Machine,0,0,1,0,0,1,0,0,0,0,0,0,1
ASSAM,2001,By Overdose of sleeping pills,0,0,0,1,0,1,0,0,0,0,0,0,1
ASSAM,2001,By touching electric wires,1,21,26,11,0,59,0,6,3,0,0,9,68
ASSAM,2001,By coming under running vehicles/trains,0,1,3,2,0,6,0,0,0,0,0,0,6
ASSAM,2001,By Other means (please specify),10,76,73,62,5,226,2,33,32,11,3,81,307
ASSAM,2001,Total,35,620,702,418,61,1836,19,383,274,119,16,811,2647
ASSAM,2001,Total (Poison),5,129,131,57,12,334,4,109,86,30,4,233,567
ASSAM,2001,Total (Jumping),0,2,0,1,0,3,0,0,0,0,0,0,3
ASSAM,2002,By Over Alcoholism,0,1,2,0,0,3,0,0,0,0,0,0,3
ASSAM,2002,By Drowning,5,70,49,37,3,164,9,30,27,15,4,85,249
ASSAM,2002,By Fire/Self Immolation,0,8,12,5,0,25,1,18,21,1,4,45,70
ASSAM,2002,By Fire-Arms,0,0,2,0,0,2,0,0,0,0,0,0,2
ASSAM,2002,By Hanging,10,263,360,188,28,849,5,176,129,50,6,366,1215
ASSAM,2002,By Consuming Insecticides,2,18,17,2,0,39,1,13,5,0,0,19,58
ASSAM,2002,By Consuming Other Poison,2,113,128,85,11,339,6,114,65,30,6,221,560
ASSAM,2002,By Self Infliction of injury,0,0,0,1,1,2,0,0,1,1,0,2,4
ASSAM,2002,By Jumping from (Building),0,0,0,0,0,0,0,0,0,0,0,0,0
ASSAM,2002,By Jumping from (Other sites),0,5,1,2,0,8,0,0,0,0,0,0,8
ASSAM,2002,By Jumping off Moving Vehicles/Trains,1,6,8,2,2,19,0,2,2,2,0,6,25
ASSAM,2002,By Machine,0,0,0,0,0,0,0,0,0,0,0,0,0
ASSAM,2002,By Overdose of sleeping pills,0,0,0,0,0,0,0,0,0,0,0,0,0
ASSAM,2002,By touching electric wires,0,14,11,6,0,31,0,0,1,0,0,1,32
ASSAM,2002,By coming under running vehicles/trains,0,10,27,9,1,47,0,3,6,2,0,11,58
ASSAM,2002,By Other means,3,56,63,44,8,174,2,20,18,7,5,52,226
ASSAM,2002,Total,23,564,680,381,54,1702,24,376,275,108,25,808,2510
ASSAM,2002,Total (Poison),4,131,145,88,12,380,7,127,71,31,6,242,622
ASSAM,2002,Total (Jumping),0,5,1,2,0,8,0,0,0,0,0,0,8
ASSAM,2003,By Over Alcoholism,0,0,11,15,3,29,0,0,0,0,0,0,29
ASSAM,2003,By Drowning,19,108,55,46,4,232,14,89,24,13,8,148,380
ASSAM,2003,By Fire/Self Immolation,2,16,9,14,0,41,0,22,15,7,0,44,85
ASSAM,2003,By Fire-Arms,0,5,7,1,0,13,0,0,0,0,0,0,13
ASSAM,2003,By Hanging,13,281,268,128,30,720,14,220,97,46,11,388,1108
ASSAM,2003,By Consuming Insecticides,3,19,11,1,0,34,2,9,1,0,0,12,46
ASSAM,2003,By Consuming Other Poison,10,79,80,35,3,207,11,90,45,10,1,157,364
ASSAM,2003,By Self Infliction of injury,0,0,0,0,0,0,0,0,0,0,0,0,0
ASSAM,2003,By Jumping from (Building),0,7,3,0,0,10,0,9,2,0,0,11,21
ASSAM,2003,By Jumping from (Other sites),1,3,3,7,0,14,2,2,1,2,0,7,21
ASSAM,2003,By Jumping off Moving Vehicles/Trains,0,1,5,5,1,12,0,1,0,1,0,2,14
ASSAM,2003,By Machine,0,0,2,4,0,6,0,0,0,0,0,0,6
ASSAM,2003,By Overdose of sleeping pills,0,0,0,0,0,0,0,0,0,0,0,0,0
ASSAM,2003,By touching electric wires,1,10,7,4,2,24,0,0,4,1,1,6,30
ASSAM,2003,By coming under running vehicles/trains,1,25,25,14,1,66,0,8,8,4,2,22,88
ASSAM,2003,By Other means (please specify),11,117,71,49,20,268,5,62,28,17,11,123,391
ASSAM,2003,Total,61,671,557,323,64,1676,48,512,225,101,34,920,2596
ASSAM,2003,Total (Poison),13,98,91,36,3,241,13,99,46,10,1,169,410
ASSAM,2003,Total (Jumping),1,10,6,7,0,24,2,11,3,2,0,18,42
ASSAM,2004,By Over Alcoholism,0,1,2,1,2,6,0,0,0,0,0,0,6
ASSAM,2004,By Drowning,13,79,117,66,5,280,8,53,42,19,2,124,404
ASSAM,2004,By Fire/Self Immolation,2,11,14,3,1,31,0,17,14,2,0,33,64
ASSAM,2004,By Fire-Arms,0,1,5,3,0,9,0,0,0,0,0,0,9
ASSAM,2004,By Hanging,16,344,359,192,45,956,5,219,156,55,8,443,1399
ASSAM,2004,By Consuming Insecticides,0,5,2,1,1,9,0,8,1,3,0,12,21
ASSAM,2004,By Consuming Other Poison,6,112,131,48,3,300,3,93,55,20,3,174,474
ASSAM,2004,By Self Infliction of injury,0,6,3,0,0,9,0,2,2,0,0,4,13
ASSAM,2004,By Jumping from (Building),0,3,1,1,0,5,0,1,2,0,0,3,8
ASSAM,2004,By Jumping from (Other sites),2,20,22,1,0,45,0,2,5,2,0,9,54
ASSAM,2004,By Jumping off Moving Vehicles/Trains,0,5,11,4,0,20,0,1,0,0,0,1,21
ASSAM,2004,By Machine,0,4,2,5,1,12,0,0,1,2,0,3,15
ASSAM,2004,By Overdose of sleeping pills,0,0,0,0,0,0,0,1,1,0,0,2,2
ASSAM,2004,By touching electric wires,0,13,12,10,1,36,0,4,0,1,0,5,41
ASSAM,2004,By coming under running vehicles/trains,0,33,19,15,0,67,1,11,5,2,0,19,86
ASSAM,2004,By Other means (please specify),2,54,64,27,13,160,1,34,12,14,1,62,222
ASSAM,2004,Total,41,691,764,377,72,1945,18,446,296,120,14,894,2839
ASSAM,2004,Total (Poison),6,123,136,49,4,318,3,103,58,23,3,190,508
ASSAM,2004,Total (Jumping),2,23,23,2,0,50,0,3,7,2,0,12,62
ASSAM,2005,By Over Alcoholism,0,1,6,4,0,11,0,0,0,0,0,0,11
ASSAM,2005,By Drowning,14,63,84,51,10,222,5,60,41,11,5,122,344
ASSAM,2005,By Fire/Self Immolation,0,0,3,4,1,8,3,4,6,0,0,13,21
ASSAM,2005,By Fire-Arms,0,0,1,0,0,1,0,0,0,0,0,0,1
ASSAM,2005,By Hanging,7,377,375,172,42,973,14,225,137,68,9,453,1426
ASSAM,2005,By Consuming Insecticides,0,1,1,0,0,2,1,0,1,0,0,2,4
ASSAM,2005,By Consuming Other Poison,6,88,99,84,10,287,6,85,68,14,2,175,462
ASSAM,2005,By Self Infliction of injury,0,9,10,6,0,25,1,2,5,2,0,10,35
ASSAM,2005,By Jumping from (Building),0,1,2,1,0,4,0,2,0,0,0,2,6
ASSAM,2005,By Jumping from (Other sites),0,4,6,2,0,12,0,1,1,1,0,3,15
ASSAM,2005,By Jumping off Moving Vehicles/Trains,0,9,18,4,0,31,0,2,2,2,0,6,37
ASSAM,2005,By Machine,0,1,2,0,0,3,0,0,1,0,0,1,4
ASSAM,2005,By Overdose of sleeping pills,0,0,0,0,0,0,0,0,0,0,0,0,0
ASSAM,2005,By touching electric wires,1,19,19,8,0,47,2,2,5,2,0,11,58
ASSAM,2005,By coming under running vehicles/trains,0,15,32,19,5,71,0,6,5,5,2,18,89
ASSAM,2005,By Other means (please specify),8,55,133,53,5,254,5,36,27,11,0,79,333
ASSAM,2005,Total,36,643,791,408,73,1951,37,425,299,116,18,895,2846
ASSAM,2005,Total (Poison),6,98,110,90,10,314,8,87,74,16,2,187,501
ASSAM,2005,Total (Jumping),0,5,8,3,0,16,0,3,1,1,0,5,21
ASSAM,2006,By Over Alcoholism,0,7,3,5,3,18,0,0,1,1,0,2,20
ASSAM,2006,By Drowning,15,110,70,38,9,242,5,40,30,6,2,83,325
ASSAM,2006,By Fire/Self Immolation,0,12,12,7,1,32,0,22,32,11,3,68,100
ASSAM,2006,By Fire-Arms,0,4,4,0,0,8,0,0,0,0,0,0,8
ASSAM,2006,By Hanging,7,322,462,192,42,1025,11,189,147,35,4,386,1411
ASSAM,2006,By Consuming Insecticides,0,5,6,1,0,12,0,5,3,0,0,8,20
ASSAM,2006,By Consuming Other Poison,8,162,158,74,6,408,9,100,80,30,3,222,630
ASSAM,2006,By Self Infliction of injury,0,0,0,0,0,0,0,0,0,0,0,0,0
ASSAM,2006,By Jumping from (Building),0,1,3,1,0,5,0,0,3,2,0,5,10
ASSAM,2006,By Jumping from (Other sites),0,7,1,2,0,10,0,0,1,2,0,3,13
ASSAM,2006,By Jumping off Moving Vehicles/Trains,0,15,23,16,0,54,1,0,3,2,0,6,60
ASSAM,2006,By Machine,0,0,0,5,0,5,0,0,0,1,0,1,6
ASSAM,2006,By Overdose of sleeping pills,0,3,3,0,1,7,0,0,0,0,1,1,8
ASSAM,2006,By touching electric wires,2,13,9,8,0,32,1,4,5,0,0,10,42
ASSAM,2006,By coming under running vehicles/trains,1,10,17,8,0,36,1,3,8,5,1,18,54
ASSAM,2006,By Other means (please specify),11,82,82,28,19,222,4,50,35,12,1,102,324
ASSAM,2006,Total,44,753,853,385,81,2116,32,413,348,107,15,915,3031
ASSAM,2006,Total (Poison),8,167,164,75,6,420,9,105,83,30,3,230,650
ASSAM,2006,Total (Jumping),0,8,4,3,0,15,0,0,4,4,0,8,23
ASSAM,2007,By Over Alcoholism,0,3,0,0,0,3,0,0,0,0,0,0,3
ASSAM,2007,By Drowning,10,73,99,67,6,255,7,34,23,9,1,74,329
ASSAM,2007,By Fire/Self Immolation,0,7,8,3,0,18,2,28,15,6,2,53,71
ASSAM,2007,By Fire-Arms,0,0,2,1,0,3,0,0,0,0,0,0,3
ASSAM,2007,By Hanging,16,337,392,262,31,1038,8,173,135,48,9,373,1411
ASSAM,2007,By Consuming Insecticides,1,12,15,6,1,35,2,14,8,1,0,25,60
ASSAM,2007,By Consuming Other Poison,3,148,121,63,8,343,7,107,96,26,4,240,583
ASSAM,2007,By Self Infliction of injury,0,0,0,1,0,1,0,1,0,0,0,1,2
ASSAM,2007,By Jumping from (Building),0,1,0,1,0,2,0,0,0,0,1,1,3
ASSAM,2007,By Jumping from (Other sites),0,5,0,3,0,8,0,0,0,0,0,0,8
ASSAM,2007,By Jumping off Moving Vehicles/Trains,0,4,15,5,0,24,0,3,2,1,0,6,30
ASSAM,2007,By Machine,0,0,0,0,0,0,0,0,0,0,0,0,0
ASSAM,2007,By Overdose of sleeping pills,0,0,0,0,0,0,0,0,0,0,0,0,0
ASSAM,2007,By touching electric wires,2,11,4,12,0,29,0,2,1,0,0,3,32
ASSAM,2007,By coming under running vehicles/trains,1,6,15,11,3,36,0,4,0,2,2,8,44
ASSAM,2007,By Other means (please specify),5,97,128,72,19,321,7,61,51,27,16,162,483
ASSAM,2007,Total,38,704,799,507,68,2116,33,427,331,120,35,946,3062
ASSAM,2007,Total (Poison),4,160,136,70,9,379,9,122,104,27,4,266,645
ASSAM,2007,Total (Jumping),0,6,0,4,0,10,0,0,0,0,1,1,11
ASSAM,2008,By Over Alcoholism,0,0,0,2,0,2,0,7,12,5,0,24,26
ASSAM,2008,By Drowning,5,69,101,57,7,239,3,58,52,14,2,129,368
ASSAM,2008,By Fire/Self Immolation,0,10,7,2,0,19,0,13,8,1,0,22,41
ASSAM,2008,By Fire-Arms,0,3,3,0,0,6,0,0,0,0,0,0,6
ASSAM,2008,By Hanging,10,332,326,191,19,878,4,206,119,44,5,378,1256
ASSAM,2008,By Consuming Insecticides,0,19,16,2,0,37,1,12,19,4,0,36,73
ASSAM,2008,By Consuming Other Poison,5,135,127,43,7,317,4,116,92,21,5,238,555
ASSAM,2008,By Self Infliction of injury,0,3,4,1,0,8,0,1,1,0,0,2,10
ASSAM,2008,By Jumping from (Building),0,3,0,0,0,3,0,2,0,1,0,3,6
ASSAM,2008,By Jumping from (Other sites),0,10,0,4,2,16,0,4,0,2,0,6,22
ASSAM,2008,By Jumping off Moving Vehicles/Trains,0,4,2,8,1,15,0,2,4,0,0,6,21
ASSAM,2008,By Machine,0,0,1,1,0,2,0,0,0,0,0,0,2
ASSAM,2008,By Overdose of sleeping pills,0,0,1,0,0,1,0,1,0,0,0,1,2
ASSAM,2008,By touching electric wires,2,23,19,5,0,49,0,4,3,4,1,12,61
ASSAM,2008,By coming under running vehicles/trains,0,10,19,11,2,42,0,10,7,0,1,18,60
ASSAM,2008,By Other means (please specify),6,95,146,71,18,336,5,67,43,24,5,144,480
ASSAM,2008,Total,28,716,772,398,56,1970,17,503,360,120,19,1019,2989
ASSAM,2008,Total (Poison),5,157,147,46,7,362,5,129,112,25,5,276,638
ASSAM,2008,Total (Jumping),0,13,0,4,2,19,0,6,0,3,0,9,28
ASSAM,2009,By Over Alcoholism,0,1,3,0,0,4,0,0,0,0,0,0,4
ASSAM,2009,By Drowning,1,42,63,39,5,150,0,21,28,22,1,72,222
ASSAM,2009,By Fire/Self Immolation,0,13,13,1,0,27,0,57,26,11,4,98,125
ASSAM,2009,By Fire-Arms,0,0,2,1,0,3,0,0,0,0,0,0,3
ASSAM,2009,By Hanging,11,353,370,223,32,989,11,228,179,71,13,502,1491
ASSAM,2009,By Consuming Insecticides,1,9,9,2,1,22,0,6,4,2,0,12,34
ASSAM,2009,By Consuming Other Poison,9,144,101,43,3,300,10,151,55,22,3,241,541
ASSAM,2009,By Self Infliction of injury,0,2,0,0,0,2,0,0,0,0,0,0,2
ASSAM,2009,By Jumping from (Building),0,3,0,0,0,3,0,3,0,2,0,5,8
ASSAM,2009,By Jumping from (Other sites),0,2,6,4,1,13,0,0,2,2,0,4,17
ASSAM,2009,By Jumping off Moving Vehicles/Trains,0,7,19,8,0,34,0,2,6,10,0,18,52
ASSAM,2009,By Machine,0,0,0,1,0,1,0,0,0,0,0,0,1
ASSAM,2009,By Overdose of sleeping pills,0,0,0,0,0,0,0,0,0,0,0,0,0
ASSAM,2009,By touching electric wires,3,9,16,16,3,47,0,8,11,14,0,33,80
ASSAM,2009,By coming under running vehicles/trains,0,1,14,8,1,24,0,7,1,6,0,14,38
ASSAM,2009,By Other means (please specify),2,69,96,79,17,263,3,31,28,18,5,85,348
ASSAM,2009,Total,27,655,712,425,63,1882,24,514,340,180,26,1084,2966
ASSAM,2009,Total (Poison),10,155,110,45,4,324,10,157,59,24,3,253,577
ASSAM,2009,Total (Jumping),0,5,6,4,1,16,0,3,2,4,0,9,25
ASSAM,2010,By Over Alcoholism,0,1,1,0,0,2,0,0,0,0,0,0,2
ASSAM,2010,By Drowning,10,72,71,53,9,215,4,21,31,16,2,74,289
ASSAM,2010,By Fire/Self Immolation,0,12,13,2,1,28,1,47,26,4,2,80,108
ASSAM,2010,By Fire-Arms,0,1,2,2,0,5,0,0,0,0,0,0,5
ASSAM,2010,By Hanging,15,381,389,251,43,1079,13,220,139,51,9,432,1511
ASSAM,2010,By Consuming Insecticides,0,9,3,6,0,18,0,14,9,1,0,24,42
ASSAM,2010,By Consuming Other Poison,4,161,121,69,7,362,9,147,59,24,5,244,606
ASSAM,2010,By Self Infliction of injury,0,2,4,1,0,7,0,0,1,0,0,1,8
ASSAM,2010,By Jumping from (Building),0,3,3,0,0,6,0,3,2,0,0,5,11
ASSAM,2010,By Jumping from (Other sites),0,11,7,5,0,23,2,0,0,0,0,2,25
ASSAM,2010,By Jumping off Moving Vehicles/Trains,0,13,17,4,0,34,0,2,1,2,0,5,39
ASSAM,2010,By Machine,0,0,0,1,0,1,0,0,0,0,0,0,1
ASSAM,2010,By Overdose of sleeping pills,0,0,0,0,0,0,0,2,0,0,0,2,2
ASSAM,2010,By touching electric wires,2,13,18,9,2,44,0,3,11,15,0,29,73
ASSAM,2010,By coming under running vehicles/trains,1,22,25,17,1,66,0,5,6,7,0,18,84
ASSAM,2010,By Other means (please specify),2,44,61,22,7,136,3,25,17,2,4,51,187
ASSAM,2010,Total,34,745,735,442,70,2026,32,489,302,122,22,967,2993
ASSAM,2010,Total (Poison),4,172,128,76,7,387,9,161,69,25,5,269,656
ASSAM,2010,Total (Jumping),0,14,10,5,0,29,2,3,2,0,0,7,36
ASSAM,2011,By Over Alcoholism,0,3,3,1,0,7,0,0,1,0,0,1,8
ASSAM,2011,By Drowning,4,40,54,47,3,148,1,28,19,11,0,59,207
ASSAM,2011,By Fire/Self Immolation,0,9,9,5,1,24,1,31,18,14,1,65,89
ASSAM,2011,By Fire-Arms,0,2,0,3,0,5,0,0,0,0,0,0,5
ASSAM,2011,By Hanging,8,403,369,243,31,1054,2,209,166,59,8,444,1498
ASSAM,2011,By Consuming Insecticides,1,9,11,2,0,23,1,19,19,5,0,44,67
ASSAM,2011,By Consuming Other Poison,3,121,133,52,4,313,5,80,86,25,2,198,511
ASSAM,2011,By Self Infliction of injury,0,1,3,0,0,4,0,2,0,1,0,3,7
ASSAM,2011,By Jumping from (Building),0,6,6,4,0,16,0,2,0,0,0,2,18
ASSAM,2011,By Jumping from (Other sites),0,0,0,0,0,0,0,0,1,0,0,1,1
ASSAM,2011,By Jumping off Moving Vehicles/Trains,0,8,8,4,0,20,0,3,5,0,0,8,28
ASSAM,2011,By Machine,0,1,0,0,0,1,0,0,0,0,0,0,1
ASSAM,2011,By Overdose of sleeping pills,0,5,5,1,0,11,0,2,0,0,0,2,13
ASSAM,2011,By touching electric wires,0,10,14,2,0,26,0,5,3,0,0,8,34
ASSAM,2011,By coming under running vehicles/trains,0,22,19,10,1,52,0,8,10,3,0,21,73
ASSAM,2011,By Other means (please specify),4,27,52,34,5,122,0,21,13,8,2,44,166
ASSAM,2011,Total,20,667,686,408,45,1826,10,410,341,126,13,900,2726
ASSAM,2011,Total (Poison),4,131,147,54,4,340,6,101,105,31,2,245,585
ASSAM,2011,Total (Jumping),0,6,6,4,0,16,0,2,1,0,0,3,19
ASSAM,2012,By Over Alcoholism,0,6,10,5,3,24,1,1,0,0,0,2,26
ASSAM,2012,By Drowning,3,61,72,39,6,181,2,31,30,17,2,82,263
ASSAM,2012,By Fire/Self Immolation,0,13,17,8,0,38,0,16,16,4,0,36,74
ASSAM,2012,By Fire-Arms,0,0,3,4,0,7,0,0,0,0,0,0,7
ASSAM,2012,By Hanging,13,388,594,342,34,1371,5,199,163,72,3,442,1813
ASSAM,2012,By Consuming Insecticides,0,9,10,2,0,21,0,11,16,9,0,36,57
ASSAM,2012,By Consuming Other Poison,2,70,82,51,3,208,2,60,63,24,1,150,358
ASSAM,2012,By Self Infliction of injury,0,8,9,0,0,17,0,1,0,0,0,1,18
ASSAM,2012,By Jumping from (Building),1,5,2,1,0,9,0,2,0,0,0,2,11
ASSAM,2012,By Jumping from (Other sites),2,11,6,3,0,22,0,0,0,0,1,1,23
ASSAM,2012,By Jumping off Moving Vehicles/Trains,0,17,24,6,2,49,0,3,2,0,0,5,54
ASSAM,2012,By Machine,0,2,0,2,0,4,0,0,0,0,0,0,4
ASSAM,2012,By Overdose of sleeping pills,0,2,10,11,0,23,0,0,0,0,0,0,23
ASSAM,2012,By touching electric wires,2,26,29,29,0,86,0,3,4,2,0,9,95
ASSAM,2012,By coming under running vehicles/trains,0,19,21,22,0,62,0,4,2,2,0,8,70
ASSAM,2012,By Other means (please specify),14,58,94,102,2,270,6,31,26,33,2,98,368
ASSAM,2012,Total,37,695,983,627,50,2392,16,362,322,163,9,872,3264
ASSAM,2012,Total (Poison),2,87,101,53,3,246,2,72,79,33,1,187,433
ASSAM,2012,Total (Jumping),3,16,8,4,0,31,0,2,0,0,1,3,34
BIHAR,2001,By Over Alcoholism,0,2,2,0,0,4,0,0,0,0,0,0,4
BIHAR,2001,By Drowning,1,6,9,2,0,18,1,5,5,1,0,12,30
BIHAR,2001,By Fire/Self Immolation,0,7,4,1,1,13,0,39,13,1,0,53,66
BIHAR,2001,By Fire-Arms,0,0,1,0,0,1,0,5,1,1,0,7,8
BIHAR,2001,By Hanging,1,14,23,4,3,45,1,23,23,4,2,53,98
BIHAR,2001,By Consuming Insecticides,0,12,11,0,0,23,2,18,12,5,1,38,61
BIHAR,2001,By Consuming Other Poison,3,42,27,5,3,80,8,35,14,7,2,66,146
BIHAR,2001,By Self Infliction of injury,0,0,0,0,0,0,0,0,1,0,0,1,1
BIHAR,2001,By Jumping from (Building),0,0,0,0,0,0,0,0,0,0,0,0,0
BIHAR,2001,By Jumping from (Other sites),0,0,5,2,0,7,0,1,1,1,0,3,10
BIHAR,2001,By Jumping off Moving Vehicles/Trains,0,1,0,0,0,1,0,0,0,0,0,0,1
BIHAR,2001,By Machine,0,0,0,0,0,0,0,0,0,0,0,0,0
BIHAR,2001,By Overdose of sleeping pills,0,1,0,1,0,2,0,1,0,0,0,1,3
BIHAR,2001,By touching electric wires,0,4,15,0,0,19,0,1,0,0,0,1,20
BIHAR,2001,By coming under running vehicles/trains,0,1,2,0,0,3,0,0,0,0,0,0,3
BIHAR,2001,By Other means (please specify),3,41,22,16,9,91,2,25,24,7,3,61,152
BIHAR,2001,Total,8,131,121,31,16,307,14,153,94,27,8,296,603
BIHAR,2001,Total (Poison),3,54,38,5,3,103,10,53,27,12,3,105,208
BIHAR,2001,Total (Jumping),0,0,5,2,0,7,0,1,1,1,0,3,10
BIHAR,2002,By Over Alcoholism,0,3,4,5,1,13,0,0,0,1,0,1,14
BIHAR,2002,By Drowning,6,10,3,3,1,23,0,1,4,0,0,5,28
BIHAR,2002,By Fire/Self Immolation,0,7,5,14,0,26,3,32,17,4,0,56,82
BIHAR,2002,By Fire-Arms,0,4,9,0,0,13,0,0,1,0,0,1,14
BIHAR,2002,By Hanging,3,20,42,6,1,72,2,29,21,6,1,59,131
BIHAR,2002,By Consuming Insecticides,2,11,31,8,3,55,0,25,13,8,1,47,102
BIHAR,2002,By Consuming Other Poison,5,42,32,10,4,93,1,29,23,8,1,62,155
BIHAR,2002,By Self Infliction of injury,0,4,4,2,0,10,0,0,1,0,0,1,11
BIHAR,2002,By Jumping from (Building),0,1,1,0,0,2,0,0,3,0,0,3,5
BIHAR,2002,By Jumping from (Other sites),0,0,0,3,0,3,0,0,1,0,0,1,4
BIHAR,2002,By Jumping off Moving Vehicles/Trains,0,2,0,2,0,4,0,1,0,0,0,1,5
BIHAR,2002,By Machine,0,1,0,0,0,1,0,0,0,0,0,0,1
BIHAR,2002,By Overdose of sleeping pills,0,1,1,0,0,2,1,0,1,4,0,6,8
BIHAR,2002,By touching electric wires,0,10,2,4,0,16,0,0,3,0,0,3,19
BIHAR,2002,By coming under running vehicles/trains,0,1,3,1,0,5,0,1,0,0,0,1,6
BIHAR,2002,By Other means,7,40,25,10,6,88,6,27,8,4,2,47,135
BIHAR,2002,Total,23,157,162,68,16,426,13,145,96,35,5,294,720
BIHAR,2002,Total (Poison),7,57,67,20,7,158,1,54,37,16,2,110,268
BIHAR,2002,Total (Jumping),0,1,1,3,0,5,0,0,4,0,0,4,9
BIHAR,2003,By Over Alcoholism,0,4,1,2,4,11,0,0,0,0,0,0,11
BIHAR,2003,By Drowning,5,6,9,7,1,28,1,2,4,0,1,8,36
BIHAR,2003,By Fire/Self Immolation,5,5,5,6,0,21,3,22,19,1,0,45,66
BIHAR,2003,By Fire-Arms,1,3,1,1,0,6,0,0,2,0,0,2,8
BIHAR,2003,By Hanging,6,11,14,5,1,37,2,29,11,1,0,43,80
BIHAR,2003,By Consuming Insecticides,12,22,13,7,0,54,3,17,9,1,0,30,84
BIHAR,2003,By Consuming Other Poison,9,37,21,7,0,74,1,20,21,1,1,44,118
BIHAR,2003,By Self Infliction of injury,0,0,2,0,0,2,0,0,0,0,1,1,3
BIHAR,2003,By Jumping from (Building),0,0,0,1,0,1,0,3,2,0,0,5,6
BIHAR,2003,By Jumping from (Other sites),0,1,1,2,0,4,0,0,2,0,0,2,6
BIHAR,2003,By Jumping off Moving Vehicles/Trains,0,4,0,0,1,5,0,1,1,0,1,3,8
BIHAR,2003,By Machine,0,1,0,0,0,1,0,0,0,0,0,0,1
BIHAR,2003,By Overdose of sleeping pills,0,2,0,0,1,3,0,1,2,1,0,4,7
BIHAR,2003,By touching electric wires,1,1,5,2,0,9,0,2,1,0,0,3,12
BIHAR,2003,By coming under running vehicles/trains,0,1,1,1,1,4,0,3,1,0,0,4,8
BIHAR,2003,By Other means (please specify),10,37,31,10,3,91,5,27,15,7,0,54,145
BIHAR,2003,Total,49,135,104,51,12,351,15,127,90,12,4,248,599
BIHAR,2003,Total (Poison),21,59,36,14,0,130,4,37,30,2,2,75,205
BIHAR,2003,Total (Jumping),0,1,1,3,0,5,0,3,4,0,0,7,12
BIHAR,2004,By Over Alcoholism,0,0,3,1,0,4,0,0,0,0,0,0,4
BIHAR,2004,By Drowning,2,9,5,2,1,19,2,3,3,0,0,8,27
BIHAR,2004,By Fire/Self Immolation,0,1,4,2,1,8,1,8,8,2,1,20,28
BIHAR,2004,By Fire-Arms,0,2,2,1,0,5,0,0,0,0,0,0,5
BIHAR,2004,By Hanging,2,11,10,6,1,30,1,15,6,2,0,24,54
BIHAR,2004,By Consuming Insecticides,1,11,12,3,2,29,1,15,12,4,1,33,62
BIHAR,2004,By Consuming Other Poison,1,18,19,4,0,42,1,6,8,5,0,20,62
BIHAR,2004,By Self Infliction of injury,1,4,3,1,0,9,0,0,0,0,0,0,9
BIHAR,2004,By Jumping from (Building),0,0,0,0,0,0,0,0,0,0,0,0,0
BIHAR,2004,By Jumping from (Other sites),0,0,0,0,0,0,0,0,0,0,0,0,0
BIHAR,2004,By Jumping off Moving Vehicles/Trains,0,0,0,0,0,0,0,0,0,0,0,0,0
BIHAR,2004,By Machine,0,0,0,0,0,0,0,0,0,0,0,0,0
BIHAR,2004,By Overdose of sleeping pills,0,1,1,0,0,2,0,0,1,0,0,1,3
BIHAR,2004,By touching electric wires,1,0,1,2,0,4,0,2,0,0,0,2,6
BIHAR,2004,By coming under running vehicles/trains,0,1,0,1,0,2,0,0,2,0,0,2,4
BIHAR,2004,By Other means (please specify),8,17,16,7,10,58,3,10,11,1,4,29,87
BIHAR,2004,Total,16,75,76,30,15,212,9,59,51,14,6,139,351
BIHAR,2004,Total (Poison),3,33,34,8,2,80,2,21,20,9,1,53,133
BIHAR,2004,Total (Jumping),0,0,0,0,0,0,0,0,0,0,0,0,0
BIHAR,2005,By Over Alcoholism,0,4,7,3,0,14,0,0,0,0,0,0,14
BIHAR,2005,By Drowning,2,12,6,3,1,24,0,9,4,3,0,16,40
BIHAR,2005,By Fire/Self Immolation,0,9,1,1,1,12,0,6,16,3,0,25,37
BIHAR,2005,By Fire-Arms,0,0,6,0,0,6,0,0,0,0,0,0,6
BIHAR,2005,By Hanging,0,20,12,2,4,38,0,17,7,2,0,26,64
BIHAR,2005,By Consuming Insecticides,0,23,12,6,1,42,0,19,19,5,1,44,86
BIHAR,2005,By Consuming Other Poison,1,21,8,5,0,35,1,20,6,3,2,32,67
BIHAR,2005,By Self Infliction of injury,0,1,0,0,1,2,0,0,0,0,0,0,2
BIHAR,2005,By Jumping from (Building),0,2,8,0,0,10,0,0,0,0,0,0,10
BIHAR,2005,By Jumping from (Other sites),1,2,8,0,0,11,1,1,1,0,0,3,14
BIHAR,2005,By Jumping off Moving Vehicles/Trains,0,0,0,0,0,0,0,0,0,0,0,0,0
BIHAR,2005,By Machine,0,0,1,0,0,1,0,0,0,0,0,0,1
BIHAR,2005,By Overdose of sleeping pills,0,0,1,3,0,4,0,0,0,0,0,0,4
BIHAR,2005,By touching electric wires,1,6,6,3,0,16,0,1,1,0,1,3,19
BIHAR,2005,By coming under running vehicles/trains,0,1,2,0,0,3,0,2,0,0,0,2,5
BIHAR,2005,By Other means (please specify),9,22,28,44,6,109,3,29,23,7,3,65,174
BIHAR,2005,Total,14,123,106,70,14,327,5,104,77,23,7,216,543
BIHAR,2005,Total (Poison),1,45,20,11,2,79,1,39,25,8,3,76,155
BIHAR,2005,Total (Jumping),1,4,16,0,0,21,1,1,1,0,0,3,24
BIHAR,2006,By Over Alcoholism,0,1,1,1,1,4,0,0,0,0,0,0,4
BIHAR,2006,By Drowning,3,15,12,2,2,34,2,18,12,8,0,40,74
BIHAR,2006,By Fire/Self Immolation,1,6,4,3,0,14,2,17,16,13,2,50,64
BIHAR,2006,By Fire-Arms,0,1,4,1,1,7,0,2,3,0,0,5,12
BIHAR,2006,By Hanging,1,28,20,8,1,58,1,29,25,2,0,57,115
BIHAR,2006,By Consuming Insecticides,2,16,11,3,2,34,1,14,17,3,0,35,69
BIHAR,2006,By Consuming Other Poison,0,24,25,5,2,56,2,19,34,4,0,59,115
BIHAR,2006,By Self Infliction of injury,0,1,1,0,0,2,0,0,0,1,0,1,3
BIHAR,2006,By Jumping from (Building),0,1,2,0,0,3,0,0,0,0,0,0,3
BIHAR,2006,By Jumping from (Other sites),0,0,1,2,0,3,0,2,0,2,0,4,7
BIHAR,2006,By Jumping off Moving Vehicles/Trains,0,0,0,0,0,0,0,3,0,0,0,3,3
BIHAR,2006,By Machine,0,0,0,0,0,0,0,0,0,0,0,0,0
BIHAR,2006,By Overdose of sleeping pills,0,0,0,1,0,1,0,0,0,0,0,0,1
BIHAR,2006,By touching electric wires,1,0,3,1,0,5,0,0,0,0,0,0,5
BIHAR,2006,By coming under running vehicles/trains,1,2,0,0,0,3,0,0,3,1,0,4,7
BIHAR,2006,By Other means (please specify),19,28,18,8,2,75,16,19,19,4,3,61,136
BIHAR,2006,Total,28,123,102,35,11,299,24,123,129,38,5,319,618
BIHAR,2006,Total (Poison),2,41,37,8,4,92,3,33,51,8,0,95,187
BIHAR,2006,Total (Jumping),0,1,3,2,0,6,0,2,0,2,0,4,10
BIHAR,2007,By Over Alcoholism,0,1,10,4,0,15,0,0,0,0,0,0,15
BIHAR,2007,By Drowning,6,35,14,11,3,69,6,12,9,3,0,30,99
BIHAR,2007,By Fire/Self Immolation,1,7,4,4,0,16,3,17,26,7,0,53,69
BIHAR,2007,By Fire-Arms,0,10,2,1,0,13,0,3,0,0,0,3,16
BIHAR,2007,By Hanging,1,33,16,9,2,61,3,23,20,1,0,47,108
BIHAR,2007,By Consuming Insecticides,1,32,20,9,0,62,5,35,11,1,0,52,114
BIHAR,2007,By Consuming Other Poison,9,22,10,11,4,56,4,24,17,12,2,59,115
BIHAR,2007,By Self Infliction of injury,0,8,9,2,1,20,0,7,3,0,0,10,30
BIHAR,2007,By Jumping from (Building),0,0,1,0,0,1,0,1,0,0,0,1,2
BIHAR,2007,By Jumping from (Other sites),0,3,0,2,0,5,0,1,1,0,0,2,7
BIHAR,2007,By Jumping off Moving Vehicles/Trains,0,0,2,0,1,3,0,0,0,0,0,0,3
BIHAR,2007,By Machine,0,0,1,0,0,1,0,0,0,1,0,1,2
BIHAR,2007,By Overdose of sleeping pills,1,2,1,0,0,4,0,2,1,0,0,3,7
BIHAR,2007,By touching electric wires,0,8,7,4,0,19,0,3,0,1,0,4,23
BIHAR,2007,By coming under running vehicles/trains,0,0,1,1,0,2,0,6,0,0,0,6,8
BIHAR,2007,By Other means (please specify),14,51,48,57,17,187,23,62,29,25,21,160,347
BIHAR,2007,Total,33,212,146,115,28,534,44,196,117,51,23,431,965
BIHAR,2007,Total (Poison),10,62,39,22,5,138,9,66,31,13,2,121,259
BIHAR,2007,Total (Jumping),0,3,1,2,0,6,0,2,1,0,0,3,9
BIHAR,2008,By Over Alcoholism,0,3,8,5,12,28,0,3,0,0,0,3,31
BIHAR,2008,By Drowning,7,24,28,8,7,74,8,17,19,8,11,63,137
BIHAR,2008,By Fire/Self Immolation,0,11,26,9,2,48,0,22,10,4,2,38,86
BIHAR,2008,By Fire-Arms,0,4,2,0,0,6,0,0,0,1,0,1,7
BIHAR,2008,By Hanging,0,22,10,8,0,40,6,14,13,0,0,33,73
BIHAR,2008,By Consuming Insecticides,1,29,36,6,1,73,0,26,25,3,1,55,128
BIHAR,2008,By Consuming Other Poison,0,8,13,6,1,28,2,13,15,1,0,31,59
BIHAR,2008,By Self Infliction of injury,0,5,0,0,0,5,0,2,3,1,0,6,11
BIHAR,2008,By Jumping from (Building),0,3,2,1,0,6,0,1,0,0,0,1,7
BIHAR,2008,By Jumping from (Other sites),0,2,0,0,0,2,0,0,1,0,0,1,3
BIHAR,2008,By Jumping off Moving Vehicles/Trains,0,0,0,0,0,0,0,0,0,0,0,0,0
BIHAR,2008,By Machine,0,1,0,0,0,1,0,0,0,1,0,1,2
BIHAR,2008,By Overdose of sleeping pills,0,0,0,3,0,3,0,0,0,0,0,0,3
BIHAR,2008,By touching electric wires,0,11,9,2,4,26,0,0,3,0,0,3,29
BIHAR,2008,By coming under running vehicles/trains,0,0,0,0,0,0,0,0,0,0,0,0,0
BIHAR,2008,By Other means (please specify),27,95,68,49,30,269,17,67,56,21,9,170,439
BIHAR,2008,Total,35,218,202,97,57,609,33,165,145,40,23,406,1015
BIHAR,2008,Total (Poison),1,42,49,12,2,106,2,41,43,5,1,92,198
BIHAR,2008,Total (Jumping),0,5,2,1,0,8,0,1,1,0,0,2,10
BIHAR,2009,By Over Alcoholism,0,3,10,1,0,14,0,0,0,0,0,0,14
BIHAR,2009,By Drowning,6,21,28,12,7,74,1,12,31,1,0,45,119
BIHAR,2009,By Fire/Self Immolation,0,11,4,7,1,23,5,46,49,12,0,112,135
BIHAR,2009,By Fire-Arms,0,1,0,0,0,1,0,3,1,0,0,4,5
BIHAR,2009,By Hanging,2,25,22,10,0,59,3,42,52,11,0,108,167
BIHAR,2009,By Consuming Insecticides,3,30,30,7,1,71,5,39,44,4,3,95,166
BIHAR,2009,By Consuming Other Poison,1,37,25,18,7,88,1,44,34,2,1,82,170
BIHAR,2009,By Self Infliction of injury,0,0,1,0,0,1,0,0,0,0,0,0,1
BIHAR,2009,By Jumping from (Building),1,2,3,0,0,6,0,0,0,0,0,0,6
BIHAR,2009,By Jumping from (Other sites),0,2,0,0,0,2,0,0,0,0,0,0,2
BIHAR,2009,By Jumping off Moving Vehicles/Trains,0,2,2,0,0,4,0,0,0,0,0,0,4
BIHAR,2009,By Machine,0,2,2,1,0,5,0,0,0,0,0,0,5
BIHAR,2009,By Overdose of sleeping pills,0,1,25,1,0,27,0,1,0,0,0,1,28
BIHAR,2009,By touching electric wires,3,7,4,1,0,15,0,0,1,0,0,1,16
BIHAR,2009,By coming under running vehicles/trains,0,1,2,0,0,3,0,1,0,0,0,1,4
BIHAR,2009,By Other means (please specify),6,57,35,17,6,121,10,40,20,11,7,88,209
BIHAR,2009,Total,22,202,193,75,22,514,25,228,232,41,11,537,1051
BIHAR,2009,Total (Poison),4,67,56,25,8,160,6,83,78,6,4,177,337
BIHAR,2009,Total (Jumping),1,4,3,0,0,8,0,0,0,0,0,0,8
BIHAR,2010,By Over Alcoholism,0,4,12,5,1,22,0,0,0,0,0,0,22
BIHAR,2010,By Drowning,17,19,17,8,1,62,11,12,10,3,0,36,98
BIHAR,2010,By Fire/Self Immolation,1,10,15,3,1,30,6,33,30,9,3,81,111
BIHAR,2010,By Fire-Arms,0,2,3,0,0,5,0,2,0,0,0,2,7
BIHAR,2010,By Hanging,0,25,25,4,2,56,8,26,17,6,1,58,114
BIHAR,2010,By Consuming Insecticides,3,44,32,11,2,92,9,27,27,6,1,70,162
BIHAR,2010,By Consuming Other Poison,1,17,22,5,1,46,1,16,14,6,3,40,86
BIHAR,2010,By Self Infliction of injury,0,0,4,0,0,4,0,0,4,0,0,4,8
BIHAR,2010,By Jumping from (Building),3,3,4,0,0,10,4,6,3,0,0,13,23
BIHAR,2010,By Jumping from (Other sites),0,1,3,1,1,6,0,1,0,0,0,1,7
BIHAR,2010,By Jumping off Moving Vehicles/Trains,0,0,2,0,0,2,0,0,0,0,0,0,2
BIHAR,2010,By Machine,1,4,1,0,0,6,0,1,4,2,0,7,13
BIHAR,2010,By Overdose of sleeping pills,0,7,6,1,1,15,0,0,6,2,0,8,23
BIHAR,2010,By touching electric wires,3,10,7,3,0,23,0,1,1,2,5,9,32
BIHAR,2010,By coming under running vehicles/trains,0,0,0,0,0,0,0,0,0,0,0,0,0
BIHAR,2010,By Other means (please specify),11,82,119,95,26,333,15,102,43,17,8,185,518
BIHAR,2010,Total,40,228,272,136,36,712,54,227,159,53,21,514,1226
BIHAR,2010,Total (Poison),4,61,58,16,3,142,10,43,45,12,4,114,256
BIHAR,2010,Total (Jumping),3,4,7,1,1,16,4,7,3,0,0,14,30
BIHAR,2011,By Over Alcoholism,0,1,14,2,0,17,0,0,1,0,0,1,18
BIHAR,2011,By Drowning,6,15,27,7,1,56,3,13,12,3,1,32,88
BIHAR,2011,By Fire/Self Immolation,0,3,8,3,0,14,5,32,27,7,1,72,86
BIHAR,2011,By Fire-Arms,0,1,2,0,0,3,0,2,1,0,0,3,6
BIHAR,2011,By Hanging,0,30,28,8,1,67,2,24,17,1,0,44,111
BIHAR,2011,By Consuming Insecticides,2,38,17,9,4,70,1,21,19,3,4,48,118
BIHAR,2011,By Consuming Other Poison,1,18,18,22,1,60,5,20,13,0,0,38,98
BIHAR,2011,By Self Infliction of injury,0,1,0,1,0,2,0,1,0,0,0,1,3
BIHAR,2011,By Jumping from (Building),0,3,1,0,0,4,0,1,2,0,0,3,7
BIHAR,2011,By Jumping from (Other sites),0,3,0,1,0,4,0,0,1,0,0,1,5
BIHAR,2011,By Jumping off Moving Vehicles/Trains,0,1,0,0,0,1,0,0,0,0,0,0,1
BIHAR,2011,By Machine,0,0,0,0,0,0,0,0,0,0,0,0,0
BIHAR,2011,By Overdose of sleeping pills,0,1,0,0,0,1,0,0,0,0,0,0,1
BIHAR,2011,By touching electric wires,0,7,4,1,0,12,0,2,1,0,0,3,15
BIHAR,2011,By coming under running vehicles/trains,0,3,0,0,1,4,0,1,1,1,0,3,7
BIHAR,2011,By Other means (please specify),7,25,44,34,21,131,25,32,31,4,8,100,231
BIHAR,2011,Total,16,150,163,88,29,446,41,149,126,19,14,349,795
BIHAR,2011,Total (Poison),3,57,35,32,5,132,6,42,32,3,4,87,219
BIHAR,2011,Total (Jumping),0,6,1,1,0,8,0,1,3,0,0,4,12
BIHAR,2012,By Over Alcoholism,0,2,8,6,1,17,0,0,0,0,0,0,17
BIHAR,2012,By Drowning,0,18,18,3,2,41,2,13,2,1,1,19,60
BIHAR,2012,By Fire/Self Immolation,0,6,5,1,0,12,0,21,10,3,2,36,48
BIHAR,2012,By Fire-Arms,0,2,0,0,1,3,0,0,0,0,0,0,3
BIHAR,2012,By Hanging,0,43,34,9,1,87,0,31,17,5,1,54,141
BIHAR,2012,By Consuming Insecticides,0,23,38,10,2,73,0,25,18,5,0,48,121
BIHAR,2012,By Consuming Other Poison,0,10,11,2,0,23,0,10,14,2,0,26,49
BIHAR,2012,By Self Infliction of injury,0,1,1,0,0,2,0,2,2,0,0,4,6
BIHAR,2012,By Jumping from (Building),0,2,2,0,0,4,0,4,2,0,0,6,10
BIHAR,2012,By Jumping from (Other sites),0,3,0,0,0,3,0,0,0,0,0,0,3
BIHAR,2012,By Jumping off Moving Vehicles/Trains,0,0,2,0,0,2,0,0,0,0,0,0,2
BIHAR,2012,By Machine,0,0,0,0,0,0,0,0,0,0,0,0,0
BIHAR,2012,By Overdose of sleeping pills,0,3,1,0,0,4,0,1,1,0,0,2,6
BIHAR,2012,By touching electric wires,0,3,10,1,1,15,0,1,0,0,0,1,16
BIHAR,2012,By coming under running vehicles/trains,0,0,0,0,1,1,0,1,0,0,0,1,2
BIHAR,2012,By Other means (please specify),5,39,82,31,11,168,4,26,57,13,7,107,275
BIHAR,2012,Total,5,155,212,63,20,455,6,135,123,29,11,304,759
BIHAR,2012,Total (Poison),0,34,50,12,2,98,0,37,34,7,0,78,176
BIHAR,2012,Total (Jumping),0,5,2,0,0,7,0,4,2,0,0,6,13
CHHATTISGARH,2001,By Over Alcoholism,0,3,24,13,4,44,0,1,5,4,3,13,57
CHHATTISGARH,2001,By Drowning,4,14,24,7,17,66,4,23,9,10,4,50,116
CHHATTISGARH,2001,By Fire/Self Immolation,1,26,37,17,3,84,11,145,76,12,7,251,335
CHHATTISGARH,2001,By Fire-Arms,0,2,1,1,0,4,0,0,0,0,0,0,4
CHHATTISGARH,2001,By Hanging,16,358,491,324,172,1361,12,191,113,84,39,439,1800
CHHATTISGARH,2001,By Consuming Insecticides,13,233,228,124,34,632,12,167,142,36,11,368,1000
CHHATTISGARH,2001,By Consuming Other Poison,2,101,73,31,7,214,3,89,48,21,0,161,375
CHHATTISGARH,2001,By Self Infliction of injury,0,1,1,0,0,2,0,0,0,0,0,0,2
CHHATTISGARH,2001,By Jumping from (Building),0,1,1,0,0,2,0,0,0,0,0,0,2
CHHATTISGARH,2001,By Jumping from (Other sites),0,1,1,0,0,2,0,0,0,0,0,0,2
CHHATTISGARH,2001,By Jumping off Moving Vehicles/Trains,0,13,10,6,1,30,0,2,2,0,1,5,35
CHHATTISGARH,2001,By Machine,0,0,3,0,1,4,0,0,1,0,0,1,5
CHHATTISGARH,2001,By Overdose of sleeping pills,0,1,0,4,0,5,0,1,2,0,0,3,8
CHHATTISGARH,2001,By touching electric wires,0,3,11,2,1,17,1,0,3,0,0,4,21
CHHATTISGARH,2001,By coming under running vehicles/trains,0,15,25,3,5,48,0,4,3,7,3,17,65
CHHATTISGARH,2001,By Other means (please specify),8,20,25,31,41,125,6,11,14,19,23,73,198
CHHATTISGARH,2001,Total,44,792,955,563,286,2640,49,634,418,193,91,1385,4025
CHHATTISGARH,2001,Total (Poison),15,335,302,155,41,848,15,256,190,57,11,529,1377
CHHATTISGARH,2001,Total (Jumping),0,2,2,0,0,4,0,0,0,0,0,0,4
CHHATTISGARH,2002,By Over Alcoholism,0,2,28,14,2,46,0,0,0,2,0,2,48
CHHATTISGARH,2002,By Drowning,17,22,30,17,13,99,7,25,20,10,9,71,170
CHHATTISGARH,2002,By Fire/Self Immolation,4,19,18,13,5,59,4,95,64,40,5,208,267
CHHATTISGARH,2002,By Fire-Arms,0,0,2,0,0,2,0,2,1,1,0,4,6
CHHATTISGARH,2002,By Hanging,21,309,451,320,105,1206,9,195,141,55,23,423,1629
CHHATTISGARH,2002,By Consuming Insecticides,5,236,203,140,31,615,10,145,112,56,18,341,956
CHHATTISGARH,2002,By Consuming Other Poison,9,88,56,20,8,181,2,64,36,8,4,114,295
CHHATTISGARH,2002,By Self Infliction of injury,0,9,7,3,3,22,0,7,2,0,4,13,35
CHHATTISGARH,2002,By Jumping from (Building),0,4,2,1,2,9,0,0,2,0,0,2,11
CHHATTISGARH,2002,By Jumping from (Other sites),0,0,0,0,0,0,0,0,0,0,0,0,0
CHHATTISGARH,2002,By Jumping off Moving Vehicles/Trains,1,8,11,1,5,26,0,5,4,0,2,11,37
CHHATTISGARH,2002,By Machine,0,2,2,1,0,5,0,0,0,0,0,0,5
CHHATTISGARH,2002,By Overdose of sleeping pills,0,2,1,0,0,3,0,0,0,0,0,0,3
CHHATTISGARH,2002,By touching electric wires,6,8,8,3,2,27,0,0,1,0,0,1,28
CHHATTISGARH,2002,By coming under running vehicles/trains,1,18,18,9,3,49,1,9,7,1,0,18,67
CHHATTISGARH,2002,By Other means,21,67,91,64,37,280,29,47,20,9,8,113,393
CHHATTISGARH,2002,Total,85,794,928,606,216,2629,62,594,410,182,73,1321,3950
CHHATTISGARH,2002,Total (Poison),14,333,266,163,42,818,12,216,150,64,26,468,1286
CHHATTISGARH,2002,Total (Jumping),0,4,2,1,2,9,0,0,2,0,0,2,11
CHHATTISGARH,2003,By Over Alcoholism,0,15,23,13,1,52,0,1,1,8,1,11,63
CHHATTISGARH,2003,By Drowning,23,45,52,35,13,168,27,30,29,11,14,111,279
CHHATTISGARH,2003,By Fire/Self Immolation,1,22,20,10,3,56,13,103,50,19,3,188,244
CHHATTISGARH,2003,By Fire-Arms,0,0,1,1,0,2,0,1,0,0,0,1,3
CHHATTISGARH,2003,By Hanging,30,365,414,270,111,1190,29,227,120,51,22,449,1639
CHHATTISGARH,2003,By Consuming Insecticides,14,172,121,79,21,407,6,118,60,31,9,224,631
CHHATTISGARH,2003,By Consuming Other Poison,11,85,70,40,16,222,14,80,68,26,11,199,421
CHHATTISGARH,2003,By Self Infliction of injury,0,1,0,0,0,1,0,1,0,0,0,1,2
CHHATTISGARH,2003,By Jumping from (Building),2,9,16,5,2,34,1,1,3,1,0,6,40
CHHATTISGARH,2003,By Jumping from (Other sites),0,2,1,1,2,6,0,2,0,1,0,3,9
CHHATTISGARH,2003,By Jumping off Moving Vehicles/Trains,0,4,4,5,0,13,0,1,2,1,0,4,17
CHHATTISGARH,2003,By Machine,0,0,3,0,0,3,0,0,0,0,0,0,3
CHHATTISGARH,2003,By Overdose of sleeping pills,0,1,0,0,0,1,0,1,0,0,0,1,2
CHHATTISGARH,2003,By touching electric wires,2,27,23,18,2,72,1,1,3,2,0,7,79
CHHATTISGARH,2003,By coming under running vehicles/trains,2,43,44,19,8,116,1,10,7,1,2,21,137
CHHATTISGARH,2003,By Other means (please specify),18,55,86,58,32,249,14,45,30,9,3,101,350
CHHATTISGARH,2003,Total,103,846,878,554,211,2592,106,622,373,161,65,1327,3919
CHHATTISGARH,2003,Total (Poison),25,258,191,119,37,630,20,199,128,57,20,424,1054
CHHATTISGARH,2003,Total (Jumping),2,11,17,6,4,40,1,3,3,2,0,9,49
CHHATTISGARH,2004,By Over Alcoholism,0,3,15,6,0,24,0,0,2,0,0,2,26
CHHATTISGARH,2004,By Drowning,8,24,32,14,8,86,9,12,22,14,4,61,147
CHHATTISGARH,2004,By Fire/Self Immolation,4,22,27,15,4,72,10,118,85,21,5,239,311
CHHATTISGARH,2004,By Fire-Arms,0,0,2,1,0,3,0,2,1,0,0,3,6
CHHATTISGARH,2004,By Hanging,24,389,555,352,159,1479,20,243,157,89,26,535,2014
CHHATTISGARH,2004,By Consuming Insecticides,6,261,175,110,36,588,24,153,83,37,18,315,903
CHHATTISGARH,2004,By Consuming Other Poison,4,100,99,75,20,298,5,73,61,22,10,171,469
CHHATTISGARH,2004,By Self Infliction of injury,0,3,3,1,0,7,0,0,0,0,0,0,7
CHHATTISGARH,2004,By Jumping from (Building),0,2,0,1,0,3,0,3,1,0,0,4,7
CHHATTISGARH,2004,By Jumping from (Other sites),0,0,0,0,0,0,0,0,0,0,0,0,0
CHHATTISGARH,2004,By Jumping off Moving Vehicles/Trains,0,7,11,7,8,33,0,1,4,3,1,9,42
CHHATTISGARH,2004,By Machine,0,1,1,0,0,2,0,0,0,0,0,0,2
CHHATTISGARH,2004,By Overdose of sleeping pills,0,0,0,0,0,0,0,0,0,0,0,0,0
CHHATTISGARH,2004,By touching electric wires,1,3,5,0,1,10,0,0,0,0,1,1,11
CHHATTISGARH,2004,By coming under running vehicles/trains,0,19,46,21,6,92,0,15,8,2,0,25,117
CHHATTISGARH,2004,By Other means (please specify),30,45,86,104,24,289,24,34,36,37,13,144,433
CHHATTISGARH,2004,Total,77,879,1057,707,266,2986,92,654,460,225,78,1509,4495
CHHATTISGARH,2004,Total (Poison),10,364,277,186,56,893,29,226,144,59,28,486,1379
CHHATTISGARH,2004,Total (Jumping),0,2,0,1,0,3,0,3,1,0,0,4,7
CHHATTISGARH,2005,By Over Alcoholism,2,13,39,23,6,83,4,12,9,8,3,36,119
CHHATTISGARH,2005,By Drowning,18,30,34,28,14,124,11,26,22,17,8,84,208
CHHATTISGARH,2005,By Fire/Self Immolation,5,31,28,11,2,77,5,177,67,27,8,284,361
CHHATTISGARH,2005,By Fire-Arms,63,52,31,26,0,172,5,5,6,6,0,22,194
CHHATTISGARH,2005,By Hanging,23,431,522,307,121,1404,19,204,152,62,23,460,1864
CHHATTISGARH,2005,By Consuming Insecticides,9,242,213,101,23,588,7,172,105,54,14,352,940
CHHATTISGARH,2005,By Consuming Other Poison,5,75,62,38,6,186,7,70,38,6,5,126,312
CHHATTISGARH,2005,By Self Infliction of injury,0,2,4,0,0,6,0,2,0,0,0,2,8
CHHATTISGARH,2005,By Jumping from (Building),0,0,0,0,0,0,0,0,0,0,0,0,0
CHHATTISGARH,2005,By Jumping from (Other sites),0,0,0,0,0,0,0,0,0,0,0,0,0
CHHATTISGARH,2005,By Jumping off Moving Vehicles/Trains,0,15,7,1,0,23,0,2,4,0,1,7,30
CHHATTISGARH,2005,By Machine,0,7,5,0,0,12,0,0,0,0,0,0,12
CHHATTISGARH,2005,By Overdose of sleeping pills,0,0,0,0,0,0,0,0,0,0,0,0,0
CHHATTISGARH,2005,By touching electric wires,1,13,15,9,3,41,0,2,1,1,0,4,45
CHHATTISGARH,2005,By coming under running vehicles/trains,0,39,35,17,4,95,2,13,10,3,3,31,126
CHHATTISGARH,2005,By Other means (please specify),34,112,179,115,54,494,13,57,51,25,22,168,662
CHHATTISGARH,2005,Total,160,1062,1174,676,233,3305,73,742,465,209,87,1576,4881
CHHATTISGARH,2005,Total (Poison),14,319,279,139,29,780,14,244,143,60,19,480,1260
CHHATTISGARH,2005,Total (Jumping),0,0,0,0,0,0,0,0,0,0,0,0,0
CHHATTISGARH,2006,By Over Alcoholism,0,2,15,13,6,36,0,0,3,1,1,5,41
CHHATTISGARH,2006,By Drowning,7,20,20,8,6,61,1,6,8,7,8,30,91
CHHATTISGARH,2006,By Fire/Self Immolation,1,36,37,6,2,82,13,189,79,27,14,322,404
CHHATTISGARH,2006,By Fire-Arms,0,1,0,0,0,1,0,0,0,0,0,0,1
CHHATTISGARH,2006,By Hanging,32,423,489,325,86,1355,24,227,131,69,24,475,1830
CHHATTISGARH,2006,By Consuming Insecticides,17,268,219,78,32,614,19,195,111,31,8,364,978
CHHATTISGARH,2006,By Consuming Other Poison,4,61,57,24,13,159,4,49,26,4,0,83,242
CHHATTISGARH,2006,By Self Infliction of injury,0,0,2,0,0,2,0,0,0,0,0,0,2
CHHATTISGARH,2006,By Jumping from (Building),0,2,0,0,0,2,0,1,0,0,0,1,3
CHHATTISGARH,2006,By Jumping from (Other sites),0,0,0,0,0,0,0,0,0,0,0,0,0
CHHATTISGARH,2006,By Jumping off Moving Vehicles/Trains,0,7,6,3,0,16,0,3,0,0,0,3,19
CHHATTISGARH,2006,By Machine,0,8,13,1,0,22,0,0,5,0,0,5,27
CHHATTISGARH,2006,By Overdose of sleeping pills,0,0,0,0,0,0,0,0,0,0,0,0,0
CHHATTISGARH,2006,By touching electric wires,1,11,7,3,1,23,1,1,2,1,0,5,28
CHHATTISGARH,2006,By coming under running vehicles/trains,2,26,32,12,2,74,0,4,7,2,1,14,88
CHHATTISGARH,2006,By Other means (please specify),48,202,188,117,58,613,34,100,56,46,23,259,872
CHHATTISGARH,2006,Total,112,1067,1085,590,206,3060,96,775,428,188,79,1566,4626
CHHATTISGARH,2006,Total (Poison),21,329,278,102,45,775,23,244,137,35,8,447,1222
CHHATTISGARH,2006,Total (Jumping),0,2,0,0,0,2,0,1,0,0,0,1,3
CHHATTISGARH,2007,By Over Alcoholism,0,5,37,22,5,69,0,0,8,3,2,13,82
CHHATTISGARH,2007,By Drowning,11,21,25,19,13,89,5,18,54,23,7,107,196
CHHATTISGARH,2007,By Fire/Self Immolation,1,41,33,9,5,89,7,176,79,26,9,297,386
CHHATTISGARH,2007,By Fire-Arms,0,24,79,86,38,227,0,22,21,18,6,67,294
CHHATTISGARH,2007,By Hanging,23,433,418,312,131,1317,21,220,120,52,21,434,1751
CHHATTISGARH,2007,By Consuming Insecticides,8,262,252,107,34,663,5,167,109,61,13,355,1018
CHHATTISGARH,2007,By Consuming Other Poison,6,106,80,44,19,255,10,72,43,17,2,144,399
CHHATTISGARH,2007,By Self Infliction of injury,0,0,1,0,0,1,0,0,0,0,0,0,1
CHHATTISGARH,2007,By Jumping from (Building),0,1,9,8,9,27,0,0,3,3,0,6,33
CHHATTISGARH,2007,By Jumping from (Other sites),0,0,0,0,0,0,0,0,0,0,0,0,0
CHHATTISGARH,2007,By Jumping off Moving Vehicles/Trains,0,6,5,0,0,11,0,0,0,0,0,0,11
CHHATTISGARH,2007,By Machine,0,0,0,0,0,0,0,0,0,0,0,0,0
CHHATTISGARH,2007,By Overdose of sleeping pills,0,1,0,0,0,1,0,0,0,0,0,0,1
CHHATTISGARH,2007,By touching electric wires,2,15,11,2,0,30,1,3,4,1,1,10,40
CHHATTISGARH,2007,By coming under running vehicles/trains,0,18,18,11,9,56,2,5,3,2,2,14,70
CHHATTISGARH,2007,By Other means (please specify),27,114,155,68,57,421,8,48,32,26,22,136,557
CHHATTISGARH,2007,Total,78,1047,1123,688,320,3256,59,731,476,232,85,1583,4839
CHHATTISGARH,2007,Total (Poison),14,368,333,151,53,919,15,239,152,78,15,499,1418
CHHATTISGARH,2007,Total (Jumping),0,1,9,8,9,27,0,0,3,3,0,6,33
CHHATTISGARH,2008,By Over Alcoholism,1,11,19,15,6,52,0,8,5,3,2,18,70
CHHATTISGARH,2008,By Drowning,2,37,25,12,3,79,15,45,39,14,1,114,193
CHHATTISGARH,2008,By Fire/Self Immolation,13,121,143,64,3,344,14,222,106,35,5,382,726
CHHATTISGARH,2008,By Fire-Arms,0,1,4,0,0,5,0,0,0,0,0,0,5
CHHATTISGARH,2008,By Hanging,23,495,598,339,133,1588,31,276,164,76,21,568,2156
CHHATTISGARH,2008,By Consuming Insecticides,6,241,187,160,47,641,11,176,103,40,18,348,989
CHHATTISGARH,2008,By Consuming Other Poison,6,122,87,48,11,274,6,86,41,32,9,174,448
CHHATTISGARH,2008,By Self Infliction of injury,0,17,3,3,2,25,0,9,1,2,0,12,37
CHHATTISGARH,2008,By Jumping from (Building),0,3,3,0,0,6,0,1,0,0,0,1,7
CHHATTISGARH,2008,By Jumping from (Other sites),0,0,0,0,0,0,0,0,0,0,0,0,0
CHHATTISGARH,2008,By Jumping off Moving Vehicles/Trains,1,8,20,11,2,42,1,6,1,2,0,10,52
CHHATTISGARH,2008,By Machine,0,0,0,0,0,0,0,0,0,0,0,0,0
CHHATTISGARH,2008,By Overdose of sleeping pills,0,1,3,5,0,9,0,2,0,1,0,3,12
CHHATTISGARH,2008,By touching electric wires,2,10,1,2,1,16,1,0,1,0,0,2,18
CHHATTISGARH,2008,By coming under running vehicles/trains,2,27,37,7,3,76,1,10,5,2,3,21,97
CHHATTISGARH,2008,By Other means (please specify),9,31,26,19,6,91,2,13,12,11,6,44,135
CHHATTISGARH,2008,Total,65,1125,1156,685,217,3248,82,854,478,218,65,1697,4945
CHHATTISGARH,2008,Total (Poison),12,380,277,211,60,940,17,271,145,74,27,534,1474
CHHATTISGARH,2008,Total (Jumping),0,3,3,0,0,6,0,1,0,0,0,1,7
CHHATTISGARH,2009,By Over Alcoholism,0,10,23,13,10,56,0,1,3,4,3,11,67
CHHATTISGARH,2009,By Drowning,20,45,27,29,16,137,12,10,13,9,8,52,189
CHHATTISGARH,2009,By Fire/Self Immolation,4,40,67,46,10,167,15,238,138,47,14,452,619
CHHATTISGARH,2009,By Fire-Arms,0,3,3,1,0,7,0,1,1,0,0,2,9
CHHATTISGARH,2009,By Hanging,13,467,559,435,170,1644,16,254,160,86,28,544,2188
CHHATTISGARH,2009,By Consuming Insecticides,7,243,219,145,53,667,9,177,121,53,13,373,1040
CHHATTISGARH,2009,By Consuming Other Poison,8,205,128,57,11,409,10,134,74,20,10,248,657
CHHATTISGARH,2009,By Self Infliction of injury,0,0,0,0,1,1,0,0,0,0,0,0,1
CHHATTISGARH,2009,By Jumping from (Building),0,1,1,1,0,3,0,1,1,0,0,2,5
CHHATTISGARH,2009,By Jumping from (Other sites),0,5,7,4,2,18,0,6,4,0,3,13,31
CHHATTISGARH,2009,By Jumping off Moving Vehicles/Trains,0,3,24,25,3,55,0,3,3,3,3,12,67
CHHATTISGARH,2009,By Machine,0,3,5,0,0,8,0,2,2,0,0,4,12
CHHATTISGARH,2009,By Overdose of sleeping pills,0,3,1,0,0,4,0,0,0,0,0,0,4
CHHATTISGARH,2009,By touching electric wires,3,17,20,20,10,70,2,6,3,3,1,15,85
CHHATTISGARH,2009,By coming under running vehicles/trains,1,20,33,8,1,63,0,12,5,1,2,20,83
CHHATTISGARH,2009,By Other means (please specify),48,160,225,153,59,645,12,28,59,65,17,181,826
CHHATTISGARH,2009,Total,104,1225,1342,937,346,3954,76,873,587,291,102,1929,5883
CHHATTISGARH,2009,Total (Poison),15,448,347,202,65,1077,19,311,195,73,23,621,1698
CHHATTISGARH,2009,Total (Jumping),0,6,8,5,2,21,0,7,5,0,3,15,36
CHHATTISGARH,2010,By Over Alcoholism,0,4,25,11,7,47,0,4,3,3,0,10,57
CHHATTISGARH,2010,By Drowning,0,13,16,16,9,54,0,8,6,3,2,19,73
CHHATTISGARH,2010,By Fire/Self Immolation,1,59,48,39,12,159,8,181,136,50,18,393,552
CHHATTISGARH,2010,By Fire-Arms,0,3,2,2,0,7,0,0,1,0,0,1,8
CHHATTISGARH,2010,By Hanging,19,536,595,428,195,1773,10,235,192,83,21,541,2314
CHHATTISGARH,2010,By Consuming Insecticides,12,243,271,195,55,776,11,199,129,71,22,432,1208
CHHATTISGARH,2010,By Consuming Other Poison,7,134,92,50,18,301,2,79,52,10,7,150,451
CHHATTISGARH,2010,By Self Infliction of injury,4,74,45,14,9,146,3,32,14,1,2,52,198
CHHATTISGARH,2010,By Jumping from (Building),0,0,2,3,0,5,0,0,0,0,1,1,6
CHHATTISGARH,2010,By Jumping from (Other sites),0,0,1,3,0,4,0,0,0,0,1,1,5
CHHATTISGARH,2010,By Jumping off Moving Vehicles/Trains,0,14,13,9,0,36,0,7,1,2,0,10,46
CHHATTISGARH,2010,By Machine,0,0,0,0,0,0,0,0,0,0,0,0,0
CHHATTISGARH,2010,By Overdose of sleeping pills,0,0,0,0,0,0,0,0,0,0,0,0,0
CHHATTISGARH,2010,By touching electric wires,0,6,2,13,0,21,0,1,1,1,0,3,24
CHHATTISGARH,2010,By coming under running vehicles/trains,0,27,44,40,9,120,0,14,11,2,2,29,149
CHHATTISGARH,2010,By Other means (please specify),67,271,382,279,97,1096,24,102,101,66,42,335,1431
CHHATTISGARH,2010,Total,110,1384,1538,1102,411,4545,58,862,647,292,118,1977,6522
CHHATTISGARH,2010,Total (Poison),23,451,408,259,82,1223,16,310,195,82,31,634,1857
CHHATTISGARH,2010,Total (Jumping),0,0,3,6,0,9,0,0,0,0,2,2,11
CHHATTISGARH,2011,By Over Alcoholism,0,10,40,37,8,95,0,4,6,9,2,21,116
CHHATTISGARH,2011,By Drowning,11,25,32,22,19,109,10,16,8,10,9,53,162
CHHATTISGARH,2011,By Fire/Self Immolation,5,60,56,50,11,182,14,223,154,58,15,464,646
CHHATTISGARH,2011,By Fire-Arms,0,5,7,2,0,14,0,1,1,1,0,3,17
CHHATTISGARH,2011,By Hanging,20,535,662,425,182,1824,16,300,166,96,42,620,2444
CHHATTISGARH,2011,By Consuming Insecticides,10,326,282,197,65,880,10,215,134,86,39,484,1364
CHHATTISGARH,2011,By Consuming Other Poison,3,117,89,50,24,283,4,99,52,23,4,182,465
CHHATTISGARH,2011,By Self Infliction of injury,0,1,1,1,0,3,0,0,0,0,0,0,3
CHHATTISGARH,2011,By Jumping from (Building),0,1,0,0,0,1,0,0,0,0,0,0,1
CHHATTISGARH,2011,By Jumping from (Other sites),0,1,0,0,0,1,0,0,0,0,0,0,1
CHHATTISGARH,2011,By Jumping off Moving Vehicles/Trains,0,7,11,20,1,39,0,1,3,0,0,4,43
CHHATTISGARH,2011,By Machine,0,1,0,0,0,1,0,0,0,1,0,1,2
CHHATTISGARH,2011,By Overdose of sleeping pills,0,0,1,0,0,1,0,0,0,0,0,0,1
CHHATTISGARH,2011,By touching electric wires,1,17,8,12,5,43,1,2,1,0,0,4,47
CHHATTISGARH,2011,By coming under running vehicles/trains,1,38,36,28,17,120,1,25,13,3,3,45,165
CHHATTISGARH,2011,By Other means (please specify),51,284,276,237,83,931,30,102,100,89,27,348,1279
CHHATTISGARH,2011,Total,102,1428,1501,1081,415,4527,86,988,638,376,141,2229,6756
CHHATTISGARH,2011,Total (Poison),13,444,372,248,89,1166,14,314,186,109,43,666,1832
CHHATTISGARH,2011,Total (Jumping),0,2,0,0,0,2,0,0,0,0,0,0,2
CHHATTISGARH,2012,By Over Alcoholism,0,10,44,28,8,90,9,4,14,13,9,49,139
CHHATTISGARH,2012,By Drowning,12,28,43,32,22,137,9,18,19,8,9,63,200
CHHATTISGARH,2012,By Fire/Self Immolation,5,44,59,32,4,144,8,150,90,38,16,302,446
CHHATTISGARH,2012,By Fire-Arms,0,0,6,5,0,11,0,0,0,0,0,0,11
CHHATTISGARH,2012,By Hanging,14,590,634,434,151,1823,21,288,160,77,40,586,2409
CHHATTISGARH,2012,By Consuming Insecticides,8,214,183,119,36,560,11,134,87,40,18,290,850
CHHATTISGARH,2012,By Consuming Other Poison,2,115,106,58,16,297,5,83,33,17,4,142,439
CHHATTISGARH,2012,By Self Infliction of injury,1,15,3,3,0,22,2,13,5,5,1,26,48
CHHATTISGARH,2012,By Jumping from (Building),0,2,0,0,0,2,0,0,0,0,0,0,2
CHHATTISGARH,2012,By Jumping from (Other sites),0,0,0,0,0,0,0,0,0,0,1,1,1
CHHATTISGARH,2012,By Jumping off Moving Vehicles/Trains,0,0,1,0,0,1,0,0,0,0,0,0,1
CHHATTISGARH,2012,By Machine,0,0,0,0,0,0,0,1,0,0,0,1,1
CHHATTISGARH,2012,By Overdose of sleeping pills,0,0,0,0,0,0,0,0,0,0,0,0,0
CHHATTISGARH,2012,By touching electric wires,1,11,13,17,7,49,0,6,1,1,0,8,57
CHHATTISGARH,2012,By coming under running vehicles/trains,0,41,53,18,5,117,0,15,5,5,0,25,142
CHHATTISGARH,2012,By Other means (please specify),40,234,249,173,65,761,13,54,29,28,23,147,908
CHHATTISGARH,2012,Total,83,1304,1394,919,314,4014,78,766,443,232,121,1640,5654
CHHATTISGARH,2012,Total (Poison),11,344,292,180,52,879,18,230,125,62,23,458,1337
CHHATTISGARH,2012,Total (Jumping),0,2,0,0,0,2,0,0,0,0,1,1,3
GOA,2001,By Over Alcoholism,0,0,0,1,0,1,0,0,0,0,0,0,1
GOA,2001,By Drowning,0,5,14,7,7,33,1,8,11,4,6,30,63
GOA,2001,By Fire/Self Immolation,0,1,3,2,0,6,0,10,7,1,5,23,29
GOA,2001,By Fire-Arms,0,1,2,0,0,3,0,0,0,0,0,0,3
GOA,2001,By Hanging,0,25,38,18,5,86,1,7,10,1,3,22,108
GOA,2001,By Consuming Insecticides,0,0,3,0,1,4,0,1,0,0,1,2,6
GOA,2001,By Consuming Other Poison,0,5,7,3,1,16,1,4,4,0,0,9,25
GOA,2001,By Self Infliction of injury,0,0,3,1,0,4,0,0,0,0,0,0,4
GOA,2001,By Jumping from (Building),0,0,0,0,0,0,0,0,0,0,0,0,0
GOA,2001,By Jumping from (Other sites),0,0,0,0,0,0,0,0,0,0,0,0,0
GOA,2001,By Jumping off Moving Vehicles/Trains,0,0,0,0,0,0,0,0,0,0,0,0,0
GOA,2001,By Machine,0,0,0,0,0,0,0,0,0,0,0,0,0
GOA,2001,By Overdose of sleeping pills,0,0,1,0,0,1,0,0,0,0,0,0,1
GOA,2001,By touching electric wires,0,0,0,0,0,0,0,0,0,0,0,0,0
GOA,2001,By coming under running vehicles/trains,0,2,1,2,0,5,0,0,0,0,0,0,5
GOA,2001,By Other means (please specify),0,4,1,1,2,8,0,0,0,0,3,3,11
GOA,2001,Total,0,43,73,35,16,167,3,30,32,6,18,89,256
GOA,2001,Total (Poison),0,5,13,4,2,24,1,5,4,0,1,11,35
GOA,2001,Total (Jumping),0,0,0,0,0,0,0,0,0,0,0,0,0
GOA,2002,By Over Alcoholism,0,1,1,0,0,2,0,0,0,0,0,0,2
GOA,2002,By Drowning,0,8,18,2,5,33,2,1,9,3,2,17,50
GOA,2002,By Fire/Self Immolation,0,0,2,5,1,8,0,10,5,1,0,16,24
GOA,2002,By Fire-Arms,0,0,0,0,0,0,0,0,0,0,0,0,0
GOA,2002,By Hanging,0,44,47,21,7,119,0,13,6,1,1,21,140
GOA,2002,By Consuming Insecticides,0,3,4,3,0,10,0,2,1,0,0,3,13
GOA,2002,By Consuming Other Poison,0,9,11,7,2,29,0,7,4,0,1,12,41
GOA,2002,By Self Infliction of injury,0,0,0,1,0,1,0,0,0,0,0,0,1
GOA,2002,By Jumping from (Building),0,1,0,1,1,3,0,0,0,1,0,1,4
GOA,2002,By Jumping from (Other sites),0,3,1,0,0,4,0,2,0,0,1,3,7
GOA,2002,By Jumping off Moving Vehicles/Trains,0,1,0,0,0,1,0,0,0,0,0,0,1
GOA,2002,By Machine,0,0,0,0,0,0,0,0,0,0,0,0,0
GOA,2002,By Overdose of sleeping pills,0,0,0,0,1,1,0,0,0,0,0,0,1
GOA,2002,By touching electric wires,0,0,0,0,0,0,0,0,0,0,0,0,0
GOA,2002,By coming under running vehicles/trains,0,1,1,1,0,3,0,0,0,0,0,0,3
GOA,2002,By Other means,0,2,5,5,0,12,0,5,1,3,1,10,22
GOA,2002,Total,0,73,90,46,17,226,2,40,26,9,6,83,309
GOA,2002,Total (Poison),0,12,15,11,2,40,0,9,5,0,1,15,55
GOA,2002,Total (Jumping),0,4,1,1,1,7,0,2,0,1,1,4,11
GOA,2003,By Over Alcoholism,0,0,2,0,1,3,0,0,0,0,0,0,3
GOA,2003,By Drowning,0,11,19,11,2,43,1,19,6,0,2,28,71
GOA,2003,By Fire/Self Immolation,0,2,7,1,2,12,0,11,4,7,0,22,34
GOA,2003,By Fire-Arms,0,0,0,1,0,1,0,0,0,0,0,0,1
GOA,2003,By Hanging,0,36,55,21,9,121,2,9,5,1,0,17,138
GOA,2003,By Consuming Insecticides,0,5,4,5,0,14,0,4,0,0,0,4,18
GOA,2003,By Consuming Other Poison,0,3,3,3,0,9,0,4,3,1,0,8,17
GOA,2003,By Self Infliction of injury,0,0,0,0,0,0,0,0,0,0,0,0,0
GOA,2003,By Jumping from (Building),0,1,0,0,0,1,0,1,0,0,1,2,3
GOA,2003,By Jumping from (Other sites),0,1,0,0,0,1,0,0,0,0,0,0,1
GOA,2003,By Jumping off Moving Vehicles/Trains,0,0,2,0,0,2,0,0,0,0,0,0,2
GOA,2003,By Machine,0,0,0,0,0,0,0,0,0,0,0,0,0
GOA,2003,By Overdose of sleeping pills,0,0,0,0,0,0,0,0,0,1,0,1,1
GOA,2003,By touching electric wires,0,0,0,0,0,0,0,0,0,0,0,0,0
GOA,2003,By coming under running vehicles/trains,0,0,4,0,0,4,0,0,0,0,0,0,4
GOA,2003,By Other means (please specify),0,2,0,0,0,2,1,3,0,1,0,5,7
GOA,2003,Total,0,61,96,42,14,213,4,51,18,11,3,87,300
GOA,2003,Total (Poison),0,8,7,8,0,23,0,8,3,1,0,12,35
GOA,2003,Total (Jumping),0,2,0,0,0,2,0,1,0,0,1,2,4
GOA,2004,By Over Alcoholism,0,0,0,0,0,0,0,0,0,0,0,0,0
GOA,2004,By Drowning,2,13,12,9,4,40,0,10,7,1,4,22,62
GOA,2004,By Fire/Self Immolation,0,3,0,1,0,4,1,2,6,2,2,13,17
GOA,2004,By Fire-Arms,0,0,0,0,0,0,0,0,0,0,0,0,0
GOA,2004,By Hanging,1,43,52,27,0,123,2,21,6,7,0,36,159
GOA,2004,By Consuming Insecticides,0,1,5,0,0,6,0,5,0,1,0,6,12
GOA,2004,By Consuming Other Poison,0,6,4,6,2,18,0,7,5,1,0,13,31
GOA,2004,By Self Infliction of injury,0,0,0,0,1,1,0,1,0,0,0,1,2
GOA,2004,By Jumping from (Building),0,1,1,0,0,2,0,0,0,0,0,0,2
GOA,2004,By Jumping from (Other sites),0,0,1,0,0,1,0,0,0,0,0,0,1
GOA,2004,By Jumping off Moving Vehicles/Trains,0,0,0,0,0,0,0,0,0,0,0,0,0
GOA,2004,By Machine,0,0,0,0,0,0,0,0,0,0,0,0,0
GOA,2004,By Overdose of sleeping pills,0,1,0,0,0,1,0,0,0,1,0,1,2
GOA,2004,By touching electric wires,0,0,0,0,0,0,0,0,0,0,0,0,0
GOA,2004,By coming under running vehicles/trains,0,2,2,0,0,4,0,0,0,0,0,0,4
GOA,2004,By Other means (please specify),3,3,5,1,0,12,2,0,7,1,0,10,22
GOA,2004,Total,6,73,82,44,7,212,5,46,31,14,6,102,314
GOA,2004,Total (Poison),0,7,9,6,3,25,0,13,5,2,0,20,45
GOA,2004,Total (Jumping),0,1,2,0,0,3,0,0,0,0,0,0,3
GOA,2005,By Over Alcoholism,0,3,15,8,3,29,0,5,5,2,3,15,44
GOA,2005,By Drowning,0,3,6,1,0,10,0,4,0,2,1,7,17
GOA,2005,By Fire/Self Immolation,0,2,3,0,1,6,0,4,1,4,3,12,18
GOA,2005,By Fire-Arms,0,1,0,0,0,1,0,1,0,0,0,1,2
GOA,2005,By Hanging,2,38,49,24,8,121,1,16,6,6,4,33,154
GOA,2005,By Consuming Insecticides,0,2,0,1,0,3,0,1,0,0,0,1,4
GOA,2005,By Consuming Other Poison,0,4,5,4,1,14,1,3,2,0,0,6,20
GOA,2005,By Self Infliction of injury,0,0,1,0,1,2,0,0,0,0,0,0,2
GOA,2005,By Jumping from (Building),0,0,1,0,0,1,0,0,0,0,0,0,1
GOA,2005,By Jumping from (Other sites),0,0,1,0,1,2,0,0,0,0,0,0,2
GOA,2005,By Jumping off Moving Vehicles/Trains,0,0,0,0,0,0,0,0,0,0,0,0,0
GOA,2005,By Machine,0,0,0,0,0,0,0,0,0,0,0,0,0
GOA,2005,By Overdose of sleeping pills,0,0,0,0,0,0,0,2,0,0,0,2,2
GOA,2005,By touching electric wires,0,0,1,0,0,1,0,1,0,0,0,1,2
GOA,2005,By coming under running vehicles/trains,0,1,3,0,1,5,0,1,1,0,0,2,7
GOA,2005,By Other means (please specify),0,0,0,2,0,2,0,4,0,1,0,5,7
GOA,2005,Total,2,54,85,40,16,197,2,42,15,15,11,85,282
GOA,2005,Total (Poison),0,6,6,5,2,19,1,4,2,0,0,7,26
GOA,2005,Total (Jumping),0,0,2,0,1,3,0,0,0,0,0,0,3
GOA,2006,By Over Alcoholism,0,0,0,0,0,0,0,0,0,0,0,0,0
GOA,2006,By Drowning,0,6,15,7,4,32,2,11,6,5,2,26,58
GOA,2006,By Fire/Self Immolation,0,3,0,3,0,6,0,7,5,2,1,15,21
GOA,2006,By Fire-Arms,0,0,0,0,0,0,0,0,0,0,0,0,0
GOA,2006,By Hanging,1,37,40,23,6,107,1,12,6,3,4,26,133
GOA,2006,By Consuming Insecticides,0,4,1,2,1,8,1,5,0,2,1,9,17
GOA,2006,By Consuming Other Poison,0,4,7,3,1,15,1,5,1,0,0,7,22
GOA,2006,By Self Infliction of injury,0,1,1,1,0,3,0,0,0,0,0,0,3
GOA,2006,By Jumping from (Building),0,0,0,0,0,0,0,0,0,0,0,0,0
GOA,2006,By Jumping from (Other sites),0,0,0,0,0,0,0,0,0,0,1,1,1
GOA,2006,By Jumping off Moving Vehicles/Trains,0,2,0,0,0,2,0,0,0,0,0,0,2
GOA,2006,By Machine,0,0,0,0,0,0,0,0,0,0,0,0,0
GOA,2006,By Overdose of sleeping pills,0,0,0,0,0,0,0,0,0,0,0,0,0
GOA,2006,By touching electric wires,0,0,0,0,0,0,0,0,0,1,0,1,1
GOA,2006,By coming under running vehicles/trains,0,0,2,1,1,4,0,0,0,0,0,0,4
GOA,2006,By Other means (please specify),0,3,3,0,0,6,1,0,4,0,2,7,13
GOA,2006,Total,1,60,69,40,13,183,6,40,22,13,11,92,275
GOA,2006,Total (Poison),0,9,9,6,2,26,2,10,1,2,1,16,42
GOA,2006,Total (Jumping),0,0,0,0,0,0,0,0,0,0,1,1,1
GOA,2007,By Over Alcoholism,0,0,0,0,0,0,0,0,0,0,0,0,0
GOA,2007,By Drowning,0,10,15,11,3,39,0,10,3,5,0,18,57
GOA,2007,By Fire/Self Immolation,0,3,3,2,1,9,0,5,5,0,0,10,19
GOA,2007,By Fire-Arms,0,0,0,0,0,0,0,0,0,0,0,0,0
GOA,2007,By Hanging,1,29,43,15,6,94,2,15,12,5,4,38,132
GOA,2007,By Consuming Insecticides,0,5,5,3,6,19,0,7,1,1,0,9,28
GOA,2007,By Consuming Other Poison,0,2,2,3,1,8,0,4,2,1,0,7,15
GOA,2007,By Self Infliction of injury,0,0,0,0,0,0,0,0,0,0,0,0,0
GOA,2007,By Jumping from (Building),0,0,0,0,0,0,0,0,0,0,0,0,0
GOA,2007,By Jumping from (Other sites),0,0,0,0,0,0,0,0,0,0,0,0,0
GOA,2007,By Jumping off Moving Vehicles/Trains,0,0,0,0,0,0,0,0,0,0,0,0,0
GOA,2007,By Machine,0,0,0,0,0,0,0,0,0,0,0,0,0
GOA,2007,By Overdose of sleeping pills,0,0,0,0,0,0,0,0,0,0,0,0,0
GOA,2007,By touching electric wires,0,0,0,0,0,0,0,0,0,1,0,1,1
GOA,2007,By coming under running vehicles/trains,0,1,0,0,0,1,0,0,0,0,0,0,1
GOA,2007,By Other means (please specify),0,4,1,2,1,8,0,6,2,1,0,9,17
GOA,2007,Total,1,54,69,36,18,178,2,47,25,14,4,92,270
GOA,2007,Total (Poison),0,7,7,6,7,27,0,11,3,2,0,16,43
GOA,2007,Total (Jumping),0,0,0,0,0,0,0,0,0,0,0,0,0
GOA,2008,By Over Alcoholism,0,1,0,0,0,1,0,0,1,0,0,1,2
GOA,2008,By Drowning,0,9,12,4,2,27,0,9,6,4,5,24,51
GOA,2008,By Fire/Self Immolation,0,0,2,2,0,4,1,7,4,1,0,13,17
GOA,2008,By Fire-Arms,0,0,1,0,0,1,0,1,1,0,0,2,3
GOA,2008,By Hanging,0,35,60,19,7,121,1,27,7,2,4,41,162
GOA,2008,By Consuming Insecticides,0,2,2,0,0,4,1,2,1,0,0,4,8
GOA,2008,By Consuming Other Poison,0,3,5,3,1,12,0,4,1,0,0,5,17
GOA,2008,By Self Infliction of injury,0,0,0,0,0,0,0,0,0,0,0,0,0
GOA,2008,By Jumping from (Building),0,0,0,0,0,0,0,0,0,0,0,0,0
GOA,2008,By Jumping from (Other sites),0,1,0,0,2,3,0,1,2,2,1,6,9
GOA,2008,By Jumping off Moving Vehicles/Trains,0,0,0,0,0,0,0,0,0,0,0,0,0
GOA,2008,By Machine,0,0,0,0,0,0,0,0,0,0,0,0,0
GOA,2008,By Overdose of sleeping pills,0,1,1,0,1,3,0,0,1,0,0,1,4
GOA,2008,By touching electric wires,0,0,0,0,0,0,0,0,0,0,0,0,0
GOA,2008,By coming under running vehicles/trains,0,3,1,0,0,4,0,0,0,0,0,0,4
GOA,2008,By Other means (please specify),0,0,0,1,2,3,0,3,2,1,1,7,10
GOA,2008,Total,0,55,84,29,15,183,3,54,26,10,11,104,287
GOA,2008,Total (Poison),0,5,7,3,1,16,1,6,2,0,0,9,25
GOA,2008,Total (Jumping),0,1,0,0,2,3,0,1,2,2,1,6,9
GOA,2009,By Over Alcoholism,0,0,0,1,0,1,0,0,0,0,0,0,1
GOA,2009,By Drowning,0,3,11,3,6,23,0,3,6,4,3,16,39
GOA,2009,By Fire/Self Immolation,0,1,3,2,1,7,0,14,6,4,1,25,32
GOA,2009,By Fire-Arms,0,0,0,0,0,0,0,0,0,0,0,0,0
GOA,2009,By Hanging,1,42,46,31,5,125,2,21,6,4,2,35,160
GOA,2009,By Consuming Insecticides,0,0,3,2,1,6,0,4,0,1,0,5,11
GOA,2009,By Consuming Other Poison,0,1,3,1,2,7,0,1,1,0,1,3,10
GOA,2009,By Self Infliction of injury,0,0,0,0,0,0,0,0,0,0,0,0,0
GOA,2009,By Jumping from (Building),0,0,2,2,1,5,0,0,0,0,0,0,5
GOA,2009,By Jumping from (Other sites),0,2,1,0,1,4,0,0,0,0,0,0,4
GOA,2009,By Jumping off Moving Vehicles/Trains,0,0,0,0,0,0,0,0,0,0,0,0,0
GOA,2009,By Machine,0,0,0,0,0,0,0,0,0,0,0,0,0
GOA,2009,By Overdose of sleeping pills,0,1,0,1,0,2,0,1,0,0,0,1,3
GOA,2009,By touching electric wires,0,0,0,0,0,0,0,0,0,0,0,0,0
GOA,2009,By coming under running vehicles/trains,0,0,0,0,0,0,0,0,0,0,0,0,0
GOA,2009,By Other means (please specify),0,0,3,1,0,4,0,4,3,1,1,9,13
GOA,2009,Total,1,50,72,44,17,184,2,48,22,14,8,94,278
GOA,2009,Total (Poison),0,1,6,3,3,13,0,5,1,1,1,8,21
GOA,2009,Total (Jumping),0,2,3,2,2,9,0,0,0,0,0,0,9
GOA,2010,By Over Alcoholism,0,0,1,0,0,1,0,0,0,0,0,0,1
GOA,2010,By Drowning,0,8,7,10,8,33,0,3,5,4,10,22,55
GOA,2010,By Fire/Self Immolation,0,1,4,0,0,5,1,4,6,1,0,12,17
GOA,2010,By Fire-Arms,0,0,0,0,0,0,0,0,0,0,0,0,0
GOA,2010,By Hanging,2,41,49,46,10,148,2,19,5,1,5,32,180
GOA,2010,By Consuming Insecticides,0,2,1,1,2,6,0,2,0,0,0,2,8
GOA,2010,By Consuming Other Poison,0,11,11,2,1,25,0,5,3,1,0,9,34
GOA,2010,By Self Infliction of injury,0,1,1,0,0,2,0,0,0,0,0,0,2
GOA,2010,By Jumping from (Building),0,0,0,0,0,0,0,0,0,0,0,0,0
GOA,2010,By Jumping from (Other sites),0,2,2,0,0,4,0,0,0,0,0,0,4
GOA,2010,By Jumping off Moving Vehicles/Trains,0,0,0,1,0,1,0,0,0,0,0,0,1
GOA,2010,By Machine,0,0,0,0,0,0,0,0,0,0,0,0,0
GOA,2010,By Overdose of sleeping pills,0,0,0,1,0,1,0,0,0,1,0,1,2
GOA,2010,By touching electric wires,0,0,0,0,0,0,0,0,0,0,0,0,0
GOA,2010,By coming under running vehicles/trains,0,2,2,0,0,4,0,0,1,0,0,1,5
GOA,2010,By Other means (please specify),0,1,3,2,0,6,0,4,1,1,1,7,13
GOA,2010,Total,2,69,81,63,21,236,3,37,21,9,16,86,322
GOA,2010,Total (Poison),0,14,13,3,3,33,0,7,3,1,0,11,44
GOA,2010,Total (Jumping),0,2,2,0,0,4,0,0,0,0,0,0,4
GOA,2011,By Over Alcoholism,0,0,0,0,0,0,0,0,0,0,0,0,0
GOA,2011,By Drowning,0,2,12,9,1,24,0,2,2,2,3,9,33
GOA,2011,By Fire/Self Immolation,0,1,2,0,1,4,0,5,6,0,0,11,15
GOA,2011,By Fire-Arms,0,0,0,0,1,1,0,0,2,0,0,2,3
GOA,2011,By Hanging,3,36,53,24,9,125,1,25,10,5,3,44,169
GOA,2011,By Consuming Insecticides,0,2,0,0,1,3,0,5,0,0,0,5,8
GOA,2011,By Consuming Other Poison,1,6,9,3,2,21,1,6,4,0,1,12,33
GOA,2011,By Self Infliction of injury,0,0,0,0,0,0,0,0,0,0,0,0,0
GOA,2011,By Jumping from (Building),0,0,0,0,0,0,0,0,0,0,0,0,0
GOA,2011,By Jumping from (Other sites),0,1,1,0,0,2,0,0,0,1,0,1,3
GOA,2011,By Jumping off Moving Vehicles/Trains,0,0,1,0,0,1,0,0,0,0,0,0,1
GOA,2011,By Machine,0,0,0,0,0,0,0,0,0,0,0,0,0
GOA,2011,By Overdose of sleeping pills,0,0,0,1,1,2,0,1,0,0,1,2,4
GOA,2011,By touching electric wires,0,0,0,0,0,0,0,0,0,0,0,0,0
GOA,2011,By coming under running vehicles/trains,0,2,1,1,0,4,0,0,0,0,0,0,4
GOA,2011,By Other means (please specify),1,2,2,1,2,8,1,7,2,1,1,12,20
GOA,2011,Total,5,52,81,39,18,195,3,51,26,9,9,98,293
GOA,2011,Total (Poison),1,8,9,3,3,24,1,11,4,0,1,17,41
GOA,2011,Total (Jumping),0,1,1,0,0,2,0,0,0,1,0,1,3
GOA,2012,By Over Alcoholism,0,0,2,1,0,3,0,0,0,0,0,0,3
GOA,2012,By Drowning,2,6,8,5,0,21,3,4,8,3,3,21,42
GOA,2012,By Fire/Self Immolation,0,1,0,0,0,1,0,3,1,0,3,7,8
GOA,2012,By Fire-Arms,0,0,1,0,0,1,0,0,0,0,0,0,1
GOA,2012,By Hanging,2,38,58,30,14,142,0,20,14,3,5,42,184
GOA,2012,By Consuming Insecticides,0,0,0,1,0,1,0,0,1,0,0,1,2
GOA,2012,By Consuming Other Poison,1,5,3,3,0,12,0,4,0,1,0,5,17
GOA,2012,By Self Infliction of injury,0,0,0,0,1,1,0,0,0,0,0,0,1
GOA,2012,By Jumping from (Building),0,0,0,0,0,0,0,0,0,0,0,0,0
GOA,2012,By Jumping from (Other sites),0,2,0,1,1,4,0,0,0,0,0,0,4
GOA,2012,By Jumping off Moving Vehicles/Trains,0,0,0,0,0,0,0,0,0,0,0,0,0
GOA,2012,By Machine,0,0,0,0,0,0,0,0,0,0,0,0,0
GOA,2012,By Overdose of sleeping pills,0,0,0,0,0,0,0,2,1,0,0,3,3
GOA,2012,By touching electric wires,0,0,0,1,0,1,0,0,0,0,0,0,1
GOA,2012,By coming under running vehicles/trains,0,0,0,0,0,0,0,0,0,0,0,0,0
GOA,2012,By Other means (please specify),0,1,6,2,0,9,0,4,5,2,3,14,23
GOA,2012,Total,5,53,78,44,16,196,3,37,30,9,14,93,289
GOA,2012,Total (Poison),1,5,3,4,1,14,0,4,1,1,0,6,20
GOA,2012,Total (Jumping),0,2,0,1,1,4,0,0,0,0,0,0,4
GUJARAT,2001,By Over Alcoholism,0,2,2,2,1,7,0,1,0,0,0,1,8
GUJARAT,2001,By Drowning,12,41,52,25,11,141,11,52,41,8,4,116,257
GUJARAT,2001,By Fire/Self Immolation,9,96,136,50,23,314,11,256,191,78,65,601,915
GUJARAT,2001,By Fire-Arms,0,0,0,2,0,2,0,1,0,0,0,1,3
GUJARAT,2001,By Hanging,3,226,207,116,26,578,7,200,93,38,12,350,928
GUJARAT,2001,By Consuming Insecticides,11,282,197,101,22,613,19,211,146,56,31,463,1076
GUJARAT,2001,By Consuming Other Poison,2,271,272,107,34,686,9,250,128,48,18,453,1139
GUJARAT,2001,By Self Infliction of injury,0,12,20,3,0,35,0,14,6,3,2,25,60
GUJARAT,2001,By Jumping from (Building),0,5,8,7,1,21,0,2,4,3,2,11,32
GUJARAT,2001,By Jumping from (Other sites),0,3,2,1,0,6,0,2,2,0,0,4,10
GUJARAT,2001,By Jumping off Moving Vehicles/Trains,0,8,11,3,1,23,0,9,7,1,0,17,40
GUJARAT,2001,By Machine,0,0,3,0,0,3,0,0,0,0,0,0,3
GUJARAT,2001,By Overdose of sleeping pills,0,5,7,4,3,19,0,6,6,3,0,15,34
GUJARAT,2001,By touching electric wires,0,5,3,2,1,11,0,1,3,2,0,6,17
GUJARAT,2001,By coming under running vehicles/trains,0,31,68,23,8,130,1,18,12,6,2,39,169
GUJARAT,2001,By Other means (please specify),3,15,31,6,5,60,0,7,18,11,4,40,100
GUJARAT,2001,Total,40,1002,1019,452,136,2649,58,1030,657,257,140,2142,4791
GUJARAT,2001,Total (Poison),13,565,489,211,56,1334,28,475,280,107,51,941,2275
GUJARAT,2001,Total (Jumping),0,8,10,8,1,27,0,4,6,3,2,15,42
GUJARAT,2002,By Over Alcoholism,0,1,1,2,0,4,0,0,0,0,0,0,4
GUJARAT,2002,By Drowning,7,53,63,29,15,167,9,40,31,10,4,94,261
GUJARAT,2002,By Fire/Self Immolation,0,118,93,65,25,301,9,258,166,67,47,547,848
GUJARAT,2002,By Fire-Arms,0,9,1,3,0,13,0,0,2,0,0,2,15
GUJARAT,2002,By Hanging,5,259,271,117,25,677,4,192,101,50,17,364,1041
GUJARAT,2002,By Consuming Insecticides,7,241,229,122,31,630,4,200,112,58,19,393,1023
GUJARAT,2002,By Consuming Other Poison,4,254,243,113,31,645,10,225,143,63,8,449,1094
GUJARAT,2002,By Self Infliction of injury,0,4,2,3,1,10,0,0,0,0,0,0,10
GUJARAT,2002,By Jumping from (Building),0,5,6,6,0,17,0,0,1,0,1,2,19
GUJARAT,2002,By Jumping from (Other sites),0,2,3,1,0,6,0,2,1,0,0,3,9
GUJARAT,2002,By Jumping off Moving Vehicles/Trains,0,5,5,2,0,12,0,3,0,0,1,4,16
GUJARAT,2002,By Machine,0,1,0,0,0,1,0,0,0,0,0,0,1
GUJARAT,2002,By Overdose of sleeping pills,0,4,12,5,1,22,0,6,6,2,0,14,36
GUJARAT,2002,By touching electric wires,0,4,3,0,0,7,0,1,0,0,0,1,8
GUJARAT,2002,By coming under running vehicles/trains,0,45,48,33,10,136,1,12,9,2,1,25,161
GUJARAT,2002,By Other means,2,17,16,17,6,58,2,7,18,6,7,40,98
GUJARAT,2002,Total,25,1022,996,518,145,2706,39,946,590,258,105,1938,4644
GUJARAT,2002,Total (Poison),11,499,474,238,63,1285,14,425,255,121,27,842,2127
GUJARAT,2002,Total (Jumping),0,7,9,7,0,23,0,2,2,0,1,5,28
GUJARAT,2003,By Over Alcoholism,0,2,5,1,1,9,0,0,1,0,0,1,10
GUJARAT,2003,By Drowning,7,47,65,26,12,157,3,39,31,8,8,89,246
GUJARAT,2003,By Fire/Self Immolation,1,81,109,73,35,299,15,192,184,89,61,541,840
GUJARAT,2003,By Fire-Arms,0,2,2,2,1,7,1,3,0,1,0,5,12
GUJARAT,2003,By Hanging,2,242,290,144,37,715,8,184,119,41,21,373,1088
GUJARAT,2003,By Consuming Insecticides,3,259,217,131,36,646,4,240,116,75,39,474,1120
GUJARAT,2003,By Consuming Other Poison,4,231,204,96,31,566,11,162,91,35,19,318,884
GUJARAT,2003,By Self Infliction of injury,0,3,1,8,1,13,1,2,0,0,2,5,18
GUJARAT,2003,By Jumping from (Building),0,4,18,1,0,23,0,8,1,0,0,9,32
GUJARAT,2003,By Jumping from (Other sites),0,4,3,0,2,9,0,3,3,0,0,6,15
GUJARAT,2003,By Jumping off Moving Vehicles/Trains,1,5,7,2,0,15,0,1,4,1,0,6,21
GUJARAT,2003,By Machine,0,0,0,0,0,0,0,0,1,0,0,1,1
GUJARAT,2003,By Overdose of sleeping pills,0,2,5,3,2,12,0,3,1,0,3,7,19
GUJARAT,2003,By touching electric wires,1,2,3,0,0,6,0,2,0,0,0,2,8
GUJARAT,2003,By coming under running vehicles/trains,1,32,41,26,10,110,0,16,11,4,0,31,141
GUJARAT,2003,By Other means (please specify),2,15,26,10,10,63,0,18,18,6,6,48,111
GUJARAT,2003,Total,22,931,996,523,178,2650,43,873,581,260,159,1916,4566
GUJARAT,2003,Total (Poison),7,493,422,235,68,1225,16,404,207,110,60,797,2022
GUJARAT,2003,Total (Jumping),0,8,21,1,2,32,0,11,4,0,0,15,47
GUJARAT,2004,By Over Alcoholism,0,1,1,1,1,4,0,1,1,0,0,2,6
GUJARAT,2004,By Drowning,13,70,87,45,15,230,3,64,57,9,10,143,373
GUJARAT,2004,By Fire/Self Immolation,4,76,110,74,27,291,10,232,178,86,30,536,827
GUJARAT,2004,By Fire-Arms,0,4,11,9,0,24,1,5,2,1,0,9,33
GUJARAT,2004,By Hanging,7,267,293,149,34,750,3,197,133,34,18,385,1135
GUJARAT,2004,By Consuming Insecticides,3,252,224,151,57,687,5,227,104,76,33,445,1132
GUJARAT,2004,By Consuming Other Poison,1,210,191,106,31,539,6,150,99,41,11,307,846
GUJARAT,2004,By Self Infliction of injury,0,10,7,0,0,17,0,3,1,1,0,5,22
GUJARAT,2004,By Jumping from (Building),0,3,17,6,2,28,0,3,0,1,0,4,32
GUJARAT,2004,By Jumping from (Other sites),0,9,7,4,3,23,0,6,0,0,0,6,29
GUJARAT,2004,By Jumping off Moving Vehicles/Trains,0,8,3,0,0,11,0,0,1,0,0,1,12
GUJARAT,2004,By Machine,0,0,1,0,0,1,0,0,0,0,0,0,1
GUJARAT,2004,By Overdose of sleeping pills,0,6,6,7,2,21,1,3,2,1,1,8,29
GUJARAT,2004,By touching electric wires,0,10,4,5,0,19,0,1,2,1,0,4,23
GUJARAT,2004,By coming under running vehicles/trains,1,33,59,34,5,132,0,14,11,3,1,29,161
GUJARAT,2004,By Other means (please specify),5,29,16,20,3,73,0,21,13,3,5,42,115
GUJARAT,2004,Total,34,988,1037,611,180,2850,29,927,604,257,109,1926,4776
GUJARAT,2004,Total (Poison),4,472,422,257,88,1243,11,380,204,118,44,757,2000
GUJARAT,2004,Total (Jumping),0,12,24,10,5,51,0,9,0,1,0,10,61
GUJARAT,2005,By Over Alcoholism,0,0,2,1,1,4,0,0,0,0,0,0,4
GUJARAT,2005,By Drowning,4,88,95,41,20,248,3,75,45,12,7,142,390
GUJARAT,2005,By Fire/Self Immolation,2,75,101,80,16,274,5,174,152,67,39,437,711
GUJARAT,2005,By Fire-Arms,0,2,3,2,0,7,0,3,1,1,0,5,12
GUJARAT,2005,By Hanging,4,275,343,181,47,850,7,197,137,43,15,399,1249
GUJARAT,2005,By Consuming Insecticides,6,192,174,117,39,528,5,146,107,65,30,353,881
GUJARAT,2005,By Consuming Other Poison,4,235,232,105,38,614,8,189,108,54,18,377,991
GUJARAT,2005,By Self Infliction of injury,0,6,5,2,0,13,0,2,3,0,1,6,19
GUJARAT,2005,By Jumping from (Building),0,7,7,5,3,22,0,3,3,1,0,7,29
GUJARAT,2005,By Jumping from (Other sites),0,1,8,1,0,10,0,1,0,2,0,3,13
GUJARAT,2005,By Jumping off Moving Vehicles/Trains,0,2,2,4,0,8,0,0,0,0,0,0,8
GUJARAT,2005,By Machine,0,0,0,0,0,0,0,0,0,0,0,0,0
GUJARAT,2005,By Overdose of sleeping pills,0,7,9,5,0,21,0,4,0,1,0,5,26
GUJARAT,2005,By touching electric wires,0,8,6,1,0,15,0,1,3,0,0,4,19
GUJARAT,2005,By coming under running vehicles/trains,1,55,79,51,15,201,3,10,14,6,5,38,239
GUJARAT,2005,By Other means (please specify),4,27,16,27,13,87,2,46,28,7,4,87,174
GUJARAT,2005,Total,25,980,1082,623,192,2902,33,851,601,259,119,1863,4765
GUJARAT,2005,Total (Poison),10,433,411,224,77,1155,13,337,218,119,49,736,1891
GUJARAT,2005,Total (Jumping),0,8,15,6,3,32,0,4,3,3,0,10,42
GUJARAT,2006,By Over Alcoholism,0,0,2,0,0,2,0,0,0,0,0,0,2
GUJARAT,2006,By Drowning,3,74,101,61,22,261,2,64,52,11,6,135,396
GUJARAT,2006,By Fire/Self Immolation,1,69,110,81,19,280,3,236,161,77,50,527,807
GUJARAT,2006,By Fire-Arms,0,0,3,1,0,4,1,0,2,1,0,4,8
GUJARAT,2006,By Hanging,6,312,321,203,25,867,3,218,117,49,17,404,1271
GUJARAT,2006,By Consuming Insecticides,9,244,297,179,64,793,10,219,153,97,30,509,1302
GUJARAT,2006,By Consuming Other Poison,6,190,177,107,43,523,6,128,91,42,12,279,802
GUJARAT,2006,By Self Infliction of injury,0,2,2,2,0,6,0,3,0,0,0,3,9
GUJARAT,2006,By Jumping from (Building),0,10,9,2,4,25,0,2,6,1,0,9,34
GUJARAT,2006,By Jumping from (Other sites),0,2,4,1,1,8,0,3,1,0,0,4,12
GUJARAT,2006,By Jumping off Moving Vehicles/Trains,0,17,23,9,3,52,0,2,3,0,1,6,58
GUJARAT,2006,By Machine,0,1,0,0,0,1,0,0,0,0,0,0,1
GUJARAT,2006,By Overdose of sleeping pills,0,5,4,1,0,10,1,4,0,0,0,5,15
GUJARAT,2006,By touching electric wires,1,3,2,3,0,9,0,1,1,0,0,2,11
GUJARAT,2006,By coming under running vehicles/trains,0,25,45,26,13,109,0,15,8,8,3,34,143
GUJARAT,2006,By Other means (please specify),4,32,34,18,10,98,2,30,19,12,3,66,164
GUJARAT,2006,Total,30,986,1134,694,204,3048,28,925,614,298,122,1987,5035
GUJARAT,2006,Total (Poison),15,436,476,288,107,1322,16,350,244,139,42,791,2113
GUJARAT,2006,Total (Jumping),0,12,13,3,5,33,0,5,7,1,0,13,46
GUJARAT,2007,By Over Alcoholism,0,9,15,6,1,31,0,0,0,4,0,4,35
GUJARAT,2007,By Drowning,7,111,127,72,29,346,4,86,65,30,12,197,543
GUJARAT,2007,By Fire/Self Immolation,2,73,110,59,18,262,7,227,187,74,73,568,830
GUJARAT,2007,By Fire-Arms,0,1,2,1,1,5,0,0,0,0,0,0,5
GUJARAT,2007,By Hanging,7,379,381,153,32,952,6,250,143,45,10,454,1406
GUJARAT,2007,By Consuming Insecticides,8,280,296,181,80,845,12,254,141,85,36,528,1373
GUJARAT,2007,By Consuming Other Poison,3,211,184,111,25,534,4,134,91,48,16,293,827
GUJARAT,2007,By Self Infliction of injury,0,1,3,0,2,6,0,3,2,1,1,7,13
GUJARAT,2007,By Jumping from (Building),1,11,17,9,0,38,0,13,7,5,2,27,65
GUJARAT,2007,By Jumping from (Other sites),0,4,7,4,2,17,0,4,1,0,0,5,22
GUJARAT,2007,By Jumping off Moving Vehicles/Trains,0,3,4,0,0,7,0,1,0,1,0,2,9
GUJARAT,2007,By Machine,0,1,3,4,1,9,0,0,0,1,0,1,10
GUJARAT,2007,By Overdose of sleeping pills,0,5,7,12,1,25,0,4,2,0,5,11,36
GUJARAT,2007,By touching electric wires,0,9,11,1,0,21,0,2,5,3,0,10,31
GUJARAT,2007,By coming under running vehicles/trains,0,56,77,38,14,185,0,20,22,4,2,48,233
GUJARAT,2007,By Other means (please specify),5,35,22,22,8,92,2,14,22,10,2,50,142
GUJARAT,2007,Total,33,1189,1266,673,214,3375,35,1012,688,311,159,2205,5580
GUJARAT,2007,Total (Poison),11,492,483,292,107,1385,16,391,234,134,53,828,2213
GUJARAT,2007,Total (Jumping),1,15,24,13,2,55,0,17,8,5,2,32,87
GUJARAT,2008,By Over Alcoholism,0,1,7,5,0,13,0,0,0,0,0,0,13
GUJARAT,2008,By Drowning,6,118,125,62,21,332,3,80,58,26,12,179,511
GUJARAT,2008,By Fire/Self Immolation,1,84,149,58,26,318,6,263,201,92,67,629,947
GUJARAT,2008,By Fire-Arms,0,1,3,0,1,5,0,0,0,0,0,0,5
GUJARAT,2008,By Hanging,9,392,387,221,63,1072,6,282,159,71,9,527,1599
GUJARAT,2008,By Consuming Insecticides,5,310,362,190,62,929,10,253,177,71,45,556,1485
GUJARAT,2008,By Consuming Other Poison,1,212,220,130,46,609,6,160,132,63,22,383,992
GUJARAT,2008,By Self Infliction of injury,0,6,6,6,0,18,0,1,0,0,0,1,19
GUJARAT,2008,By Jumping from (Building),1,9,12,2,1,25,1,3,3,2,1,10,35
GUJARAT,2008,By Jumping from (Other sites),0,2,5,3,0,10,0,1,2,1,0,4,14
GUJARAT,2008,By Jumping off Moving Vehicles/Trains,0,2,3,1,0,6,1,3,0,1,0,5,11
GUJARAT,2008,By Machine,0,1,1,0,0,2,0,1,0,0,0,1,3
GUJARAT,2008,By Overdose of sleeping pills,0,2,14,29,9,54,0,13,10,10,2,35,89
GUJARAT,2008,By touching electric wires,0,14,9,6,0,29,0,0,2,0,1,3,32
GUJARAT,2008,By coming under running vehicles/trains,0,78,98,51,14,241,2,17,21,6,6,52,293
GUJARAT,2008,By Other means (please specify),2,18,21,23,8,72,4,13,21,4,3,45,117
GUJARAT,2008,Total,25,1250,1422,787,251,3735,39,1090,786,347,168,2430,6165
GUJARAT,2008,Total (Poison),6,528,588,326,108,1556,16,414,309,134,67,940,2496
GUJARAT,2008,Total (Jumping),1,11,17,5,1,35,1,4,5,3,1,14,49
GUJARAT,2009,By Over Alcoholism,0,3,6,5,0,14,0,0,0,0,0,0,14
GUJARAT,2009,By Drowning,4,99,107,56,17,283,2,76,52,19,9,158,441
GUJARAT,2009,By Fire/Self Immolation,5,129,150,61,34,379,4,313,202,88,55,662,1041
GUJARAT,2009,By Fire-Arms,0,0,2,2,0,4,0,0,0,0,0,0,4
GUJARAT,2009,By Hanging,5,406,399,219,48,1077,6,261,134,48,9,458,1535
GUJARAT,2009,By Consuming Insecticides,5,295,323,157,73,853,10,239,197,101,54,601,1454
GUJARAT,2009,By Consuming Other Poison,5,225,270,140,50,690,4,204,136,74,41,459,1149
GUJARAT,2009,By Self Infliction of injury,0,0,1,0,0,1,0,0,0,0,0,0,1
GUJARAT,2009,By Jumping from (Building),2,8,10,6,3,29,0,5,2,2,2,11,40
GUJARAT,2009,By Jumping from (Other sites),0,7,11,5,2,25,0,2,3,1,1,7,32
GUJARAT,2009,By Jumping off Moving Vehicles/Trains,0,3,2,1,2,8,0,5,3,0,0,8,16
GUJARAT,2009,By Machine,0,0,2,0,1,3,0,0,0,0,0,0,3
GUJARAT,2009,By Overdose of sleeping pills,0,10,0,9,0,19,0,8,18,2,0,28,47
GUJARAT,2009,By touching electric wires,0,3,10,3,0,16,0,0,1,0,0,1,17
GUJARAT,2009,By coming under running vehicles/trains,0,56,88,48,16,208,0,30,18,11,3,62,270
GUJARAT,2009,By Other means (please specify),1,11,23,25,2,62,4,16,5,2,3,30,92
GUJARAT,2009,Total,27,1255,1404,737,248,3671,30,1159,771,348,177,2485,6156
GUJARAT,2009,Total (Poison),10,520,594,297,123,1544,14,443,333,175,95,1060,2604
GUJARAT,2009,Total (Jumping),2,15,21,11,5,54,0,7,5,3,3,18,72
GUJARAT,2010,By Over Alcoholism,0,0,4,0,0,4,0,0,0,0,0,0,4
GUJARAT,2010,By Drowning,6,86,107,53,26,278,7,78,38,25,10,158,436
GUJARAT,2010,By Fire/Self Immolation,5,106,144,57,17,329,3,266,175,95,51,590,919
GUJARAT,2010,By Fire-Arms,0,4,1,2,0,7,0,5,0,0,1,6,13
GUJARAT,2010,By Hanging,7,401,361,200,49,1018,11,297,151,47,18,524,1542
GUJARAT,2010,By Consuming Insecticides,8,372,376,196,79,1031,8,256,198,97,34,593,1624
GUJARAT,2010,By Consuming Other Poison,5,203,204,139,54,605,6,141,103,71,34,355,960
GUJARAT,2010,By Self Infliction of injury,0,14,12,7,0,33,0,1,1,0,0,2,35
GUJARAT,2010,By Jumping from (Building),0,15,19,4,3,41,2,4,3,6,0,15,56
GUJARAT,2010,By Jumping from (Other sites),0,7,3,3,0,13,0,6,6,0,0,12,25
GUJARAT,2010,By Jumping off Moving Vehicles/Trains,0,11,17,3,2,33,0,2,0,1,0,3,36
GUJARAT,2010,By Machine,0,1,0,0,0,1,0,0,1,0,0,1,2
GUJARAT,2010,By Overdose of sleeping pills,0,2,2,2,2,8,0,0,0,0,1,1,9
GUJARAT,2010,By touching electric wires,1,7,7,6,0,21,0,3,0,0,1,4,25
GUJARAT,2010,By coming under running vehicles/trains,2,64,100,47,18,231,0,20,22,16,3,61,292
GUJARAT,2010,By Other means (please specify),3,50,55,39,13,160,5,26,24,9,5,69,229
GUJARAT,2010,Total,37,1343,1412,758,263,3813,42,1105,722,367,158,2394,6207
GUJARAT,2010,Total (Poison),13,589,592,342,133,1669,14,398,302,168,68,950,2619
GUJARAT,2010,Total (Jumping),0,22,22,7,3,54,2,10,9,6,0,27,81
GUJARAT,2011,By Over Alcoholism,0,1,2,0,0,3,0,0,0,0,0,0,3
GUJARAT,2011,By Drowning,5,90,99,61,19,274,5,68,46,39,6,164,438
GUJARAT,2011,By Fire/Self Immolation,2,95,121,69,30,317,2,216,172,95,55,540,857
GUJARAT,2011,By Fire-Arms,0,8,6,4,0,18,0,4,0,0,0,4,22
GUJARAT,2011,By Hanging,11,443,407,222,47,1130,18,281,185,75,26,585,1715
GUJARAT,2011,By Consuming Insecticides,7,389,370,221,80,1067,12,253,187,100,36,588,1655
GUJARAT,2011,By Consuming Other Poison,2,236,200,121,38,597,9,180,96,61,27,373,970
GUJARAT,2011,By Self Infliction of injury,0,14,18,5,1,38,0,1,2,0,0,3,41
GUJARAT,2011,By Jumping from (Building),2,13,16,4,2,37,1,9,10,2,1,23,60
GUJARAT,2011,By Jumping from (Other sites),1,27,29,4,3,64,2,22,3,3,0,30,94
GUJARAT,2011,By Jumping off Moving Vehicles/Trains,0,9,12,7,0,28,2,3,1,0,0,6,34
GUJARAT,2011,By Machine,0,0,0,0,0,0,0,0,2,0,0,2,2
GUJARAT,2011,By Overdose of sleeping pills,0,1,2,0,5,8,0,1,13,1,7,22,30
GUJARAT,2011,By touching electric wires,0,4,3,5,0,12,0,0,0,0,0,0,12
GUJARAT,2011,By coming under running vehicles/trains,3,64,88,56,21,232,0,25,19,11,4,59,291
GUJARAT,2011,By Other means (please specify),2,30,25,21,9,87,2,30,19,12,8,71,158
GUJARAT,2011,Total,35,1424,1398,800,255,3912,53,1093,755,399,170,2470,6382
GUJARAT,2011,Total (Poison),9,639,588,347,119,1702,21,434,285,161,63,964,2666
GUJARAT,2011,Total (Jumping),3,40,45,8,5,101,3,31,13,5,1,53,154
GUJARAT,2012,By Over Alcoholism,0,1,4,2,0,7,0,0,1,0,0,1,8
GUJARAT,2012,By Drowning,14,136,125,67,23,365,7,66,51,28,8,160,525
GUJARAT,2012,By Fire/Self Immolation,3,86,120,72,21,302,5,287,192,88,56,628,930
GUJARAT,2012,By Fire-Arms,0,2,3,1,1,7,0,5,0,0,0,5,12
GUJARAT,2012,By Hanging,9,578,476,220,71,1354,15,418,258,95,14,800,2154
GUJARAT,2012,By Consuming Insecticides,8,433,472,278,94,1285,13,305,225,135,38,716,2001
GUJARAT,2012,By Consuming Other Poison,1,153,161,76,25,416,1,93,58,58,26,236,652
GUJARAT,2012,By Self Infliction of injury,0,5,18,6,0,29,0,3,5,4,0,12,41
GUJARAT,2012,By Jumping from (Building),1,9,6,9,5,30,0,4,2,3,0,9,39
GUJARAT,2012,By Jumping from (Other sites),0,2,7,0,0,9,0,2,2,0,0,4,13
GUJARAT,2012,By Jumping off Moving Vehicles/Trains,2,5,8,3,1,19,0,1,0,0,0,1,20
GUJARAT,2012,By Machine,0,0,2,0,0,2,0,0,0,0,0,0,2
GUJARAT,2012,By Overdose of sleeping pills,0,3,11,13,1,28,0,4,5,2,1,12,40
GUJARAT,2012,By touching electric wires,2,5,6,1,0,14,0,0,0,0,0,0,14
GUJARAT,2012,By coming under running vehicles/trains,0,75,121,73,29,298,0,34,16,6,1,57,355
GUJARAT,2012,By Other means (please specify),12,61,48,61,15,197,16,24,29,30,8,107,304
GUJARAT,2012,Total,52,1554,1588,882,286,4362,57,1246,844,449,152,2748,7110
GUJARAT,2012,Total (Poison),9,591,651,360,119,1730,14,401,288,197,64,964,2694
GUJARAT,2012,Total (Jumping),1,11,13,9,5,39,0,6,4,3,0,13,52
HARYANA,2001,By Over Alcoholism,0,4,15,8,0,27,0,0,0,1,0,1,28
HARYANA,2001,By Drowning,14,29,31,11,4,89,3,16,16,1,1,37,126
HARYANA,2001,By Fire/Self Immolation,1,52,51,23,3,130,3,58,59,11,7,138,268
HARYANA,2001,By Fire-Arms,0,6,2,1,6,15,0,0,0,0,0,0,15
HARYANA,2001,By Hanging,4,125,81,29,6,245,0,40,21,5,0,66,311
HARYANA,2001,By Consuming Insecticides,8,93,64,27,15,207,4,51,28,12,1,96,303
HARYANA,2001,By Consuming Other Poison,6,134,146,57,12,355,6,105,57,9,4,181,536
HARYANA,2001,By Self Infliction of injury,0,1,0,2,0,3,0,0,0,0,0,0,3
HARYANA,2001,By Jumping from (Building),0,1,0,1,0,2,0,0,0,0,0,0,2
HARYANA,2001,By Jumping from (Other sites),0,0,0,1,0,1,0,0,1,0,1,2,3
HARYANA,2001,By Jumping off Moving Vehicles/Trains,0,1,4,2,0,7,0,0,0,0,0,0,7
HARYANA,2001,By Machine,0,4,2,0,0,6,0,0,0,0,0,0,6
HARYANA,2001,By Overdose of sleeping pills,0,0,0,0,0,0,0,0,0,0,0,0,0
HARYANA,2001,By touching electric wires,0,13,15,8,0,36,0,4,0,0,0,4,40
HARYANA,2001,By coming under running vehicles/trains,1,28,47,45,8,129,0,40,30,9,6,85,214
HARYANA,2001,By Other means (please specify),0,28,41,21,22,112,4,8,8,8,5,33,145
HARYANA,2001,Total,34,519,499,236,76,1364,20,322,220,56,25,643,2007
HARYANA,2001,Total (Poison),14,228,210,86,27,565,10,156,85,21,5,277,842
HARYANA,2001,Total (Jumping),0,1,0,2,0,3,0,0,1,0,1,2,5
HARYANA,2002,By Over Alcoholism,0,3,18,7,0,28,0,0,0,0,0,0,28
HARYANA,2002,By Drowning,5,36,35,17,6,99,3,19,13,0,0,35,134
HARYANA,2002,By Fire/Self Immolation,1,28,27,23,3,82,0,62,36,9,2,109,191
HARYANA,2002,By Fire-Arms,0,4,3,4,3,14,0,0,0,0,0,0,14
HARYANA,2002,By Hanging,3,103,81,31,8,226,0,37,22,3,0,62,288
HARYANA,2002,By Consuming Insecticides,4,71,41,18,11,145,0,31,17,5,1,54,199
HARYANA,2002,By Consuming Other Poison,5,144,168,57,22,396,7,109,56,17,3,192,588
HARYANA,2002,By Self Infliction of injury,0,8,2,0,0,10,0,3,3,0,0,6,16
HARYANA,2002,By Jumping from (Building),0,1,2,0,0,3,0,0,0,0,0,0,3
HARYANA,2002,By Jumping from (Other sites),0,1,3,0,0,4,0,1,2,1,0,4,8
HARYANA,2002,By Jumping off Moving Vehicles/Trains,0,1,2,1,0,4,0,0,0,0,0,0,4
HARYANA,2002,By Machine,0,4,4,4,0,12,0,0,0,0,0,0,12
HARYANA,2002,By Overdose of sleeping pills,0,3,2,0,0,5,0,2,0,0,0,2,7
HARYANA,2002,By touching electric wires,5,11,18,8,1,43,0,2,4,1,0,7,50
HARYANA,2002,By coming under running vehicles/trains,1,36,117,55,8,217,1,41,30,9,5,86,303
HARYANA,2002,By Other means,12,76,100,71,23,282,9,30,20,8,6,73,355
HARYANA,2002,Total,36,530,623,296,85,1570,20,337,203,53,17,630,2200
HARYANA,2002,Total (Poison),9,223,211,75,33,551,7,143,76,22,4,252,803
HARYANA,2002,Total (Jumping),0,2,5,0,0,7,0,1,2,1,0,4,11
HARYANA,2003,By Over Alcoholism,0,6,11,10,4,31,0,0,0,0,0,0,31
HARYANA,2003,By Drowning,11,42,44,18,7,122,3,12,13,2,1,31,153
HARYANA,2003,By Fire/Self Immolation,0,22,31,14,4,71,2,64,38,10,3,117,188
HARYANA,2003,By Fire-Arms,0,8,7,6,3,24,0,4,3,1,0,8,32
HARYANA,2003,By Hanging,3,125,88,41,10,267,3,45,20,10,2,80,347
HARYANA,2003,By Consuming Insecticides,3,123,126,49,13,314,2,45,29,14,3,93,407
HARYANA,2003,By Consuming Other Poison,4,121,80,29,16,250,6,72,29,12,2,121,371
HARYANA,2003,By Self Infliction of injury,0,15,12,11,7,45,0,0,1,1,0,2,47
HARYANA,2003,By Jumping from (Building),0,0,2,1,0,3,0,0,0,0,0,0,3
HARYANA,2003,By Jumping from (Other sites),0,7,4,0,1,12,0,3,1,1,1,6,18
HARYANA,2003,By Jumping off Moving Vehicles/Trains,0,1,3,2,1,7,0,0,0,0,0,0,7
HARYANA,2003,By Machine,0,4,5,4,0,13,0,0,0,0,0,0,13
HARYANA,2003,By Overdose of sleeping pills,0,4,1,0,0,5,0,2,0,0,0,2,7
HARYANA,2003,By touching electric wires,2,11,15,9,3,40,1,2,2,1,0,6,46
HARYANA,2003,By coming under running vehicles/trains,4,16,11,9,7,47,2,1,2,0,1,6,53
HARYANA,2003,By Other means (please specify),7,71,162,95,27,362,6,64,47,14,11,142,504
HARYANA,2003,Total,34,576,602,298,103,1613,25,314,185,66,24,614,2227
HARYANA,2003,Total (Poison),7,259,218,89,36,609,8,117,59,27,5,216,825
HARYANA,2003,Total (Jumping),0,7,6,1,1,15,0,3,1,1,1,6,21
HARYANA,2004,By Over Alcoholism,0,5,10,6,2,23,0,0,0,0,0,0,23
HARYANA,2004,By Drowning,11,39,42,17,4,113,1,11,8,7,3,30,143
HARYANA,2004,By Fire/Self Immolation,0,18,10,6,3,37,0,40,40,10,1,91,128
HARYANA,2004,By Fire-Arms,0,5,7,4,3,19,0,0,1,0,0,1,20
HARYANA,2004,By Hanging,0,104,94,54,11,263,4,48,24,6,2,84,347
HARYANA,2004,By Consuming Insecticides,3,81,93,30,12,219,4,38,29,6,0,77,296
HARYANA,2004,By Consuming Other Poison,2,78,47,26,19,172,4,48,32,9,0,93,265
HARYANA,2004,By Self Infliction of injury,0,10,4,1,0,15,0,4,4,1,0,9,24
HARYANA,2004,By Jumping from (Building),0,1,2,0,0,3,0,0,0,0,0,0,3
HARYANA,2004,By Jumping from (Other sites),0,4,6,2,0,12,0,0,1,0,0,1,13
HARYANA,2004,By Jumping off Moving Vehicles/Trains,0,4,5,2,0,11,0,0,0,0,0,0,11
HARYANA,2004,By Machine,0,0,4,1,0,5,0,0,0,0,0,0,5
HARYANA,2004,By Overdose of sleeping pills,3,2,8,2,3,18,0,3,0,2,0,5,23
HARYANA,2004,By touching electric wires,3,44,109,52,11,219,0,43,29,11,6,89,308
HARYANA,2004,By coming under running vehicles/trains,1,15,14,5,3,38,0,1,1,1,1,4,42
HARYANA,2004,By Other means (please specify),11,106,89,47,34,287,9,71,35,19,10,144,431
HARYANA,2004,Total,34,516,544,255,105,1454,22,307,204,72,23,628,2082
HARYANA,2004,Total (Poison),5,169,144,57,31,406,8,90,65,16,0,179,585
HARYANA,2004,Total (Jumping),0,5,8,2,0,15,0,0,1,0,0,1,16
HARYANA,2005,By Over Alcoholism,0,5,13,14,0,32,0,0,0,0,0,0,32
HARYANA,2005,By Drowning,10,33,44,15,4,106,1,10,10,9,0,30,136
HARYANA,2005,By Fire/Self Immolation,0,29,27,12,11,79,3,43,59,20,2,127,206
HARYANA,2005,By Fire-Arms,0,3,1,0,0,4,0,1,0,0,0,1,5
HARYANA,2005,By Hanging,1,111,86,37,4,239,0,36,25,7,2,70,309
HARYANA,2005,By Consuming Insecticides,1,40,39,11,3,94,0,13,7,1,0,21,115
HARYANA,2005,By Consuming Other Poison,7,108,103,35,15,268,1,67,29,5,4,106,374
HARYANA,2005,By Self Infliction of injury,0,8,6,7,1,22,0,5,3,1,0,9,31
HARYANA,2005,By Jumping from (Building),2,2,2,1,1,8,0,0,0,0,0,0,8
HARYANA,2005,By Jumping from (Other sites),0,1,3,0,0,4,0,0,0,0,0,0,4
HARYANA,2005,By Jumping off Moving Vehicles/Trains,2,3,4,0,0,9,0,0,0,0,0,0,9
HARYANA,2005,By Machine,0,0,4,0,0,4,0,0,0,0,0,0,4
HARYANA,2005,By Overdose of sleeping pills,0,0,0,0,0,0,0,0,0,1,0,1,1
HARYANA,2005,By touching electric wires,1,75,111,49,9,245,0,40,31,12,8,91,336
HARYANA,2005,By coming under running vehicles/trains,2,4,5,0,0,11,1,1,0,0,0,2,13
HARYANA,2005,By Other means (please specify),2,88,160,93,25,368,9,41,23,20,2,95,463
HARYANA,2005,Total,28,510,608,274,73,1493,15,257,187,76,18,553,2046
HARYANA,2005,Total (Poison),8,156,148,53,19,384,1,85,39,7,4,136,520
HARYANA,2005,Total (Jumping),2,3,5,1,1,12,0,0,0,0,0,0,12
HARYANA,2006,By Over Alcoholism,0,3,19,20,0,42,0,0,0,0,0,0,42
HARYANA,2006,By Drowning,7,55,27,23,5,117,3,6,9,3,1,22,139
HARYANA,2006,By Fire/Self Immolation,1,17,19,9,2,48,0,37,29,15,4,85,133
HARYANA,2006,By Fire-Arms,0,3,3,1,0,7,0,0,1,0,0,1,8
HARYANA,2006,By Hanging,2,112,108,41,8,271,2,49,24,9,0,84,355
HARYANA,2006,By Consuming Insecticides,2,83,81,30,5,201,3,37,24,7,2,73,274
HARYANA,2006,By Consuming Other Poison,4,129,95,53,13,294,2,54,34,9,5,104,398
HARYANA,2006,By Self Infliction of injury,0,8,5,0,0,13,1,3,0,0,0,4,17
HARYANA,2006,By Jumping from (Building),1,4,6,2,1,14,0,1,1,0,0,2,16
HARYANA,2006,By Jumping from (Other sites),0,11,11,4,1,27,0,3,1,0,0,4,31
HARYANA,2006,By Jumping off Moving Vehicles/Trains,0,0,0,0,0,0,0,0,0,0,0,0,0
HARYANA,2006,By Machine,0,2,1,1,0,4,0,0,0,0,0,0,4
HARYANA,2006,By Overdose of sleeping pills,0,0,1,0,1,2,0,0,0,0,0,0,2
HARYANA,2006,By touching electric wires,0,39,12,4,2,57,0,3,0,0,0,3,60
HARYANA,2006,By coming under running vehicles/trains,0,36,179,65,16,296,2,38,30,12,7,89,385
HARYANA,2006,By Other means (please specify),8,108,134,85,38,373,8,21,24,16,10,79,452
HARYANA,2006,Total,25,610,701,338,92,1766,21,252,177,71,29,550,2316
HARYANA,2006,Total (Poison),6,220,181,83,18,508,6,94,58,16,7,181,689
HARYANA,2006,Total (Jumping),1,15,17,6,2,41,0,4,2,0,0,6,47
HARYANA,2007,By Over Alcoholism,0,8,24,8,3,43,0,0,0,0,0,0,43
HARYANA,2007,By Drowning,6,20,32,7,6,71,0,10,9,2,1,22,93
HARYANA,2007,By Fire/Self Immolation,1,12,26,13,3,55,1,48,29,9,4,91,146
HARYANA,2007,By Fire-Arms,0,0,3,3,0,6,0,0,0,0,0,0,6
HARYANA,2007,By Hanging,0,150,148,24,6,328,1,66,28,6,4,105,433
HARYANA,2007,By Consuming Insecticides,5,85,128,52,17,287,2,48,21,5,0,76,363
HARYANA,2007,By Consuming Other Poison,2,91,57,40,13,203,1,35,28,22,2,88,291
HARYANA,2007,By Self Infliction of injury,1,17,15,4,4,41,0,3,1,0,0,4,45
HARYANA,2007,By Jumping from (Building),0,2,2,4,0,8,0,0,3,0,0,3,11
HARYANA,2007,By Jumping from (Other sites),0,3,1,2,2,8,0,1,0,0,0,1,9
HARYANA,2007,By Jumping off Moving Vehicles/Trains,0,0,0,0,0,0,0,0,0,0,0,0,0
HARYANA,2007,By Machine,0,0,0,0,0,0,0,0,0,0,0,0,0
HARYANA,2007,By Overdose of sleeping pills,0,4,2,1,1,8,1,2,2,0,0,5,13
HARYANA,2007,By touching electric wires,1,25,19,9,2,56,0,1,3,0,0,4,60
HARYANA,2007,By coming under running vehicles/trains,0,96,131,88,6,321,0,30,27,8,3,68,389
HARYANA,2007,By Other means (please specify),12,147,132,85,41,417,2,69,21,13,9,114,531
HARYANA,2007,Total,28,660,720,340,104,1852,8,313,172,65,23,581,2433
HARYANA,2007,Total (Poison),8,193,200,96,34,531,3,86,50,27,2,168,699
HARYANA,2007,Total (Jumping),0,5,3,6,2,16,0,1,3,0,0,4,20
HARYANA,2008,By Over Alcoholism,0,5,6,1,0,12,0,1,0,0,0,1,13
HARYANA,2008,By Drowning,9,25,39,16,6,95,5,7,12,5,1,30,125
HARYANA,2008,By Fire/Self Immolation,0,26,22,7,2,57,0,39,31,5,5,80,137
HARYANA,2008,By Fire-Arms,0,6,2,2,0,10,0,1,0,0,0,1,11
HARYANA,2008,By Hanging,4,175,195,55,22,451,3,65,40,13,0,121,572
HARYANA,2008,By Consuming Insecticides,0,65,57,28,4,154,2,29,23,3,2,59,213
HARYANA,2008,By Consuming Other Poison,4,127,132,99,15,377,3,58,94,29,5,189,566
HARYANA,2008,By Self Infliction of injury,0,0,0,0,0,0,0,0,0,0,0,0,0
HARYANA,2008,By Jumping from (Building),0,2,1,0,0,3,0,2,0,0,0,2,5
HARYANA,2008,By Jumping from (Other sites),0,14,9,12,1,36,0,4,4,0,1,9,45
HARYANA,2008,By Jumping off Moving Vehicles/Trains,0,2,1,0,0,3,0,0,0,0,0,0,3
HARYANA,2008,By Machine,0,0,0,0,0,0,0,0,0,0,0,0,0
HARYANA,2008,By Overdose of sleeping pills,0,2,3,0,0,5,0,0,1,0,0,1,6
HARYANA,2008,By touching electric wires,2,12,16,6,1,37,0,0,2,1,0,3,40
HARYANA,2008,By coming under running vehicles/trains,1,6,9,4,2,22,0,2,1,0,0,3,25
HARYANA,2008,By Other means (please specify),27,220,282,92,91,712,26,66,47,29,15,183,895
HARYANA,2008,Total,47,687,774,322,144,1974,39,274,255,85,29,682,2656
HARYANA,2008,Total (Poison),4,192,189,127,19,531,5,87,117,32,7,248,779
HARYANA,2008,Total (Jumping),0,16,10,12,1,39,0,6,4,0,1,11,50
HARYANA,2009,By Over Alcoholism,0,4,6,5,0,15,0,0,0,0,0,0,15
HARYANA,2009,By Drowning,5,30,28,18,4,85,0,6,6,4,1,17,102
HARYANA,2009,By Fire/Self Immolation,1,44,35,15,10,105,2,62,45,16,4,129,234
HARYANA,2009,By Fire-Arms,0,2,3,1,0,6,0,0,0,0,0,0,6
HARYANA,2009,By Hanging,2,162,136,60,10,370,0,75,39,14,2,130,500
HARYANA,2009,By Consuming Insecticides,1,61,64,27,4,157,5,26,16,2,0,49,206
HARYANA,2009,By Consuming Other Poison,3,133,149,74,11,370,4,60,89,36,7,196,566
HARYANA,2009,By Self Infliction of injury,0,1,0,0,0,1,0,0,0,0,0,0,1
HARYANA,2009,By Jumping from (Building),0,7,9,3,0,19,0,3,6,0,0,9,28
HARYANA,2009,By Jumping from (Other sites),0,1,0,0,2,3,0,0,0,0,0,0,3
HARYANA,2009,By Jumping off Moving Vehicles/Trains,0,0,0,0,0,0,0,0,0,0,0,0,0
HARYANA,2009,By Machine,0,1,1,0,0,2,0,2,0,1,0,3,5
HARYANA,2009,By Overdose of sleeping pills,0,3,2,0,0,5,0,0,0,0,0,0,5
HARYANA,2009,By touching electric wires,0,14,7,2,0,23,0,3,1,0,0,4,27
HARYANA,2009,By coming under running vehicles/trains,0,17,14,8,2,41,1,0,1,0,0,2,43
HARYANA,2009,By Other means (please specify),26,212,205,125,45,613,22,57,42,22,6,149,762
HARYANA,2009,Total,38,692,659,338,88,1815,34,294,245,95,20,688,2503
HARYANA,2009,Total (Poison),4,195,213,101,15,528,9,86,105,38,7,245,773
HARYANA,2009,Total (Jumping),0,8,9,3,2,22,0,3,6,0,0,9,31
HARYANA,2010,By Over Alcoholism,0,28,21,21,3,73,0,1,1,0,0,2,75
HARYANA,2010,By Drowning,8,43,35,11,7,104,3,15,11,6,3,38,142
HARYANA,2010,By Fire/Self Immolation,2,44,40,19,2,107,1,67,61,21,5,155,262
HARYANA,2010,By Fire-Arms,0,3,3,1,0,7,0,0,0,0,0,0,7
HARYANA,2010,By Hanging,2,191,116,49,5,363,1,66,28,5,0,100,463
HARYANA,2010,By Consuming Insecticides,1,81,80,57,9,228,3,38,15,5,3,64,292
HARYANA,2010,By Consuming Other Poison,2,149,138,59,15,363,2,72,70,47,4,195,558
HARYANA,2010,By Self Infliction of injury,0,2,0,0,0,2,0,0,0,0,0,0,2
HARYANA,2010,By Jumping from (Building),0,8,8,2,1,19,0,4,1,0,0,5,24
HARYANA,2010,By Jumping from (Other sites),0,0,5,2,0,7,0,0,0,0,0,0,7
HARYANA,2010,By Jumping off Moving Vehicles/Trains,0,0,0,0,0,0,0,0,0,0,0,0,0
HARYANA,2010,By Machine,0,2,0,0,0,2,0,0,0,0,0,0,2
HARYANA,2010,By Overdose of sleeping pills,0,0,1,0,0,1,0,0,0,0,0,0,1
HARYANA,2010,By touching electric wires,0,27,23,12,0,62,0,1,1,0,0,2,64
HARYANA,2010,By coming under running vehicles/trains,1,27,15,9,3,55,1,2,1,3,2,9,64
HARYANA,2010,By Other means (please specify),8,234,253,213,77,785,6,54,53,22,12,147,932
HARYANA,2010,Total,24,839,738,455,122,2178,17,320,242,109,29,717,2895
HARYANA,2010,Total (Poison),3,232,218,116,24,593,5,110,85,52,7,259,852
HARYANA,2010,Total (Jumping),0,8,13,4,1,26,0,4,1,0,0,5,31
HARYANA,2011,By Over Alcoholism,0,7,17,9,2,35,0,0,0,0,0,0,35
HARYANA,2011,By Drowning,11,67,57,34,11,180,3,23,13,2,0,41,221
HARYANA,2011,By Fire/Self Immolation,1,29,49,24,2,105,0,67,51,10,5,133,238
HARYANA,2011,By Fire-Arms,0,7,2,3,0,12,0,0,1,0,0,1,13
HARYANA,2011,By Hanging,2,218,140,35,8,403,0,87,38,9,2,136,539
HARYANA,2011,By Consuming Insecticides,0,88,78,35,4,205,1,58,17,5,1,82,287
HARYANA,2011,By Consuming Other Poison,10,141,148,78,9,386,2,85,72,52,5,216,602
HARYANA,2011,By Self Infliction of injury,0,0,1,1,0,2,0,0,0,0,0,0,2
HARYANA,2011,By Jumping from (Building),0,4,5,1,0,10,0,0,2,0,0,2,12
HARYANA,2011,By Jumping from (Other sites),1,3,5,2,1,12,0,1,1,0,0,2,14
HARYANA,2011,By Jumping off Moving Vehicles/Trains,0,0,0,0,0,0,0,0,0,0,0,0,0
HARYANA,2011,By Machine,0,2,6,0,0,8,0,0,0,1,0,1,9
HARYANA,2011,By Overdose of sleeping pills,0,6,1,0,0,7,0,3,1,0,0,4,11
HARYANA,2011,By touching electric wires,0,20,23,9,1,53,0,0,0,1,0,1,54
HARYANA,2011,By coming under running vehicles/trains,0,9,4,3,1,17,0,0,2,0,0,2,19
HARYANA,2011,By Other means (please specify),45,360,349,207,68,1029,19,56,54,27,4,160,1189
HARYANA,2011,Total,70,961,885,441,107,2464,25,380,252,107,17,781,3245
HARYANA,2011,Total (Poison),10,229,227,114,13,593,3,143,89,57,6,298,891
HARYANA,2011,Total (Jumping),1,7,10,3,1,22,0,1,3,0,0,4,26
HARYANA,2012,By Over Alcoholism,0,14,21,18,6,59,1,0,0,1,0,2,61
HARYANA,2012,By Drowning,5,36,39,19,6,105,1,16,8,3,1,29,134
HARYANA,2012,By Fire/Self Immolation,5,13,50,14,7,89,2,38,27,10,3,80,169
HARYANA,2012,By Fire-Arms,0,0,5,3,0,8,0,1,1,0,0,2,10
HARYANA,2012,By Hanging,8,247,155,47,4,461,1,122,54,15,0,192,653
HARYANA,2012,By Consuming Insecticides,0,80,81,35,7,203,3,39,21,8,3,74,277
HARYANA,2012,By Consuming Other Poison,5,103,118,78,22,326,4,82,77,36,13,212,538
HARYANA,2012,By Self Infliction of injury,0,0,1,0,0,1,0,0,0,0,0,0,1
HARYANA,2012,By Jumping from (Building),0,10,16,4,2,32,0,6,3,0,0,9,41
HARYANA,2012,By Jumping from (Other sites),1,3,6,3,0,13,0,0,3,0,0,3,16
HARYANA,2012,By Jumping off Moving Vehicles/Trains,0,1,0,0,0,1,0,0,0,0,0,0,1
HARYANA,2012,By Machine,0,1,0,0,0,1,0,0,0,0,0,0,1
HARYANA,2012,By Overdose of sleeping pills,0,4,1,0,1,6,0,0,0,0,0,0,6
HARYANA,2012,By touching electric wires,0,27,24,11,4,66,2,6,1,0,1,10,76
HARYANA,2012,By coming under running vehicles/trains,0,2,0,1,0,3,0,0,0,0,0,0,3
HARYANA,2012,By Other means (please specify),19,225,220,164,69,697,14,47,39,30,13,143,840
HARYANA,2012,Total,43,766,737,397,128,2071,28,357,234,103,34,756,2827
HARYANA,2012,Total (Poison),5,183,200,113,29,530,7,121,98,44,16,286,816
HARYANA,2012,Total (Jumping),1,13,22,7,2,45,0,6,6,0,0,12,57
HIMACHAL PRADESH,2001,By Over Alcoholism,0,0,0,2,1,3,0,0,0,0,0,0,3
HIMACHAL PRADESH,2001,By Drowning,0,2,2,1,0,5,1,2,1,0,0,4,9
HIMACHAL PRADESH,2001,By Fire/Self Immolation,0,1,1,0,0,2,0,6,4,0,0,10,12
HIMACHAL PRADESH,2001,By Fire-Arms,0,0,1,1,0,2,0,0,0,0,0,0,2
HIMACHAL PRADESH,2001,By Hanging,0,8,13,7,0,28,0,8,1,0,0,9,37
HIMACHAL PRADESH,2001,By Consuming Insecticides,0,19,30,16,2,67,2,19,15,3,0,39,106
HIMACHAL PRADESH,2001,By Consuming Other Poison,0,21,12,18,0,51,0,33,15,11,5,64,115
HIMACHAL PRADESH,2001,By Self Infliction of injury,0,0,0,0,0,0,0,0,0,0,0,0,0
HIMACHAL PRADESH,2001,By Jumping from (Building),0,0,1,0,0,1,0,0,0,0,0,0,1
HIMACHAL PRADESH,2001,By Jumping from (Other sites),0,0,1,1,0,2,0,0,2,0,0,2,4
HIMACHAL PRADESH,2001,By Jumping off Moving Vehicles/Trains,0,0,0,0,1,1,0,0,0,0,0,0,1
HIMACHAL PRADESH,2001,By Machine,0,0,0,0,0,0,0,0,0,0,0,0,0
HIMACHAL PRADESH,2001,By Overdose of sleeping pills,0,0,0,0,0,0,0,0,0,0,0,0,0
HIMACHAL PRADESH,2001,By touching electric wires,0,1,1,1,0,3,0,1,0,0,0,1,4
HIMACHAL PRADESH,2001,By coming under running vehicles/trains,0,2,0,2,0,4,0,0,0,0,0,0,4
HIMACHAL PRADESH,2001,By Other means (please specify),1,0,2,0,5,8,0,1,0,0,0,1,9
HIMACHAL PRADESH,2001,Total,1,54,64,49,9,177,3,70,38,14,5,130,307
HIMACHAL PRADESH,2001,Total (Poison),0,40,42,34,2,118,2,52,30,14,5,103,221
HIMACHAL PRADESH,2001,Total (Jumping),0,0,2,1,0,3,0,0,2,0,0,2,5
HIMACHAL PRADESH,2002,By Over Alcoholism,0,1,5,0,0,6,0,0,0,0,0,0,6
HIMACHAL PRADESH,2002,By Drowning,0,3,5,4,1,13,2,3,1,0,0,6,19
HIMACHAL PRADESH,2002,By Fire/Self Immolation,0,3,3,0,0,6,0,2,1,1,0,4,10
HIMACHAL PRADESH,2002,By Fire-Arms,1,0,1,1,0,3,0,0,0,0,0,0,3
HIMACHAL PRADESH,2002,By Hanging,0,15,14,2,1,32,0,7,2,1,0,10,42
HIMACHAL PRADESH,2002,By Consuming Insecticides,1,32,32,6,1,72,1,37,13,2,0,53,125
HIMACHAL PRADESH,2002,By Consuming Other Poison,2,29,15,10,3,59,0,21,17,2,0,40,99
HIMACHAL PRADESH,2002,By Self Infliction of injury,0,0,1,0,0,1,0,1,0,0,0,1,2
HIMACHAL PRADESH,2002,By Jumping from (Building),0,0,0,0,0,0,0,0,0,0,0,0,0
HIMACHAL PRADESH,2002,By Jumping from (Other sites),0,1,2,1,0,4,0,1,0,1,1,3,7
HIMACHAL PRADESH,2002,By Jumping off Moving Vehicles/Trains,0,1,0,0,0,1,0,1,0,0,0,1,2
HIMACHAL PRADESH,2002,By Machine,0,0,0,0,0,0,0,0,0,0,0,0,0
HIMACHAL PRADESH,2002,By Overdose of sleeping pills,0,0,2,0,0,2,0,0,0,0,0,0,2
HIMACHAL PRADESH,2002,By touching electric wires,0,1,0,0,0,1,0,0,0,0,0,0,1
HIMACHAL PRADESH,2002,By coming under running vehicles/trains,0,0,0,0,0,0,0,0,0,0,0,0,0
HIMACHAL PRADESH,2002,By Other means,0,1,2,5,0,8,0,3,3,1,1,8,16
HIMACHAL PRADESH,2002,Total,4,87,82,29,6,208,3,76,37,8,2,126,334
HIMACHAL PRADESH,2002,Total (Poison),3,61,48,16,4,132,1,59,30,4,0,94,226
HIMACHAL PRADESH,2002,Total (Jumping),0,1,2,1,0,4,0,1,0,1,1,3,7
HIMACHAL PRADESH,2003,By Over Alcoholism,0,0,0,1,1,2,0,0,0,0,0,0,2
HIMACHAL PRADESH,2003,By Drowning,0,7,10,6,1,24,0,3,2,0,0,5,29
HIMACHAL PRADESH,2003,By Fire/Self Immolation,0,1,3,1,0,5,0,3,0,0,0,3,8
HIMACHAL PRADESH,2003,By Fire-Arms,0,0,1,1,0,2,0,1,0,0,0,1,3
HIMACHAL PRADESH,2003,By Hanging,0,15,20,5,1,41,1,6,3,1,0,11,52
HIMACHAL PRADESH,2003,By Consuming Insecticides,0,5,6,6,1,18,2,7,4,1,0,14,32
HIMACHAL PRADESH,2003,By Consuming Other Poison,2,39,31,29,7,108,2,41,28,10,0,81,189
HIMACHAL PRADESH,2003,By Self Infliction of injury,0,0,0,0,0,0,0,0,0,0,0,0,0
HIMACHAL PRADESH,2003,By Jumping from (Building),0,1,1,2,0,4,0,0,0,0,0,0,4
HIMACHAL PRADESH,2003,By Jumping from (Other sites),0,2,1,4,1,8,0,0,0,1,0,1,9
HIMACHAL PRADESH,2003,By Jumping off Moving Vehicles/Trains,0,0,0,0,0,0,0,0,0,0,0,0,0
HIMACHAL PRADESH,2003,By Machine,0,0,0,0,0,0,0,0,0,0,0,0,0
HIMACHAL PRADESH,2003,By Overdose of sleeping pills,0,0,0,1,0,1,0,0,0,1,0,1,2
HIMACHAL PRADESH,2003,By touching electric wires,0,0,0,0,0,0,0,0,0,0,0,0,0
HIMACHAL PRADESH,2003,By coming under running vehicles/trains,0,0,0,0,0,0,0,0,0,0,0,0,0
HIMACHAL PRADESH,2003,By Other means (please specify),0,8,8,7,4,27,0,11,9,7,2,29,56
HIMACHAL PRADESH,2003,Total,2,78,81,63,16,240,5,72,46,21,2,146,386
HIMACHAL PRADESH,2003,Total (Poison),2,44,37,35,8,126,4,48,32,11,0,95,221
HIMACHAL PRADESH,2003,Total (Jumping),0,3,2,6,1,12,0,0,0,1,0,1,13
HIMACHAL PRADESH,2004,By Over Alcoholism,0,0,2,1,1,4,0,0,0,0,0,0,4
HIMACHAL PRADESH,2004,By Drowning,2,6,6,5,1,20,0,3,2,2,0,7,27
HIMACHAL PRADESH,2004,By Fire/Self Immolation,0,1,2,0,1,4,0,5,0,1,0,6,10
HIMACHAL PRADESH,2004,By Fire-Arms,0,0,0,0,0,0,0,0,0,0,0,0,0
HIMACHAL PRADESH,2004,By Hanging,3,22,20,9,4,58,1,11,6,1,0,19,77
HIMACHAL PRADESH,2004,By Consuming Insecticides,0,28,22,16,4,70,0,22,19,5,1,47,117
HIMACHAL PRADESH,2004,By Consuming Other Poison,0,17,25,21,4,67,3,25,13,4,1,46,113
HIMACHAL PRADESH,2004,By Self Infliction of injury,0,0,0,0,0,0,0,0,0,0,0,0,0
HIMACHAL PRADESH,2004,By Jumping from (Building),0,0,0,0,0,0,0,0,0,0,0,0,0
HIMACHAL PRADESH,2004,By Jumping from (Other sites),0,1,3,0,1,5,0,1,0,0,0,1,6
HIMACHAL PRADESH,2004,By Jumping off Moving Vehicles/Trains,0,0,0,0,0,0,0,0,0,0,0,0,0
HIMACHAL PRADESH,2004,By Machine,0,0,0,0,0,0,0,0,0,0,0,0,0
HIMACHAL PRADESH,2004,By Overdose of sleeping pills,0,0,0,0,0,0,0,0,0,0,0,0,0
HIMACHAL PRADESH,2004,By touching electric wires,0,0,0,0,0,0,0,0,0,0,0,0,0
HIMACHAL PRADESH,2004,By coming under running vehicles/trains,0,1,0,0,0,1,0,0,0,0,0,0,1
HIMACHAL PRADESH,2004,By Other means (please specify),0,1,2,2,2,7,0,4,2,1,2,9,16
HIMACHAL PRADESH,2004,Total,5,77,82,54,18,236,4,71,42,14,4,135,371
HIMACHAL PRADESH,2004,Total (Poison),0,45,47,37,8,137,3,47,32,9,2,93,230
HIMACHAL PRADESH,2004,Total (Jumping),0,1,3,0,1,5,0,1,0,0,0,1,6
HIMACHAL PRADESH,2005,By Over Alcoholism,0,1,4,1,0,6,0,0,0,0,0,0,6
HIMACHAL PRADESH,2005,By Drowning,0,2,4,6,1,13,0,9,4,3,0,16,29
HIMACHAL PRADESH,2005,By Fire/Self Immolation,0,1,1,0,0,2,0,2,2,1,0,5,7
HIMACHAL PRADESH,2005,By Fire-Arms,0,1,3,0,0,4,0,0,0,0,0,0,4
HIMACHAL PRADESH,2005,By Hanging,0,26,23,5,1,55,0,16,8,2,0,26,81
HIMACHAL PRADESH,2005,By Consuming Insecticides,0,13,22,8,0,43,0,17,17,4,1,39,82
HIMACHAL PRADESH,2005,By Consuming Other Poison,2,24,22,16,5,69,1,31,14,2,1,49,118
HIMACHAL PRADESH,2005,By Self Infliction of injury,0,0,0,0,0,0,0,0,0,0,0,0,0
HIMACHAL PRADESH,2005,By Jumping from (Building),0,0,1,1,2,4,0,0,0,0,0,0,4
HIMACHAL PRADESH,2005,By Jumping from (Other sites),0,0,0,0,0,0,0,0,1,0,1,2,2
HIMACHAL PRADESH,2005,By Jumping off Moving Vehicles/Trains,0,0,0,0,0,0,0,0,0,0,0,0,0
HIMACHAL PRADESH,2005,By Machine,0,0,0,0,0,0,0,0,0,0,0,0,0
HIMACHAL PRADESH,2005,By Overdose of sleeping pills,0,0,0,0,0,0,0,0,0,0,0,0,0
HIMACHAL PRADESH,2005,By touching electric wires,0,0,0,0,0,0,0,0,0,0,0,0,0
HIMACHAL PRADESH,2005,By coming under running vehicles/trains,0,0,0,0,0,0,0,0,0,0,0,0,0
HIMACHAL PRADESH,2005,By Other means (please specify),0,1,6,5,6,18,0,6,1,1,0,8,26
HIMACHAL PRADESH,2005,Total,2,69,86,42,15,214,1,81,47,13,3,145,359
HIMACHAL PRADESH,2005,Total (Poison),2,37,44,24,5,112,1,48,31,6,2,88,200
HIMACHAL PRADESH,2005,Total (Jumping),0,0,1,1,2,4,0,0,1,0,1,2,6
HIMACHAL PRADESH,2006,By Over Alcoholism,0,6,12,1,0,19,0,0,0,0,0,0,19
HIMACHAL PRADESH,2006,By Drowning,0,3,9,2,0,14,0,5,2,2,0,9,23
HIMACHAL PRADESH,2006,By Fire/Self Immolation,0,2,3,1,0,6,0,7,3,2,0,12,18
HIMACHAL PRADESH,2006,By Fire-Arms,0,1,1,1,1,4,0,1,0,0,0,1,5
HIMACHAL PRADESH,2006,By Hanging,0,21,26,12,1,60,0,10,8,2,0,20,80
HIMACHAL PRADESH,2006,By Consuming Insecticides,1,15,15,10,0,41,0,16,7,5,3,31,72
HIMACHAL PRADESH,2006,By Consuming Other Poison,3,34,45,16,3,101,1,23,17,15,2,58,159
HIMACHAL PRADESH,2006,By Self Infliction of injury,0,0,1,0,0,1,0,0,0,0,0,0,1
HIMACHAL PRADESH,2006,By Jumping from (Building),0,0,0,0,0,0,0,0,0,0,0,0,0
HIMACHAL PRADESH,2006,By Jumping from (Other sites),0,1,3,4,0,8,0,2,0,0,0,2,10
HIMACHAL PRADESH,2006,By Jumping off Moving Vehicles/Trains,0,0,0,0,0,0,0,0,0,0,0,0,0
HIMACHAL PRADESH,2006,By Machine,0,1,0,2,0,3,0,0,0,0,0,0,3
HIMACHAL PRADESH,2006,By Overdose of sleeping pills,0,0,0,0,0,0,0,0,0,0,0,0,0
HIMACHAL PRADESH,2006,By touching electric wires,0,0,0,0,0,0,0,0,0,0,0,0,0
HIMACHAL PRADESH,2006,By coming under running vehicles/trains,0,0,0,0,0,0,0,0,0,0,0,0,0
HIMACHAL PRADESH,2006,By Other means (please specify),0,6,6,16,16,44,0,3,6,11,3,23,67
HIMACHAL PRADESH,2006,Total,4,90,121,65,21,301,1,67,43,37,8,156,457
HIMACHAL PRADESH,2006,Total (Poison),4,49,61,26,3,143,1,39,24,20,5,89,232
HIMACHAL PRADESH,2006,Total (Jumping),0,1,3,4,0,8,0,2,0,0,0,2,10
HIMACHAL PRADESH,2007,By Over Alcoholism,0,1,2,1,0,4,0,0,0,0,0,0,4
HIMACHAL PRADESH,2007,By Drowning,0,4,3,4,1,12,0,3,2,0,2,7,19
HIMACHAL PRADESH,2007,By Fire/Self Immolation,0,0,1,1,0,2,0,3,2,0,0,5,7
HIMACHAL PRADESH,2007,By Fire-Arms,0,0,1,1,0,2,0,0,0,0,0,0,2
HIMACHAL PRADESH,2007,By Hanging,0,23,27,7,2,59,0,9,9,3,0,21,80
HIMACHAL PRADESH,2007,By Consuming Insecticides,1,41,33,10,3,88,0,31,17,3,0,51,139
HIMACHAL PRADESH,2007,By Consuming Other Poison,1,17,17,5,1,41,0,23,14,1,2,40,81
HIMACHAL PRADESH,2007,By Self Infliction of injury,0,0,0,0,1,1,0,0,0,0,3,3,4
HIMACHAL PRADESH,2007,By Jumping from (Building),0,1,0,1,1,3,0,0,0,0,0,0,3
HIMACHAL PRADESH,2007,By Jumping from (Other sites),0,0,4,0,0,4,0,2,0,0,0,2,6
HIMACHAL PRADESH,2007,By Jumping off Moving Vehicles/Trains,0,0,1,0,0,1,0,0,0,0,0,0,1
HIMACHAL PRADESH,2007,By Machine,0,0,1,1,0,2,0,0,0,0,0,0,2
HIMACHAL PRADESH,2007,By Overdose of sleeping pills,0,1,0,0,0,1,0,0,0,0,0,0,1
HIMACHAL PRADESH,2007,By touching electric wires,0,0,0,2,0,2,0,0,0,0,0,0,2
HIMACHAL PRADESH,2007,By coming under running vehicles/trains,0,1,0,0,0,1,0,0,0,0,0,0,1
HIMACHAL PRADESH,2007,By Other means (please specify),0,3,8,5,19,35,0,1,2,4,8,15,50
HIMACHAL PRADESH,2007,Total,2,92,98,38,28,258,0,72,46,11,15,144,402
HIMACHAL PRADESH,2007,Total (Poison),2,58,50,15,5,130,0,54,31,4,5,94,224
HIMACHAL PRADESH,2007,Total (Jumping),0,1,4,1,1,7,0,2,0,0,0,2,9
HIMACHAL PRADESH,2008,By Over Alcoholism,0,2,7,9,8,26,0,0,0,0,0,0,26
HIMACHAL PRADESH,2008,By Drowning,1,14,9,10,8,42,2,6,2,1,2,13,55
HIMACHAL PRADESH,2008,By Fire/Self Immolation,0,3,3,4,1,11,1,3,6,3,3,16,27
HIMACHAL PRADESH,2008,By Fire-Arms,0,4,2,0,0,6,0,1,0,0,0,1,7
HIMACHAL PRADESH,2008,By Hanging,2,36,25,15,4,82,3,23,12,1,1,40,122
HIMACHAL PRADESH,2008,By Consuming Insecticides,0,14,12,12,1,39,0,14,7,1,1,23,62
HIMACHAL PRADESH,2008,By Consuming Other Poison,1,42,42,28,8,121,4,46,28,12,9,99,220
HIMACHAL PRADESH,2008,By Self Infliction of injury,0,0,0,0,0,0,0,0,0,0,0,0,0
HIMACHAL PRADESH,2008,By Jumping from (Building),0,0,0,0,0,0,0,0,0,0,0,0,0
HIMACHAL PRADESH,2008,By Jumping from (Other sites),1,13,4,16,5,39,0,1,1,0,0,2,41
HIMACHAL PRADESH,2008,By Jumping off Moving Vehicles/Trains,0,0,0,0,0,0,0,0,0,0,0,0,0
HIMACHAL PRADESH,2008,By Machine,0,0,0,0,0,0,0,0,0,0,0,0,0
HIMACHAL PRADESH,2008,By Overdose of sleeping pills,0,0,0,0,0,0,0,0,0,0,0,0,0
HIMACHAL PRADESH,2008,By touching electric wires,1,3,3,4,0,11,0,0,0,0,0,0,11
HIMACHAL PRADESH,2008,By coming under running vehicles/trains,0,1,1,3,0,5,0,0,0,0,0,0,5
HIMACHAL PRADESH,2008,By Other means (please specify),0,8,7,15,5,35,0,9,1,7,2,19,54
HIMACHAL PRADESH,2008,Total,6,140,115,116,40,417,10,103,57,25,18,213,630
HIMACHAL PRADESH,2008,Total (Poison),1,56,54,40,9,160,4,60,35,13,10,122,282
HIMACHAL PRADESH,2008,Total (Jumping),1,13,4,16,5,39,0,1,1,0,0,2,41
HIMACHAL PRADESH,2009,By Over Alcoholism,0,1,4,0,0,5,0,0,0,0,0,0,5
HIMACHAL PRADESH,2009,By Drowning,1,18,12,12,2,45,1,4,6,4,1,16,61
HIMACHAL PRADESH,2009,By Fire/Self Immolation,0,0,0,1,0,1,0,4,2,1,0,7,8
HIMACHAL PRADESH,2009,By Fire-Arms,0,0,2,0,0,2,0,0,0,0,0,0,2
HIMACHAL PRADESH,2009,By Hanging,0,32,27,12,3,74,2,20,12,3,2,39,113
HIMACHAL PRADESH,2009,By Consuming Insecticides,0,10,8,7,0,25,0,14,14,8,6,42,67
HIMACHAL PRADESH,2009,By Consuming Other Poison,1,46,40,13,5,105,1,31,17,8,5,62,167
HIMACHAL PRADESH,2009,By Self Infliction of injury,0,0,0,0,0,0,0,0,0,0,0,0,0
HIMACHAL PRADESH,2009,By Jumping from (Building),0,0,0,0,0,0,0,1,0,0,0,1,1
HIMACHAL PRADESH,2009,By Jumping from (Other sites),1,3,5,3,3,15,0,0,1,1,1,3,18
HIMACHAL PRADESH,2009,By Jumping off Moving Vehicles/Trains,0,0,0,0,0,0,0,0,0,0,0,0,0
HIMACHAL PRADESH,2009,By Machine,0,0,0,0,0,0,0,0,0,0,0,0,0
HIMACHAL PRADESH,2009,By Overdose of sleeping pills,0,1,2,1,0,4,0,1,0,0,0,1,5
HIMACHAL PRADESH,2009,By touching electric wires,2,0,0,0,0,2,0,0,0,0,0,0,2
HIMACHAL PRADESH,2009,By coming under running vehicles/trains,0,0,0,0,0,0,0,0,0,0,0,0,0
HIMACHAL PRADESH,2009,By Other means (please specify),0,15,28,23,22,88,7,9,3,1,3,23,111
HIMACHAL PRADESH,2009,Total,5,126,128,72,35,366,11,84,55,26,18,194,560
HIMACHAL PRADESH,2009,Total (Poison),1,56,48,20,5,130,1,45,31,16,11,104,234
HIMACHAL PRADESH,2009,Total (Jumping),1,3,5,3,3,15,0,1,1,1,1,4,19
HIMACHAL PRADESH,2010,By Over Alcoholism,0,1,1,2,2,6,0,0,0,0,0,0,6
HIMACHAL PRADESH,2010,By Drowning,2,9,9,2,2,24,0,6,2,1,2,11,35
HIMACHAL PRADESH,2010,By Fire/Self Immolation,0,0,2,0,0,2,0,4,4,5,1,14,16
HIMACHAL PRADESH,2010,By Fire-Arms,0,0,0,0,0,0,0,0,0,0,0,0,0
HIMACHAL PRADESH,2010,By Hanging,0,41,35,13,3,92,3,29,10,3,0,45,137
HIMACHAL PRADESH,2010,By Consuming Insecticides,2,20,25,9,0,56,0,25,4,1,0,30,86
HIMACHAL PRADESH,2010,By Consuming Other Poison,1,34,23,13,4,75,1,24,20,13,1,59,134
HIMACHAL PRADESH,2010,By Self Infliction of injury,0,2,0,0,0,2,0,0,0,0,0,0,2
HIMACHAL PRADESH,2010,By Jumping from (Building),0,0,0,0,0,0,0,0,0,0,0,0,0
HIMACHAL PRADESH,2010,By Jumping from (Other sites),0,2,11,9,7,29,0,1,7,5,4,17,46
HIMACHAL PRADESH,2010,By Jumping off Moving Vehicles/Trains,0,0,0,0,0,0,0,0,0,0,0,0,0
HIMACHAL PRADESH,2010,By Machine,0,0,0,0,0,0,0,0,0,0,0,0,0
HIMACHAL PRADESH,2010,By Overdose of sleeping pills,0,0,0,0,0,0,0,0,0,0,0,0,0
HIMACHAL PRADESH,2010,By touching electric wires,0,0,1,1,0,2,0,0,0,0,0,0,2
HIMACHAL PRADESH,2010,By coming under running vehicles/trains,0,0,0,0,0,0,0,0,0,0,0,0,0
HIMACHAL PRADESH,2010,By Other means (please specify),3,8,18,24,7,60,0,8,4,3,3,18,78
HIMACHAL PRADESH,2010,Total,8,117,125,73,25,348,4,97,51,31,11,194,542
HIMACHAL PRADESH,2010,Total (Poison),3,56,48,22,4,133,1,49,24,14,1,89,222
HIMACHAL PRADESH,2010,Total (Jumping),0,2,11,9,7,29,0,1,7,5,4,17,46
HIMACHAL PRADESH,2011,By Over Alcoholism,0,0,0,3,2,5,0,0,0,0,0,0,5
HIMACHAL PRADESH,2011,By Drowning,0,3,1,0,1,5,0,1,0,0,0,1,6
HIMACHAL PRADESH,2011,By Fire/Self Immolation,0,1,1,1,0,3,0,1,5,2,3,11,14
HIMACHAL PRADESH,2011,By Fire-Arms,0,0,2,0,0,2,0,0,0,0,0,0,2
HIMACHAL PRADESH,2011,By Hanging,3,37,34,14,4,92,3,21,15,5,1,45,137
HIMACHAL PRADESH,2011,By Consuming Insecticides,0,28,19,5,7,59,0,22,11,4,2,39,98
HIMACHAL PRADESH,2011,By Consuming Other Poison,2,25,17,13,6,63,2,18,19,10,0,49,112
HIMACHAL PRADESH,2011,By Self Infliction of injury,0,0,0,0,0,0,0,0,0,0,0,0,0
HIMACHAL PRADESH,2011,By Jumping from (Building),0,0,0,0,0,0,0,0,0,0,0,0,0
HIMACHAL PRADESH,2011,By Jumping from (Other sites),0,1,8,5,6,20,0,2,9,7,3,21,41
HIMACHAL PRADESH,2011,By Jumping off Moving Vehicles/Trains,0,0,0,0,0,0,0,0,0,0,0,0,0
HIMACHAL PRADESH,2011,By Machine,0,0,0,0,0,0,0,0,0,0,0,0,0
HIMACHAL PRADESH,2011,By Overdose of sleeping pills,0,0,0,0,0,0,0,0,0,0,0,0,0
HIMACHAL PRADESH,2011,By touching electric wires,0,0,2,1,0,3,0,0,0,0,0,0,3
HIMACHAL PRADESH,2011,By coming under running vehicles/trains,0,0,0,0,0,0,0,0,0,0,0,0,0
HIMACHAL PRADESH,2011,By Other means (please specify),0,3,4,4,6,17,0,1,3,2,2,8,25
HIMACHAL PRADESH,2011,Total,5,98,88,46,32,269,5,66,62,30,11,174,443
HIMACHAL PRADESH,2011,Total (Poison),2,53,36,18,13,122,2,40,30,14,2,88,210
HIMACHAL PRADESH,2011,Total (Jumping),0,1,8,5,6,20,0,2,9,7,3,21,41
HIMACHAL PRADESH,2012,By Over Alcoholism,0,0,2,3,4,9,0,0,0,0,0,0,9
HIMACHAL PRADESH,2012,By Drowning,2,7,4,4,3,20,1,3,1,1,1,7,27
HIMACHAL PRADESH,2012,By Fire/Self Immolation,0,1,1,2,0,4,1,5,1,3,1,11,15
HIMACHAL PRADESH,2012,By Fire-Arms,0,0,1,0,0,1,0,0,0,0,0,0,1
HIMACHAL PRADESH,2012,By Hanging,5,49,41,18,6,119,2,26,18,6,3,55,174
HIMACHAL PRADESH,2012,By Consuming Insecticides,0,3,3,3,1,10,0,5,3,2,1,11,21
HIMACHAL PRADESH,2012,By Consuming Other Poison,3,50,62,31,19,165,2,35,23,11,7,78,243
HIMACHAL PRADESH,2012,By Self Infliction of injury,0,0,0,0,0,0,0,0,0,0,0,0,0
HIMACHAL PRADESH,2012,By Jumping from (Building),0,0,0,0,0,0,0,0,0,0,0,0,0
HIMACHAL PRADESH,2012,By Jumping from (Other sites),0,2,4,1,1,8,0,1,2,0,0,3,11
HIMACHAL PRADESH,2012,By Jumping off Moving Vehicles/Trains,0,0,0,0,0,0,0,0,0,0,0,0,0
HIMACHAL PRADESH,2012,By Machine,0,0,0,0,0,0,0,0,0,0,0,0,0
HIMACHAL PRADESH,2012,By Overdose of sleeping pills,0,0,0,1,0,1,0,0,0,0,0,0,1
HIMACHAL PRADESH,2012,By touching electric wires,0,0,0,0,0,0,0,0,0,0,0,0,0
HIMACHAL PRADESH,2012,By coming under running vehicles/trains,0,0,0,0,0,0,0,0,0,0,0,0,0
HIMACHAL PRADESH,2012,By Other means (please specify),0,0,1,9,7,17,0,0,4,3,2,9,26
HIMACHAL PRADESH,2012,Total,10,112,119,72,41,354,6,75,52,26,15,174,528
HIMACHAL PRADESH,2012,Total (Poison),3,53,65,34,20,175,2,40,26,13,8,89,264
HIMACHAL PRADESH,2012,Total (Jumping),0,2,4,1,1,8,0,1,2,0,0,3,11
JAMMU & KASHMIR,2001,By Over Alcoholism,0,0,0,0,0,0,0,0,0,0,0,0,0
JAMMU & KASHMIR,2001,By Drowning,0,4,1,1,0,6,1,4,0,0,0,5,11
JAMMU & KASHMIR,2001,By Fire/Self Immolation,0,0,2,0,0,2,0,0,1,0,0,1,3
JAMMU & KASHMIR,2001,By Fire-Arms,0,5,1,1,0,7,0,0,2,2,0,4,11
JAMMU & KASHMIR,2001,By Hanging,0,5,2,1,0,8,0,3,1,0,1,5,13
JAMMU & KASHMIR,2001,By Consuming Insecticides,0,0,1,1,0,2,0,0,0,0,0,0,2
JAMMU & KASHMIR,2001,By Consuming Other Poison,2,12,10,2,0,26,0,15,15,3,2,35,61
JAMMU & KASHMIR,2001,By Self Infliction of injury,0,0,2,0,0,2,0,0,0,0,0,0,2
JAMMU & KASHMIR,2001,By Jumping from (Building),0,0,1,2,0,3,0,0,0,0,0,0,3
JAMMU & KASHMIR,2001,By Jumping from (Other sites),0,0,0,0,0,0,0,0,0,0,0,0,0
JAMMU & KASHMIR,2001,By Jumping off Moving Vehicles/Trains,0,0,3,4,1,8,0,0,1,0,0,1,9
JAMMU & KASHMIR,2001,By Machine,0,0,0,0,0,0,0,0,0,0,0,0,0
JAMMU & KASHMIR,2001,By Overdose of sleeping pills,0,1,0,0,0,1,0,0,0,0,0,0,1
JAMMU & KASHMIR,2001,By touching electric wires,0,0,1,0,0,1,0,0,0,0,0,0,1
JAMMU & KASHMIR,2001,By coming under running vehicles/trains,0,0,0,5,10,15,1,0,0,0,0,1,16
JAMMU & KASHMIR,2001,By Other means (please specify),0,2,7,1,0,10,0,9,1,0,0,10,20
JAMMU & KASHMIR,2001,Total,2,29,31,18,11,91,2,31,21,5,3,62,153
JAMMU & KASHMIR,2001,Total (Poison),2,12,13,3,0,30,0,15,15,3,2,35,65
JAMMU & KASHMIR,2001,Total (Jumping),0,0,1,2,0,3,0,0,0,0,0,0,3
JAMMU & KASHMIR,2002,By Over Alcoholism,0,0,1,1,0,2,0,0,0,0,0,0,2
JAMMU & KASHMIR,2002,By Drowning,0,1,1,2,0,4,0,5,1,0,0,6,10
JAMMU & KASHMIR,2002,By Fire/Self Immolation,0,2,2,0,0,4,0,7,2,1,0,10,14
JAMMU & KASHMIR,2002,By Fire-Arms,0,2,3,0,1,6,0,2,1,0,0,3,9
JAMMU & KASHMIR,2002,By Hanging,0,5,4,1,0,10,0,8,1,0,0,9,19
JAMMU & KASHMIR,2002,By Consuming Insecticides,0,5,4,0,0,9,0,4,4,2,0,10,19
JAMMU & KASHMIR,2002,By Consuming Other Poison,1,11,10,8,1,31,0,16,2,0,0,18,49
JAMMU & KASHMIR,2002,By Self Infliction of injury,0,0,0,0,1,1,0,0,0,0,0,0,1
JAMMU & KASHMIR,2002,By Jumping from (Building),0,3,1,1,0,5,0,2,0,0,0,2,7
JAMMU & KASHMIR,2002,By Jumping from (Other sites),0,0,0,0,0,0,0,0,0,0,0,0,0
JAMMU & KASHMIR,2002,By Jumping off Moving Vehicles/Trains,0,0,0,1,1,2,0,2,0,0,0,2,4
JAMMU & KASHMIR,2002,By Machine,0,0,1,0,0,1,0,0,1,0,0,1,2
JAMMU & KASHMIR,2002,By Overdose of sleeping pills,0,0,0,0,0,0,0,0,0,0,0,0,0
JAMMU & KASHMIR,2002,By touching electric wires,0,1,2,0,0,3,0,0,0,0,0,0,3
JAMMU & KASHMIR,2002,By coming under running vehicles/trains,0,0,0,0,0,0,0,5,5,0,0,10,10
JAMMU & KASHMIR,2002,By Other means,3,8,7,0,0,18,0,10,4,3,0,17,35
JAMMU & KASHMIR,2002,Total,4,38,36,14,4,96,0,61,21,6,0,88,184
JAMMU & KASHMIR,2002,Total (Poison),1,16,14,8,2,41,0,20,6,2,0,28,69
JAMMU & KASHMIR,2002,Total (Jumping),0,3,1,1,0,5,0,2,0,0,0,2,7
JAMMU & KASHMIR,2003,By Over Alcoholism,0,0,1,0,0,1,0,1,0,0,0,1,2
JAMMU & KASHMIR,2003,By Drowning,1,2,0,1,0,4,0,1,0,1,2,4,8
JAMMU & KASHMIR,2003,By Fire/Self Immolation,0,0,1,0,0,1,0,4,0,0,0,4,5
JAMMU & KASHMIR,2003,By Fire-Arms,0,6,0,0,0,6,0,0,0,0,0,0,6
JAMMU & KASHMIR,2003,By Hanging,0,5,4,3,1,13,1,4,3,1,0,9,22
JAMMU & KASHMIR,2003,By Consuming Insecticides,0,6,3,1,1,11,0,6,2,0,0,8,19
JAMMU & KASHMIR,2003,By Consuming Other Poison,0,10,3,2,1,16,3,19,10,1,0,33,49
JAMMU & KASHMIR,2003,By Self Infliction of injury,0,0,0,0,0,0,0,0,0,0,0,0,0
JAMMU & KASHMIR,2003,By Jumping from (Building),0,0,0,0,0,0,0,0,0,0,0,0,0
JAMMU & KASHMIR,2003,By Jumping from (Other sites),0,0,2,1,0,3,0,1,0,0,0,1,4
JAMMU & KASHMIR,2003,By Jumping off Moving Vehicles/Trains,0,0,0,0,0,0,0,0,0,0,0,0,0
JAMMU & KASHMIR,2003,By Machine,0,0,0,0,0,0,0,0,0,0,0,0,0
JAMMU & KASHMIR,2003,By Overdose of sleeping pills,0,0,0,0,0,0,0,0,0,0,0,0,0
JAMMU & KASHMIR,2003,By touching electric wires,0,0,0,0,0,0,0,0,0,0,0,0,0
JAMMU & KASHMIR,2003,By coming under running vehicles/trains,0,0,0,0,0,0,0,0,0,0,0,0,0
JAMMU & KASHMIR,2003,By Other means (please specify),0,1,5,1,1,8,1,7,6,0,1,15,23
JAMMU & KASHMIR,2003,Total,1,30,19,9,4,63,5,43,21,3,3,75,138
JAMMU & KASHMIR,2003,Total (Poison),0,16,6,3,2,27,3,25,12,1,0,41,68
JAMMU & KASHMIR,2003,Total (Jumping),0,0,2,1,0,3,0,1,0,0,0,1,4
JAMMU & KASHMIR,2004,By Over Alcoholism,0,0,0,0,0,0,0,0,0,0,0,0,0
JAMMU & KASHMIR,2004,By Drowning,0,0,0,0,0,0,0,0,0,0,0,0,0
JAMMU & KASHMIR,2004,By Fire/Self Immolation,0,0,0,0,0,0,0,1,2,0,0,3,3
JAMMU & KASHMIR,2004,By Fire-Arms,0,0,2,0,0,2,0,0,0,0,0,0,2
JAMMU & KASHMIR,2004,By Hanging,0,2,0,0,0,2,0,0,1,0,0,1,3
JAMMU & KASHMIR,2004,By Consuming Insecticides,0,2,0,1,0,3,0,3,2,0,0,5,8
JAMMU & KASHMIR,2004,By Consuming Other Poison,0,3,1,1,0,5,0,7,13,1,0,21,26
JAMMU & KASHMIR,2004,By Self Infliction of injury,0,0,0,0,0,0,0,0,0,0,0,0,0
JAMMU & KASHMIR,2004,By Jumping from (Building),0,0,0,0,0,0,0,0,0,0,0,0,0
JAMMU & KASHMIR,2004,By Jumping from (Other sites),0,0,0,0,0,0,0,0,0,0,0,0,0
JAMMU & KASHMIR,2004,By Jumping off Moving Vehicles/Trains,0,0,0,0,0,0,0,0,0,0,0,0,0
JAMMU & KASHMIR,2004,By Machine,0,0,0,0,0,0,0,0,0,0,0,0,0
JAMMU & KASHMIR,2004,By Overdose of sleeping pills,0,0,0,0,0,0,0,0,0,0,0,0,0
JAMMU & KASHMIR,2004,By touching electric wires,0,0,0,0,0,0,0,0,0,0,0,0,0
JAMMU & KASHMIR,2004,By coming under running vehicles/trains,0,0,0,0,0,0,0,0,0,0,0,0,0
JAMMU & KASHMIR,2004,By Other means (please specify),0,20,13,6,0,39,0,18,11,2,0,31,70
JAMMU & KASHMIR,2004,Total,0,27,16,8,0,51,0,29,29,3,0,61,112
JAMMU & KASHMIR,2004,Total (Poison),0,5,1,2,0,8,0,10,15,1,0,26,34
JAMMU & KASHMIR,2004,Total (Jumping),0,0,0,0,0,0,0,0,0,0,0,0,0
JAMMU & KASHMIR,2005,By Over Alcoholism,0,0,0,0,0,0,0,0,0,0,0,0,0
JAMMU & KASHMIR,2005,By Drowning,0,12,1,1,0,14,0,2,0,0,0,2,16
JAMMU & KASHMIR,2005,By Fire/Self Immolation,0,0,0,0,0,0,0,3,2,0,0,5,5
JAMMU & KASHMIR,2005,By Fire-Arms,0,17,2,1,0,20,0,0,0,0,0,0,20
JAMMU & KASHMIR,2005,By Hanging,0,19,8,2,1,30,0,9,1,0,0,10,40
JAMMU & KASHMIR,2005,By Consuming Insecticides,0,6,5,1,0,12,0,6,13,0,0,19,31
JAMMU & KASHMIR,2005,By Consuming Other Poison,1,21,11,2,0,35,1,7,6,1,0,15,50
JAMMU & KASHMIR,2005,By Self Infliction of injury,0,1,0,0,0,1,0,0,0,0,0,0,1
JAMMU & KASHMIR,2005,By Jumping from (Building),0,0,0,0,0,0,0,0,0,0,0,0,0
JAMMU & KASHMIR,2005,By Jumping from (Other sites),0,10,3,0,0,13,0,1,0,0,0,1,14
JAMMU & KASHMIR,2005,By Jumping off Moving Vehicles/Trains,0,0,0,0,0,0,0,0,0,0,0,0,0
JAMMU & KASHMIR,2005,By Machine,0,0,0,0,0,0,0,0,0,0,0,0,0
JAMMU & KASHMIR,2005,By Overdose of sleeping pills,0,0,0,0,0,0,0,0,0,0,0,0,0
JAMMU & KASHMIR,2005,By touching electric wires,0,2,1,1,0,4,0,0,1,0,1,2,6
JAMMU & KASHMIR,2005,By coming under running vehicles/trains,0,0,0,0,0,0,0,1,1,0,1,3,3
JAMMU & KASHMIR,2005,By Other means (please specify),2,25,28,9,3,67,3,25,12,0,1,41,108
JAMMU & KASHMIR,2005,Total,3,113,59,17,4,196,4,54,36,1,3,98,294
JAMMU & KASHMIR,2005,Total (Poison),1,28,16,3,0,48,1,13,19,1,0,34,82
JAMMU & KASHMIR,2005,Total (Jumping),0,10,3,0,0,13,0,1,0,0,0,1,14
JAMMU & KASHMIR,2006,By Over Alcoholism,0,0,2,0,0,2,0,0,0,0,0,0,2
JAMMU & KASHMIR,2006,By Drowning,0,2,1,0,0,3,0,4,1,0,0,5,8
JAMMU & KASHMIR,2006,By Fire/Self Immolation,0,1,0,1,0,2,0,5,3,1,0,9,11
JAMMU & KASHMIR,2006,By Fire-Arms,0,6,6,0,0,12,0,0,1,0,0,1,13
JAMMU & KASHMIR,2006,By Hanging,0,10,6,3,0,19,0,3,1,0,0,4,23
JAMMU & KASHMIR,2006,By Consuming Insecticides,0,1,3,0,0,4,0,16,7,0,0,23,27
JAMMU & KASHMIR,2006,By Consuming Other Poison,0,6,5,3,0,14,0,4,2,4,0,10,24
JAMMU & KASHMIR,2006,By Self Infliction of injury,0,0,0,0,0,0,0,0,0,0,0,0,0
JAMMU & KASHMIR,2006,By Jumping from (Building),0,0,0,0,0,0,0,0,0,0,0,0,0
JAMMU & KASHMIR,2006,By Jumping from (Other sites),0,2,0,0,0,2,0,1,1,0,0,2,4
JAMMU & KASHMIR,2006,By Jumping off Moving Vehicles/Trains,0,0,0,0,0,0,0,0,0,0,0,0,0
JAMMU & KASHMIR,2006,By Machine,0,1,0,0,0,1,0,1,0,0,0,1,2
JAMMU & KASHMIR,2006,By Overdose of sleeping pills,0,1,0,0,0,1,0,0,0,0,0,0,1
JAMMU & KASHMIR,2006,By touching electric wires,0,0,1,1,0,2,0,2,0,0,0,2,4
JAMMU & KASHMIR,2006,By coming under running vehicles/trains,0,0,0,0,0,0,0,0,0,0,0,0,0
JAMMU & KASHMIR,2006,By Other means (please specify),1,34,32,17,6,90,0,32,17,4,0,53,143
JAMMU & KASHMIR,2006,Total,1,64,56,25,6,152,0,68,33,9,0,110,262
JAMMU & KASHMIR,2006,Total (Poison),0,7,8,3,0,18,0,20,9,4,0,33,51
JAMMU & KASHMIR,2006,Total (Jumping),0,2,0,0,0,2,0,1,1,0,0,2,4
JAMMU & KASHMIR,2007,By Over Alcoholism,0,2,0,0,1,3,0,0,0,0,0,0,3
JAMMU & KASHMIR,2007,By Drowning,0,2,6,3,0,11,0,1,0,1,0,2,13
JAMMU & KASHMIR,2007,By Fire/Self Immolation,0,1,0,2,0,3,0,2,4,0,0,6,9
JAMMU & KASHMIR,2007,By Fire-Arms,0,1,5,0,0,6,0,2,0,0,0,2,8
JAMMU & KASHMIR,2007,By Hanging,0,16,10,3,0,29,0,9,6,0,0,15,44
JAMMU & KASHMIR,2007,By Consuming Insecticides,0,4,3,2,0,9,0,8,2,0,0,10,19
JAMMU & KASHMIR,2007,By Consuming Other Poison,0,12,5,2,2,21,0,9,4,1,1,15,36
JAMMU & KASHMIR,2007,By Self Infliction of injury,0,0,0,0,0,0,0,0,0,0,0,0,0
JAMMU & KASHMIR,2007,By Jumping from (Building),0,0,0,0,0,0,0,0,0,0,0,0,0
JAMMU & KASHMIR,2007,By Jumping from (Other sites),0,1,0,0,0,1,0,0,0,0,0,0,1
JAMMU & KASHMIR,2007,By Jumping off Moving Vehicles/Trains,0,0,0,0,0,0,0,0,0,0,0,0,0
JAMMU & KASHMIR,2007,By Machine,0,1,0,0,0,1,0,1,0,0,0,1,2
JAMMU & KASHMIR,2007,By Overdose of sleeping pills,0,0,0,0,0,0,0,1,0,0,0,1,1
JAMMU & KASHMIR,2007,By touching electric wires,0,3,1,0,0,4,0,0,0,0,0,0,4
JAMMU & KASHMIR,2007,By coming under running vehicles/trains,0,0,0,0,0,0,0,0,0,0,0,0,0
JAMMU & KASHMIR,2007,By Other means (please specify),0,22,27,11,5,65,0,18,8,2,1,29,94
JAMMU & KASHMIR,2007,Total,0,65,57,23,8,153,0,51,24,4,2,81,234
JAMMU & KASHMIR,2007,Total (Poison),0,16,8,4,2,30,0,17,6,1,1,25,55
JAMMU & KASHMIR,2007,Total (Jumping),0,1,0,0,0,1,0,0,0,0,0,0,1
JAMMU & KASHMIR,2008,By Over Alcoholism,0,0,2,1,0,3,0,0,0,0,0,0,3
JAMMU & KASHMIR,2008,By Drowning,0,2,1,0,2,5,0,2,1,1,0,4,9
JAMMU & KASHMIR,2008,By Fire/Self Immolation,0,0,1,0,0,1,0,2,1,0,0,3,4
JAMMU & KASHMIR,2008,By Fire-Arms,0,0,6,1,0,7,0,1,0,0,0,1,8
JAMMU & KASHMIR,2008,By Hanging,0,5,7,2,2,16,0,9,5,0,0,14,30
JAMMU & KASHMIR,2008,By Consuming Insecticides,0,10,9,9,1,29,0,33,21,0,0,54,83
JAMMU & KASHMIR,2008,By Consuming Other Poison,0,11,5,1,1,18,1,14,11,0,0,26,44
JAMMU & KASHMIR,2008,By Self Infliction of injury,0,0,1,0,0,1,0,0,0,0,0,0,1
JAMMU & KASHMIR,2008,By Jumping from (Building),0,0,0,0,0,0,0,0,0,0,0,0,0
JAMMU & KASHMIR,2008,By Jumping from (Other sites),0,1,2,0,0,3,0,0,0,0,0,0,3
JAMMU & KASHMIR,2008,By Jumping off Moving Vehicles/Trains,0,1,0,0,0,1,0,0,0,0,0,0,1
JAMMU & KASHMIR,2008,By Machine,0,0,0,0,0,0,0,0,0,0,0,0,0
JAMMU & KASHMIR,2008,By Overdose of sleeping pills,0,0,0,0,0,0,0,0,0,0,0,0,0
JAMMU & KASHMIR,2008,By touching electric wires,0,1,5,1,0,7,0,0,0,0,0,0,7
JAMMU & KASHMIR,2008,By coming under running vehicles/trains,0,0,0,0,0,0,0,0,0,0,0,0,0
JAMMU & KASHMIR,2008,By Other means (please specify),1,25,24,26,10,86,0,19,12,0,0,31,117
JAMMU & KASHMIR,2008,Total,1,56,63,41,16,177,1,80,51,1,0,133,310
JAMMU & KASHMIR,2008,Total (Poison),0,21,15,10,2,48,1,47,32,0,0,80,128
JAMMU & KASHMIR,2008,Total (Jumping),0,1,2,0,0,3,0,0,0,0,0,0,3
JAMMU & KASHMIR,2009,By Over Alcoholism,0,0,3,3,1,7,0,0,0,0,0,0,7
JAMMU & KASHMIR,2009,By Drowning,0,2,1,0,1,4,0,2,3,2,1,8,12
JAMMU & KASHMIR,2009,By Fire/Self Immolation,0,2,5,2,0,9,0,6,3,1,0,10,19
JAMMU & KASHMIR,2009,By Fire-Arms,0,3,6,1,0,10,0,2,0,0,0,2,12
JAMMU & KASHMIR,2009,By Hanging,0,12,3,3,0,18,0,5,4,1,0,10,28
JAMMU & KASHMIR,2009,By Consuming Insecticides,0,2,3,2,0,7,0,15,5,0,0,20,27
JAMMU & KASHMIR,2009,By Consuming Other Poison,0,14,10,4,0,28,0,26,13,0,2,41,69
JAMMU & KASHMIR,2009,By Self Infliction of injury,0,0,0,0,0,0,0,3,1,0,0,4,4
JAMMU & KASHMIR,2009,By Jumping from (Building),0,0,0,0,0,0,0,0,0,1,1,2,2
JAMMU & KASHMIR,2009,By Jumping from (Other sites),0,1,3,1,0,5,0,1,1,0,0,2,7
JAMMU & KASHMIR,2009,By Jumping off Moving Vehicles/Trains,0,0,1,2,0,3,0,0,0,0,0,0,3
JAMMU & KASHMIR,2009,By Machine,0,1,2,1,0,4,0,0,1,1,0,2,6
JAMMU & KASHMIR,2009,By Overdose of sleeping pills,0,0,0,1,0,1,0,0,0,0,0,0,1
JAMMU & KASHMIR,2009,By touching electric wires,0,0,2,1,1,4,0,1,7,1,1,10,14
JAMMU & KASHMIR,2009,By coming under running vehicles/trains,0,1,6,6,4,17,0,1,1,0,1,3,20
JAMMU & KASHMIR,2009,By Other means (please specify),0,6,29,7,9,51,2,19,15,3,0,39,90
JAMMU & KASHMIR,2009,Total,0,44,74,34,16,168,2,81,54,10,6,153,321
JAMMU & KASHMIR,2009,Total (Poison),0,16,13,6,0,35,0,44,19,0,2,65,100
JAMMU & KASHMIR,2009,Total (Jumping),0,1,3,1,0,5,0,1,1,1,1,4,9
JAMMU & KASHMIR,2010,By Over Alcoholism,0,0,1,0,1,2,0,0,0,0,0,0,2
JAMMU & KASHMIR,2010,By Drowning,0,3,3,5,1,12,0,3,3,0,0,6,18
JAMMU & KASHMIR,2010,By Fire/Self Immolation,0,3,2,0,0,5,2,4,2,2,0,10,15
JAMMU & KASHMIR,2010,By Fire-Arms,0,1,5,0,0,6,0,3,1,0,0,4,10
JAMMU & KASHMIR,2010,By Hanging,1,8,9,9,1,28,0,14,4,1,0,19,47
JAMMU & KASHMIR,2010,By Consuming Insecticides,2,13,4,4,0,23,0,15,6,1,0,22,45
JAMMU & KASHMIR,2010,By Consuming Other Poison,0,7,5,2,1,15,0,21,9,0,0,30,45
JAMMU & KASHMIR,2010,By Self Infliction of injury,0,0,0,0,0,0,0,0,0,0,0,0,0
JAMMU & KASHMIR,2010,By Jumping from (Building),0,0,0,0,0,0,0,0,0,0,0,0,0
JAMMU & KASHMIR,2010,By Jumping from (Other sites),0,2,1,1,1,5,0,1,1,0,0,2,7
JAMMU & KASHMIR,2010,By Jumping off Moving Vehicles/Trains,0,0,1,1,0,2,0,1,0,0,0,1,3
JAMMU & KASHMIR,2010,By Machine,0,0,1,0,0,1,0,2,0,0,0,2,3
JAMMU & KASHMIR,2010,By Overdose of sleeping pills,0,0,1,0,0,1,0,0,0,0,0,0,1
JAMMU & KASHMIR,2010,By touching electric wires,0,0,1,0,0,1,0,2,1,0,0,3,4
JAMMU & KASHMIR,2010,By coming under running vehicles/trains,0,0,0,0,0,0,0,0,0,0,0,0,0
JAMMU & KASHMIR,2010,By Other means (please specify),0,9,6,4,2,21,1,20,12,4,1,38,59
JAMMU & KASHMIR,2010,Total,3,46,40,26,7,122,3,86,39,8,1,137,259
JAMMU & KASHMIR,2010,Total (Poison),2,20,9,6,1,38,0,36,15,1,0,52,90
JAMMU & KASHMIR,2010,Total (Jumping),0,2,1,1,1,5,0,1,1,0,0,2,7
JAMMU & KASHMIR,2011,By Over Alcoholism,0,1,2,4,1,8,0,0,0,0,0,0,8
JAMMU & KASHMIR,2011,By Drowning,0,2,1,0,0,3,0,1,1,0,0,2,5
JAMMU & KASHMIR,2011,By Fire/Self Immolation,0,0,4,3,1,8,1,1,2,0,0,4,12
JAMMU & KASHMIR,2011,By Fire-Arms,0,3,5,3,0,11,0,0,1,0,0,1,12
JAMMU & KASHMIR,2011,By Hanging,1,10,7,9,0,27,1,12,1,1,0,15,42
JAMMU & KASHMIR,2011,By Consuming Insecticides,0,5,4,1,0,10,1,11,5,2,0,19,29
JAMMU & KASHMIR,2011,By Consuming Other Poison,0,9,8,2,2,21,0,34,20,3,0,57,78
JAMMU & KASHMIR,2011,By Self Infliction of injury,0,0,0,0,0,0,0,0,0,0,0,0,0
JAMMU & KASHMIR,2011,By Jumping from (Building),0,1,3,1,0,5,0,2,0,0,0,2,7
JAMMU & KASHMIR,2011,By Jumping from (Other sites),0,0,5,1,0,6,0,2,1,0,0,3,9
JAMMU & KASHMIR,2011,By Jumping off Moving Vehicles/Trains,0,2,0,0,1,3,0,1,0,0,0,1,4
JAMMU & KASHMIR,2011,By Machine,0,1,3,3,1,8,0,0,0,0,0,0,8
JAMMU & KASHMIR,2011,By Overdose of sleeping pills,0,0,0,2,1,3,0,0,0,0,0,0,3
JAMMU & KASHMIR,2011,By touching electric wires,1,1,2,1,0,5,0,1,2,1,0,4,9
JAMMU & KASHMIR,2011,By coming under running vehicles/trains,0,0,0,1,0,1,0,0,0,0,0,0,1
JAMMU & KASHMIR,2011,By Other means (please specify),2,5,9,8,1,25,2,22,6,4,1,35,60
JAMMU & KASHMIR,2011,Total,4,40,53,39,8,144,5,87,39,11,1,143,287
JAMMU & KASHMIR,2011,Total (Poison),0,14,12,3,2,31,1,45,25,5,0,76,107
JAMMU & KASHMIR,2011,Total (Jumping),0,1,8,2,0,11,0,4,1,0,0,5,16
JAMMU & KASHMIR,2012,By Over Alcoholism,0,0,2,5,5,12,0,0,0,0,5,5,17
JAMMU & KASHMIR,2012,By Drowning,0,4,2,0,1,7,0,3,1,0,0,4,11
JAMMU & KASHMIR,2012,By Fire/Self Immolation,0,1,3,0,0,4,0,5,4,2,0,11,15
JAMMU & KASHMIR,2012,By Fire-Arms,0,0,4,1,1,6,0,3,1,0,0,4,10
JAMMU & KASHMIR,2012,By Hanging,2,13,15,2,1,33,1,14,5,3,3,26,59
JAMMU & KASHMIR,2012,By Consuming Insecticides,0,4,9,1,0,14,0,19,18,3,3,43,57
JAMMU & KASHMIR,2012,By Consuming Other Poison,0,5,14,8,5,32,1,24,19,1,3,48,80
JAMMU & KASHMIR,2012,By Self Infliction of injury,0,0,0,0,0,0,0,0,1,0,0,1,1
JAMMU & KASHMIR,2012,By Jumping from (Building),0,0,1,1,2,4,0,2,1,1,2,6,10
JAMMU & KASHMIR,2012,By Jumping from (Other sites),0,1,1,2,1,5,0,1,2,2,0,5,10
JAMMU & KASHMIR,2012,By Jumping off Moving Vehicles/Trains,0,0,0,0,0,0,0,0,0,0,0,0,0
JAMMU & KASHMIR,2012,By Machine,0,1,3,1,0,5,0,1,1,1,0,3,8
JAMMU & KASHMIR,2012,By Overdose of sleeping pills,0,0,0,0,0,0,0,0,0,0,0,0,0
JAMMU & KASHMIR,2012,By touching electric wires,0,3,7,3,2,15,0,4,5,1,10,20,35
JAMMU & KASHMIR,2012,By coming under running vehicles/trains,0,6,4,5,1,16,0,4,1,0,0,5,21
JAMMU & KASHMIR,2012,By Other means (please specify),0,18,9,11,1,39,0,21,9,5,6,41,80
JAMMU & KASHMIR,2012,Total,2,56,74,40,20,192,2,101,68,19,32,222,414
JAMMU & KASHMIR,2012,Total (Poison),0,9,23,9,5,46,1,43,38,4,6,92,138
JAMMU & KASHMIR,2012,Total (Jumping),0,1,2,3,3,9,0,3,3,3,2,11,20
JHARKHAND,2001,By Over Alcoholism,0,0,4,0,0,4,0,0,0,0,0,0,4
JHARKHAND,2001,By Drowning,0,10,6,1,1,18,0,8,2,0,0,10,28
JHARKHAND,2001,By Fire/Self Immolation,0,2,4,3,1,10,0,9,15,4,0,28,38
JHARKHAND,2001,By Fire-Arms,0,0,0,0,0,0,0,1,0,0,0,1,1
JHARKHAND,2001,By Hanging,0,12,20,2,0,34,0,6,3,2,0,11,45
JHARKHAND,2001,By Consuming Insecticides,0,1,1,3,0,5,0,8,4,0,0,12,17
JHARKHAND,2001,By Consuming Other Poison,0,2,2,0,0,4,0,1,1,4,0,6,10
JHARKHAND,2001,By Self Infliction of injury,0,2,5,1,0,8,0,2,3,1,0,6,14
JHARKHAND,2001,By Jumping from (Building),0,0,4,4,0,8,0,3,0,2,0,5,13
JHARKHAND,2001,By Jumping from (Other sites),3,0,0,1,1,5,0,3,0,1,0,4,9
JHARKHAND,2001,By Jumping off Moving Vehicles/Trains,0,4,0,1,6,11,2,0,2,0,0,4,15
JHARKHAND,2001,By Machine,0,0,0,0,0,0,0,0,0,0,0,0,0
JHARKHAND,2001,By Overdose of sleeping pills,0,0,0,1,0,1,0,0,1,0,0,1,2
JHARKHAND,2001,By touching electric wires,0,2,1,0,0,3,0,0,0,1,0,1,4
JHARKHAND,2001,By coming under running vehicles/trains,1,0,0,0,0,1,0,4,0,0,0,4,5
JHARKHAND,2001,By Other means (please specify),0,10,9,9,1,29,3,5,0,8,0,16,45
JHARKHAND,2001,Total,4,45,56,26,10,141,5,50,31,23,0,109,250
JHARKHAND,2001,Total (Poison),0,5,8,4,0,17,0,11,8,5,0,24,41
JHARKHAND,2001,Total (Jumping),3,0,4,5,1,13,0,6,0,3,0,9,22
JHARKHAND,2002,By Over Alcoholism,0,0,5,0,0,5,0,0,0,0,0,0,5
JHARKHAND,2002,By Drowning,0,2,4,1,0,7,0,8,4,0,0,12,19
JHARKHAND,2002,By Fire/Self Immolation,0,1,3,2,0,6,0,9,18,4,0,31,37
JHARKHAND,2002,By Fire-Arms,0,0,0,0,0,0,0,1,0,0,0,1,1
JHARKHAND,2002,By Hanging,0,8,12,1,0,21,0,4,2,3,0,9,30
JHARKHAND,2002,By Consuming Insecticides,0,1,1,2,0,4,0,6,3,0,0,9,13
JHARKHAND,2002,By Consuming Other Poison,0,5,2,1,1,9,0,2,2,6,0,10,19
JHARKHAND,2002,By Self Infliction of injury,0,1,4,1,0,6,0,2,4,1,0,7,13
JHARKHAND,2002,By Jumping from (Building),2,1,5,4,2,14,0,3,1,2,0,6,20
JHARKHAND,2002,By Jumping from (Other sites),2,1,0,8,2,13,0,2,0,1,0,3,16
JHARKHAND,2002,By Jumping off Moving Vehicles/Trains,0,6,1,5,2,14,1,0,3,0,0,4,18
JHARKHAND,2002,By Machine,0,1,0,0,0,1,0,0,0,0,0,0,1
JHARKHAND,2002,By Overdose of sleeping pills,0,2,2,3,1,8,0,0,1,0,0,1,9
JHARKHAND,2002,By touching electric wires,4,8,2,2,2,18,1,0,0,3,0,4,22
JHARKHAND,2002,By coming under running vehicles/trains,1,0,0,0,0,1,0,3,0,0,0,3,4
JHARKHAND,2002,By Other means,0,8,11,6,1,26,2,7,2,8,0,19,45
JHARKHAND,2002,Total,9,45,52,36,11,153,4,47,40,28,0,119,272
JHARKHAND,2002,Total (Poison),0,7,7,4,1,19,0,10,9,7,0,26,45
JHARKHAND,2002,Total (Jumping),4,2,5,12,4,27,0,5,1,3,0,9,36
JHARKHAND,2003,By Over Alcoholism,0,0,5,0,0,5,0,0,0,0,0,0,5
JHARKHAND,2003,By Drowning,0,2,4,2,0,8,0,7,5,0,0,12,20
JHARKHAND,2003,By Fire/Self Immolation,0,1,4,2,0,7,0,6,14,3,0,23,30
JHARKHAND,2003,By Fire-Arms,0,0,0,0,0,0,0,1,0,0,0,1,1
JHARKHAND,2003,By Hanging,0,6,8,1,0,15,0,5,2,3,0,10,25
JHARKHAND,2003,By Consuming Insecticides,0,1,2,2,0,5,0,6,4,0,0,10,15
JHARKHAND,2003,By Consuming Other Poison,0,6,2,1,1,10,0,2,2,5,0,9,19
JHARKHAND,2003,By Self Infliction of injury,0,1,7,1,0,9,0,3,5,1,0,9,18
JHARKHAND,2003,By Jumping from (Building),2,1,4,4,2,13,0,4,1,3,0,8,21
JHARKHAND,2003,By Jumping from (Other sites),3,1,0,6,1,11,0,2,0,1,0,3,14
JHARKHAND,2003,By Jumping off Moving Vehicles/Trains,0,5,1,6,1,13,1,0,3,0,0,4,17
JHARKHAND,2003,By Machine,0,2,0,0,0,2,0,0,0,0,0,0,2
JHARKHAND,2003,By Overdose of sleeping pills,0,3,2,3,2,10,0,0,1,0,0,1,11
JHARKHAND,2003,By touching electric wires,2,7,1,3,2,15,1,0,0,3,0,4,19
JHARKHAND,2003,By coming under running vehicles/trains,1,0,0,0,0,1,0,3,0,0,0,3,4
JHARKHAND,2003,By Other means (please specify),1,9,12,5,2,29,2,8,3,9,0,22,51
JHARKHAND,2003,Total,9,45,52,36,11,153,4,47,40,28,0,119,272
JHARKHAND,2003,Total (Poison),0,8,11,4,1,24,0,11,11,6,0,28,52
JHARKHAND,2003,Total (Jumping),5,2,4,10,3,24,0,6,1,4,0,11,35
JHARKHAND,2004,By Over Alcoholism,0,0,7,2,0,9,0,0,0,0,0,0,9
JHARKHAND,2004,By Drowning,0,5,8,2,0,15,0,7,5,0,0,12,27
JHARKHAND,2004,By Fire/Self Immolation,0,3,6,4,0,13,0,13,23,4,0,40,53
JHARKHAND,2004,By Fire-Arms,0,0,0,0,0,0,0,1,0,0,0,1,1
JHARKHAND,2004,By Hanging,0,15,15,13,0,43,0,9,15,11,0,35,78
JHARKHAND,2004,By Consuming Insecticides,0,4,6,4,0,14,0,10,8,1,0,19,33
JHARKHAND,2004,By Consuming Other Poison,0,6,2,1,1,10,0,2,4,8,0,14,24
JHARKHAND,2004,By Self Infliction of injury,0,1,7,2,0,10,0,4,5,1,0,10,20
JHARKHAND,2004,By Jumping from (Building),2,3,8,6,1,20,0,4,1,3,0,8,28
JHARKHAND,2004,By Jumping from (Other sites),2,1,0,6,1,10,0,2,0,1,0,3,13
JHARKHAND,2004,By Jumping off Moving Vehicles/Trains,0,6,1,6,2,15,1,0,3,0,0,4,19
JHARKHAND,2004,By Machine,0,2,0,0,0,2,0,0,0,0,0,0,2
JHARKHAND,2004,By Overdose of sleeping pills,0,7,6,6,2,21,0,2,3,3,0,8,29
JHARKHAND,2004,By touching electric wires,3,10,2,4,2,21,1,0,0,4,0,5,26
JHARKHAND,2004,By coming under running vehicles/trains,1,0,0,0,0,1,0,3,0,0,0,3,4
JHARKHAND,2004,By Other means (please specify),1,9,12,5,2,29,2,8,3,9,0,22,51
JHARKHAND,2004,Total,9,72,80,61,11,233,4,65,70,45,0,184,417
JHARKHAND,2004,Total (Poison),0,11,15,7,1,34,0,16,17,10,0,43,77
JHARKHAND,2004,Total (Jumping),4,4,8,12,2,30,0,6,1,4,0,11,41
JHARKHAND,2005,By Over Alcoholism,1,14,10,12,1,38,0,0,5,3,0,8,46
JHARKHAND,2005,By Drowning,3,20,33,3,2,61,2,10,9,7,0,28,89
JHARKHAND,2005,By Fire/Self Immolation,1,3,6,8,1,19,2,11,17,2,1,33,52
JHARKHAND,2005,By Fire-Arms,0,3,9,5,0,17,0,1,2,0,0,3,20
JHARKHAND,2005,By Hanging,1,39,40,57,2,139,1,33,40,8,0,82,221
JHARKHAND,2005,By Consuming Insecticides,0,15,28,13,0,56,1,26,29,6,1,63,119
JHARKHAND,2005,By Consuming Other Poison,1,12,12,8,0,33,1,15,12,1,0,29,62
JHARKHAND,2005,By Self Infliction of injury,0,5,3,0,0,8,1,1,0,0,0,2,10
JHARKHAND,2005,By Jumping from (Building),0,4,6,0,0,10,0,0,1,0,0,1,11
JHARKHAND,2005,By Jumping from (Other sites),0,3,3,2,0,8,0,2,1,0,0,3,11
JHARKHAND,2005,By Jumping off Moving Vehicles/Trains,0,0,0,0,0,0,0,0,0,0,0,0,0
JHARKHAND,2005,By Machine,0,0,0,0,0,0,0,0,0,0,0,0,0
JHARKHAND,2005,By Overdose of sleeping pills,0,0,3,1,0,4,1,0,10,0,1,12,16
JHARKHAND,2005,By touching electric wires,1,9,4,2,0,16,1,0,0,0,1,2,18
JHARKHAND,2005,By coming under running vehicles/trains,0,0,0,0,0,0,0,0,0,0,0,0,0
JHARKHAND,2005,By Other means (please specify),0,54,30,22,8,114,3,13,2,1,0,19,133
JHARKHAND,2005,Total,8,181,187,133,14,523,13,112,128,28,4,285,808
JHARKHAND,2005,Total (Poison),1,32,43,21,0,97,3,42,41,7,1,94,191
JHARKHAND,2005,Total (Jumping),0,7,9,2,0,18,0,2,2,0,0,4,22
JHARKHAND,2006,By Over Alcoholism,0,8,18,9,0,35,0,0,2,2,0,4,39
JHARKHAND,2006,By Drowning,1,15,14,13,3,46,2,13,9,6,0,30,76
JHARKHAND,2006,By Fire/Self Immolation,1,8,11,4,1,25,2,24,20,7,0,53,78
JHARKHAND,2006,By Fire-Arms,0,0,3,0,0,3,0,0,0,0,0,0,3
JHARKHAND,2006,By Hanging,5,77,53,22,5,162,3,51,49,6,0,109,271
JHARKHAND,2006,By Consuming Insecticides,3,27,32,14,7,83,1,29,21,8,0,59,142
JHARKHAND,2006,By Consuming Other Poison,4,14,19,4,2,43,1,11,4,1,0,17,60
JHARKHAND,2006,By Self Infliction of injury,0,1,3,1,1,6,0,0,0,0,0,0,6
JHARKHAND,2006,By Jumping from (Building),0,8,4,0,0,12,0,3,1,0,0,4,16
JHARKHAND,2006,By Jumping from (Other sites),0,2,3,2,0,7,0,0,0,0,0,0,7
JHARKHAND,2006,By Jumping off Moving Vehicles/Trains,0,2,1,0,0,3,0,0,0,1,0,1,4
JHARKHAND,2006,By Machine,0,2,0,0,0,2,0,3,0,0,0,3,5
JHARKHAND,2006,By Overdose of sleeping pills,0,5,7,4,0,16,0,3,1,0,0,4,20
JHARKHAND,2006,By touching electric wires,0,2,3,0,0,5,1,0,1,0,0,2,7
JHARKHAND,2006,By coming under running vehicles/trains,0,0,3,2,0,5,0,1,0,0,0,1,6
JHARKHAND,2006,By Other means (please specify),7,19,19,20,3,68,5,20,12,7,4,48,116
JHARKHAND,2006,Total,21,190,193,95,22,521,15,158,120,38,4,335,856
JHARKHAND,2006,Total (Poison),7,42,54,19,10,132,2,40,25,9,0,76,208
JHARKHAND,2006,Total (Jumping),0,10,7,2,0,19,0,3,1,0,0,4,23
JHARKHAND,2007,By Over Alcoholism,0,10,14,9,6,39,0,1,4,1,1,7,46
JHARKHAND,2007,By Drowning,9,34,33,25,5,106,4,21,11,11,2,49,155
JHARKHAND,2007,By Fire/Self Immolation,9,14,17,9,4,53,3,23,26,11,2,65,118
JHARKHAND,2007,By Fire-Arms,0,0,1,1,1,3,0,3,0,0,0,3,6
JHARKHAND,2007,By Hanging,4,85,83,38,1,211,3,54,48,11,2,118,329
JHARKHAND,2007,By Consuming Insecticides,2,20,17,13,2,54,5,23,7,6,3,44,98
JHARKHAND,2007,By Consuming Other Poison,3,20,34,16,2,75,1,18,14,5,2,40,115
JHARKHAND,2007,By Self Infliction of injury,0,2,2,1,0,5,0,0,0,0,0,0,5
JHARKHAND,2007,By Jumping from (Building),0,7,13,6,0,26,0,1,2,3,0,6,32
JHARKHAND,2007,By Jumping from (Other sites),1,0,1,0,2,4,3,1,1,2,1,8,12
JHARKHAND,2007,By Jumping off Moving Vehicles/Trains,4,13,14,6,3,40,1,2,2,0,0,5,45
JHARKHAND,2007,By Machine,0,0,0,1,0,1,0,0,1,0,0,1,2
JHARKHAND,2007,By Overdose of sleeping pills,0,0,13,3,0,16,0,4,5,2,0,11,27
JHARKHAND,2007,By touching electric wires,2,6,13,5,2,28,1,0,1,0,1,3,31
JHARKHAND,2007,By coming under running vehicles/trains,0,1,2,1,1,5,0,0,1,1,0,2,7
JHARKHAND,2007,By Other means (please specify),12,49,59,63,31,214,1,27,12,1,6,47,261
JHARKHAND,2007,Total,46,261,316,197,60,880,22,178,135,54,20,409,1289
JHARKHAND,2007,Total (Poison),5,42,53,30,4,134,6,41,21,11,5,84,218
JHARKHAND,2007,Total (Jumping),1,7,14,6,2,30,3,2,3,5,1,14,44
JHARKHAND,2008,By Over Alcoholism,0,5,16,13,3,37,0,0,4,0,1,5,42
JHARKHAND,2008,By Drowning,6,24,42,25,7,104,7,11,9,7,1,35,139
JHARKHAND,2008,By Fire/Self Immolation,1,19,16,8,1,45,4,22,13,8,0,47,92
JHARKHAND,2008,By Fire-Arms,1,14,12,1,0,28,1,15,9,0,0,25,53
JHARKHAND,2008,By Hanging,3,27,38,31,8,107,3,16,14,11,1,45,152
JHARKHAND,2008,By Consuming Insecticides,2,26,16,7,3,54,6,9,11,4,0,30,84
JHARKHAND,2008,By Consuming Other Poison,2,16,20,14,2,54,0,14,16,10,1,41,95
JHARKHAND,2008,By Self Infliction of injury,0,2,0,0,0,2,0,1,0,2,0,3,5
JHARKHAND,2008,By Jumping from (Building),0,3,1,1,0,5,0,1,0,0,0,1,6
JHARKHAND,2008,By Jumping from (Other sites),1,3,12,4,1,21,0,1,1,2,0,4,25
JHARKHAND,2008,By Jumping off Moving Vehicles/Trains,0,3,0,1,1,5,0,0,0,0,0,0,5
JHARKHAND,2008,By Machine,0,1,1,1,0,3,0,0,0,0,0,0,3
JHARKHAND,2008,By Overdose of sleeping pills,0,2,9,2,0,13,0,3,5,1,0,9,22
JHARKHAND,2008,By touching electric wires,1,3,13,1,0,18,0,1,1,0,1,3,21
JHARKHAND,2008,By coming under running vehicles/trains,0,3,9,2,0,14,0,0,1,1,0,2,16
JHARKHAND,2008,By Other means (please specify),3,20,33,23,13,92,10,19,24,4,2,59,151
JHARKHAND,2008,Total,20,171,238,134,39,602,31,113,108,50,7,309,911
JHARKHAND,2008,Total (Poison),4,44,36,21,5,110,6,24,27,16,1,74,184
JHARKHAND,2008,Total (Jumping),1,6,13,5,1,26,0,2,1,2,0,5,31
JHARKHAND,2009,By Over Alcoholism,0,10,36,40,8,94,0,0,2,2,6,10,104
JHARKHAND,2009,By Drowning,4,36,42,18,1,101,3,21,16,4,4,48,149
JHARKHAND,2009,By Fire/Self Immolation,0,17,15,7,1,40,1,31,29,15,1,77,117
JHARKHAND,2009,By Fire-Arms,0,5,2,0,0,7,0,0,1,0,0,1,8
JHARKHAND,2009,By Hanging,4,48,68,44,4,168,6,24,25,16,0,71,239
JHARKHAND,2009,By Consuming Insecticides,2,34,37,19,5,97,3,27,22,9,1,62,159
JHARKHAND,2009,By Consuming Other Poison,2,14,15,9,1,41,0,9,11,8,0,28,69
JHARKHAND,2009,By Self Infliction of injury,0,4,4,0,1,9,0,1,2,0,0,3,12
JHARKHAND,2009,By Jumping from (Building),1,1,2,1,0,5,1,0,2,0,0,3,8
JHARKHAND,2009,By Jumping from (Other sites),1,8,5,1,0,15,0,2,3,0,0,5,20
JHARKHAND,2009,By Jumping off Moving Vehicles/Trains,0,1,1,1,1,4,0,0,0,0,0,0,4
JHARKHAND,2009,By Machine,0,1,1,4,0,6,0,0,0,0,0,0,6
JHARKHAND,2009,By Overdose of sleeping pills,1,8,8,4,2,23,0,3,4,1,0,8,31
JHARKHAND,2009,By touching electric wires,1,12,6,3,0,22,0,0,1,4,0,5,27
JHARKHAND,2009,By coming under running vehicles/trains,0,4,6,2,0,12,0,4,2,1,0,7,19
JHARKHAND,2009,By Other means (please specify),0,0,24,49,27,100,8,13,4,4,11,40,140
JHARKHAND,2009,Total,16,203,272,202,51,744,22,135,124,64,23,368,1112
JHARKHAND,2009,Total (Poison),4,52,56,28,7,147,3,37,35,17,1,93,240
JHARKHAND,2009,Total (Jumping),2,9,7,2,0,20,1,2,5,0,0,8,28
JHARKHAND,2010,By Over Alcoholism,0,7,7,8,1,23,0,4,2,6,0,12,35
JHARKHAND,2010,By Drowning,6,22,28,21,3,80,3,15,9,8,1,36,116
JHARKHAND,2010,By Fire/Self Immolation,0,16,22,10,0,48,1,25,11,2,1,40,88
JHARKHAND,2010,By Fire-Arms,0,0,1,0,0,1,0,1,2,0,0,3,4
JHARKHAND,2010,By Hanging,7,80,76,62,1,226,4,66,50,14,1,135,361
JHARKHAND,2010,By Consuming Insecticides,1,22,29,8,0,60,2,36,17,12,0,67,127
JHARKHAND,2010,By Consuming Other Poison,1,20,8,8,1,38,1,7,13,7,0,28,66
JHARKHAND,2010,By Self Infliction of injury,2,9,6,4,0,21,0,3,5,2,0,10,31
JHARKHAND,2010,By Jumping from (Building),0,0,1,0,0,1,0,3,0,0,0,3,4
JHARKHAND,2010,By Jumping from (Other sites),0,10,6,3,0,19,0,2,3,0,0,5,24
JHARKHAND,2010,By Jumping off Moving Vehicles/Trains,0,1,0,0,0,1,0,0,0,0,0,0,1
JHARKHAND,2010,By Machine,0,0,0,1,0,1,0,0,0,0,0,0,1
JHARKHAND,2010,By Overdose of sleeping pills,2,8,4,3,0,17,0,0,1,0,0,1,18
JHARKHAND,2010,By touching electric wires,1,4,4,1,0,10,0,1,0,0,0,1,11
JHARKHAND,2010,By coming under running vehicles/trains,0,1,5,1,1,8,0,1,0,0,0,1,9
JHARKHAND,2010,By Other means (please specify),64,52,78,42,5,241,5,11,29,29,21,95,336
JHARKHAND,2010,Total,84,252,275,172,12,795,16,175,142,80,24,437,1232
JHARKHAND,2010,Total (Poison),4,51,43,20,1,119,3,46,35,21,0,105,224
JHARKHAND,2010,Total (Jumping),0,10,7,3,0,20,0,5,3,0,0,8,28
JHARKHAND,2011,By Over Alcoholism,0,7,7,5,1,20,0,0,1,1,0,2,22
JHARKHAND,2011,By Drowning,4,39,28,21,5,97,3,14,8,6,1,32,129
JHARKHAND,2011,By Fire/Self Immolation,0,17,21,14,1,53,0,24,11,3,1,39,92
JHARKHAND,2011,By Fire-Arms,0,0,2,0,0,2,0,1,0,0,0,1,3
JHARKHAND,2011,By Hanging,8,125,92,69,10,304,6,77,40,13,2,138,442
JHARKHAND,2011,By Consuming Insecticides,0,48,25,4,0,77,4,20,15,7,4,50,127
JHARKHAND,2011,By Consuming Other Poison,0,13,3,8,0,24,1,16,16,5,1,39,63
JHARKHAND,2011,By Self Infliction of injury,0,0,0,0,0,0,0,2,1,0,0,3,3
JHARKHAND,2011,By Jumping from (Building),0,1,1,1,0,3,0,0,0,0,0,0,3
JHARKHAND,2011,By Jumping from (Other sites),0,0,0,0,0,0,0,0,0,0,0,0,0
JHARKHAND,2011,By Jumping off Moving Vehicles/Trains,0,6,5,2,1,14,0,5,3,0,0,8,22
JHARKHAND,2011,By Machine,0,4,0,1,0,5,0,0,0,0,0,0,5
JHARKHAND,2011,By Overdose of sleeping pills,1,5,2,2,0,10,0,3,1,0,0,4,14
JHARKHAND,2011,By touching electric wires,0,0,0,0,0,0,0,0,0,0,0,0,0
JHARKHAND,2011,By coming under running vehicles/trains,0,1,4,0,0,5,0,2,0,2,0,4,9
JHARKHAND,2011,By Other means (please specify),0,58,73,52,28,211,4,25,31,7,0,67,278
JHARKHAND,2011,Total,13,324,263,179,46,825,18,189,127,44,9,387,1212
JHARKHAND,2011,Total (Poison),0,61,28,12,0,101,5,38,32,12,5,92,193
JHARKHAND,2011,Total (Jumping),0,1,1,1,0,3,0,0,0,0,0,0,3
JHARKHAND,2012,By Over Alcoholism,0,1,8,16,12,37,0,3,0,1,0,4,41
JHARKHAND,2012,By Drowning,4,25,21,18,5,73,2,10,7,3,2,24,97
JHARKHAND,2012,By Fire/Self Immolation,2,20,17,11,0,50,6,36,26,11,0,79,129
JHARKHAND,2012,By Fire-Arms,0,0,1,3,0,4,0,0,0,0,0,0,4
JHARKHAND,2012,By Hanging,4,78,58,60,3,203,4,60,41,17,0,122,325
JHARKHAND,2012,By Consuming Insecticides,5,60,39,25,6,135,7,44,25,13,1,90,225
JHARKHAND,2012,By Consuming Other Poison,3,18,18,12,4,55,3,11,11,9,1,35,90
JHARKHAND,2012,By Self Infliction of injury,0,8,2,1,0,11,0,3,0,0,0,3,14
JHARKHAND,2012,By Jumping from (Building),0,1,0,0,0,1,0,0,0,0,0,0,1
JHARKHAND,2012,By Jumping from (Other sites),0,6,4,9,0,19,0,12,7,1,0,20,39
JHARKHAND,2012,By Jumping off Moving Vehicles/Trains,0,1,6,0,0,7,3,2,1,0,0,6,13
JHARKHAND,2012,By Machine,0,3,6,3,0,12,0,0,0,0,0,0,12
JHARKHAND,2012,By Overdose of sleeping pills,0,4,6,2,0,12,1,7,4,3,0,15,27
JHARKHAND,2012,By touching electric wires,0,3,7,2,1,13,0,0,3,0,0,3,16
JHARKHAND,2012,By coming under running vehicles/trains,0,4,9,2,1,16,3,1,0,1,0,5,21
JHARKHAND,2012,By Other means (please specify),5,65,65,34,21,190,5,28,27,11,4,75,265
JHARKHAND,2012,Total,23,297,267,198,53,838,34,217,152,70,8,481,1319
JHARKHAND,2012,Total (Poison),8,86,59,38,10,201,10,58,36,22,2,128,329
JHARKHAND,2012,Total (Jumping),0,7,4,9,0,20,0,12,7,1,0,20,40
KARNATAKA,2001,By Over Alcoholism,0,33,91,54,29,207,0,2,9,10,3,24,231
KARNATAKA,2001,By Drowning,46,228,262,171,71,778,38,258,170,117,75,658,1436
KARNATAKA,2001,By Fire/Self Immolation,10,83,150,73,19,335,17,330,208,92,21,668,1003
KARNATAKA,2001,By Fire-Arms,4,6,6,4,3,23,0,6,3,1,0,10,33
KARNATAKA,2001,By Hanging,39,635,756,514,183,2127,33,468,236,110,60,907,3034
KARNATAKA,2001,By Consuming Insecticides,9,297,354,237,102,999,21,178,116,49,18,382,1381
KARNATAKA,2001,By Consuming Other Poison,33,694,857,492,200,2276,39,430,254,138,49,910,3186
KARNATAKA,2001,By Self Infliction of injury,0,2,2,7,1,12,1,0,0,1,0,2,14
KARNATAKA,2001,By Jumping from (Building),1,1,8,3,2,15,1,3,0,0,0,4,19
KARNATAKA,2001,By Jumping from (Other sites),3,15,25,26,4,73,0,16,7,3,0,26,99
KARNATAKA,2001,By Jumping off Moving Vehicles/Trains,0,0,1,0,0,1,0,0,0,0,0,0,1
KARNATAKA,2001,By Machine,2,7,3,0,0,12,1,0,1,0,0,2,14
KARNATAKA,2001,By Overdose of sleeping pills,1,13,18,15,7,54,4,11,7,2,0,24,78
KARNATAKA,2001,By touching electric wires,4,11,28,16,1,60,2,4,4,1,2,13,73
KARNATAKA,2001,By coming under running vehicles/trains,2,93,134,66,38,333,2,17,15,22,10,66,399
KARNATAKA,2001,By Other means (please specify),26,124,185,158,73,566,25,94,88,80,27,314,880
KARNATAKA,2001,Total,180,2242,2880,1836,733,7871,184,1817,1118,626,265,4010,11881
KARNATAKA,2001,Total (Poison),42,993,1213,736,303,3287,61,608,370,188,67,1294,4581
KARNATAKA,2001,Total (Jumping),4,16,33,29,6,88,1,19,7,3,0,30,118
KARNATAKA,2002,By Over Alcoholism,0,29,53,59,27,168,0,2,2,1,2,7,175
KARNATAKA,2002,By Drowning,27,204,266,170,83,750,35,200,178,121,83,617,1367
KARNATAKA,2002,By Fire/Self Immolation,4,70,157,86,9,326,20,256,243,68,42,629,955
KARNATAKA,2002,By Fire-Arms,0,6,21,5,1,33,0,8,7,0,0,15,48
KARNATAKA,2002,By Hanging,27,712,910,495,204,2348,84,540,269,106,67,1066,3414
KARNATAKA,2002,By Consuming Insecticides,10,244,368,211,121,954,16,180,123,62,23,404,1358
KARNATAKA,2002,By Consuming Other Poison,32,629,788,488,212,2149,25,370,255,129,63,842,2991
KARNATAKA,2002,By Self Infliction of injury,0,3,6,3,1,13,0,2,0,2,0,4,17
KARNATAKA,2002,By Jumping from (Building),1,3,4,0,0,8,0,1,2,1,0,4,12
KARNATAKA,2002,By Jumping from (Other sites),2,15,15,19,20,71,1,5,9,15,11,41,112
KARNATAKA,2002,By Jumping off Moving Vehicles/Trains,0,1,0,0,0,1,0,0,0,0,0,0,1
KARNATAKA,2002,By Machine,0,1,1,0,0,2,0,0,0,0,0,0,2
KARNATAKA,2002,By Overdose of sleeping pills,1,18,21,35,7,82,2,11,5,7,0,25,107
KARNATAKA,2002,By touching electric wires,4,18,11,11,3,47,1,2,4,0,0,7,54
KARNATAKA,2002,By coming under running vehicles/trains,2,117,187,102,41,449,3,36,33,13,5,90,539
KARNATAKA,2002,By Other means,11,215,223,148,82,679,17,183,152,43,44,439,1118
KARNATAKA,2002,Total,121,2285,3031,1832,811,8080,204,1796,1282,568,340,4190,12270
KARNATAKA,2002,Total (Poison),42,876,1162,702,334,3116,41,552,378,193,86,1250,4366
KARNATAKA,2002,Total (Jumping),3,18,19,19,20,79,1,6,11,16,11,45,124
KARNATAKA,2003,By Over Alcoholism,1,12,50,40,10,113,1,1,4,6,1,13,126
KARNATAKA,2003,By Drowning,51,172,202,149,90,664,11,176,168,81,54,490,1154
KARNATAKA,2003,By Fire/Self Immolation,5,85,89,42,6,227,8,213,171,53,24,469,696
KARNATAKA,2003,By Fire-Arms,1,6,9,6,2,24,2,1,4,1,1,9,33
KARNATAKA,2003,By Hanging,37,761,894,592,262,2546,33,468,352,159,75,1087,3633
KARNATAKA,2003,By Consuming Insecticides,10,434,494,282,87,1307,24,203,116,95,31,469,1776
KARNATAKA,2003,By Consuming Other Poison,20,618,696,505,203,2042,38,351,268,141,74,872,2914
KARNATAKA,2003,By Self Infliction of injury,0,1,8,3,5,17,0,0,1,0,1,2,19
KARNATAKA,2003,By Jumping from (Building),0,4,10,1,2,17,0,0,0,0,0,0,17
KARNATAKA,2003,By Jumping from (Other sites),3,5,19,15,1,43,1,2,3,3,0,9,52
KARNATAKA,2003,By Jumping off Moving Vehicles/Trains,0,0,0,0,0,0,0,0,0,0,0,0,0
KARNATAKA,2003,By Machine,0,2,0,0,1,3,0,0,0,0,0,0,3
KARNATAKA,2003,By Overdose of sleeping pills,0,18,19,15,8,60,0,6,7,2,1,16,76
KARNATAKA,2003,By touching electric wires,2,16,13,7,1,39,1,1,4,0,0,6,45
KARNATAKA,2003,By coming under running vehicles/trains,1,116,177,120,37,451,3,27,30,15,14,89,540
KARNATAKA,2003,By Other means (please specify),11,176,215,225,195,822,32,182,153,55,33,455,1277
KARNATAKA,2003,Total,142,2426,2895,2002,910,8375,154,1631,1281,611,309,3986,12361
KARNATAKA,2003,Total (Poison),30,1053,1198,790,295,3366,62,554,385,236,106,1343,4709
KARNATAKA,2003,Total (Jumping),3,9,29,16,3,60,1,2,3,3,0,9,69
KARNATAKA,2004,By Over Alcoholism,0,22,68,45,14,149,0,2,3,2,1,8,157
KARNATAKA,2004,By Drowning,33,179,199,103,66,580,11,133,139,81,67,431,1011
KARNATAKA,2004,By Fire/Self Immolation,4,62,94,61,5,226,12,192,165,56,23,448,674
KARNATAKA,2004,By Fire-Arms,1,26,34,9,4,74,2,21,16,15,1,55,129
KARNATAKA,2004,By Hanging,28,682,920,571,188,2389,29,508,325,164,59,1085,3474
KARNATAKA,2004,By Consuming Insecticides,17,273,278,173,80,821,13,176,105,33,25,352,1173
KARNATAKA,2004,By Consuming Other Poison,21,704,715,473,173,2086,47,347,286,137,40,857,2943
KARNATAKA,2004,By Self Infliction of injury,0,0,6,1,0,7,0,0,1,1,0,2,9
KARNATAKA,2004,By Jumping from (Building),0,12,13,5,1,31,0,5,2,4,0,11,42
KARNATAKA,2004,By Jumping from (Other sites),2,6,3,2,1,14,4,5,2,1,0,12,26
KARNATAKA,2004,By Jumping off Moving Vehicles/Trains,0,1,1,1,0,3,0,0,0,0,0,0,3
KARNATAKA,2004,By Machine,0,0,3,0,0,3,0,0,0,0,0,0,3
KARNATAKA,2004,By Overdose of sleeping pills,0,9,10,7,6,32,0,14,2,1,0,17,49
KARNATAKA,2004,By touching electric wires,2,14,13,13,5,47,6,6,6,2,1,21,68
KARNATAKA,2004,By coming under running vehicles/trains,1,105,182,121,36,445,0,27,31,10,11,79,524
KARNATAKA,2004,By Other means (please specify),50,234,389,277,161,1111,22,252,148,90,29,541,1652
KARNATAKA,2004,Total,159,2329,2928,1862,740,8018,146,1688,1231,597,257,3919,11937
KARNATAKA,2004,Total (Poison),38,977,999,647,253,2914,60,523,392,171,65,1211,4125
KARNATAKA,2004,Total (Jumping),2,18,16,7,2,45,4,10,4,5,0,23,68
KARNATAKA,2005,By Over Alcoholism,0,8,26,30,4,68,0,0,2,2,0,4,72
KARNATAKA,2005,By Drowning,22,160,230,168,67,647,15,160,157,74,71,477,1124
KARNATAKA,2005,By Fire/Self Immolation,4,42,81,28,9,164,2,198,109,54,13,376,540
KARNATAKA,2005,By Fire-Arms,1,32,37,19,1,90,2,38,15,8,1,64,154
KARNATAKA,2005,By Hanging,16,708,940,565,216,2445,18,466,347,165,55,1051,3496
KARNATAKA,2005,By Consuming Insecticides,4,197,232,189,68,690,0,94,97,59,18,268,958
KARNATAKA,2005,By Consuming Other Poison,10,687,735,513,170,2115,15,432,272,127,52,898,3013
KARNATAKA,2005,By Self Infliction of injury,1,7,8,4,1,21,1,18,7,1,0,27,48
KARNATAKA,2005,By Jumping from (Building),1,2,9,5,0,17,0,1,0,0,0,1,18
KARNATAKA,2005,By Jumping from (Other sites),4,10,8,4,1,27,1,1,1,1,0,4,31
KARNATAKA,2005,By Jumping off Moving Vehicles/Trains,0,0,0,0,0,0,1,0,0,0,0,1,1
KARNATAKA,2005,By Machine,0,0,1,0,0,1,0,0,0,0,0,0,1
KARNATAKA,2005,By Overdose of sleeping pills,2,0,1,1,0,4,0,6,2,0,0,8,12
KARNATAKA,2005,By touching electric wires,1,15,4,2,1,23,0,2,1,1,0,4,27
KARNATAKA,2005,By coming under running vehicles/trains,0,163,61,127,1,352,0,23,34,14,0,71,423
KARNATAKA,2005,By Other means (please specify),38,230,318,297,160,1043,32,175,182,145,62,596,1639
KARNATAKA,2005,Total,104,2261,2691,1952,699,7707,87,1614,1226,651,272,3850,11557
KARNATAKA,2005,Total (Poison),15,891,975,706,239,2826,16,544,376,187,70,1193,4019
KARNATAKA,2005,Total (Jumping),5,12,17,9,1,44,1,2,1,1,0,5,49
KARNATAKA,2006,By Over Alcoholism,0,19,63,37,8,127,0,0,2,1,0,3,130
KARNATAKA,2006,By Drowning,25,178,219,123,62,607,15,154,197,101,59,526,1133
KARNATAKA,2006,By Fire/Self Immolation,2,55,79,40,15,191,11,194,148,62,26,441,632
KARNATAKA,2006,By Fire-Arms,0,6,9,6,2,23,0,5,1,1,0,7,30
KARNATAKA,2006,By Hanging,24,661,961,623,192,2461,25,517,313,185,47,1087,3548
KARNATAKA,2006,By Consuming Insecticides,9,233,280,222,106,850,6,151,108,67,20,352,1202
KARNATAKA,2006,By Consuming Other Poison,17,654,736,605,141,2153,40,400,325,146,42,953,3106
KARNATAKA,2006,By Self Infliction of injury,0,8,7,4,3,22,0,1,0,0,0,1,23
KARNATAKA,2006,By Jumping from (Building),0,9,7,4,0,20,0,5,1,0,1,7,27
KARNATAKA,2006,By Jumping from (Other sites),2,20,20,18,5,65,0,15,5,4,2,26,91
KARNATAKA,2006,By Jumping off Moving Vehicles/Trains,0,0,0,1,0,1,0,0,0,0,0,0,1
KARNATAKA,2006,By Machine,0,0,1,1,0,2,0,0,0,0,0,0,2
KARNATAKA,2006,By Overdose of sleeping pills,0,5,6,2,0,13,1,5,2,0,2,10,23
KARNATAKA,2006,By touching electric wires,2,1,4,2,1,10,0,0,2,0,0,2,12
KARNATAKA,2006,By coming under running vehicles/trains,0,83,62,127,1,273,0,19,30,10,0,59,332
KARNATAKA,2006,By Other means (please specify),70,375,386,210,189,1230,33,287,191,113,66,690,1920
KARNATAKA,2006,Total,151,2307,2840,2025,725,8048,131,1753,1325,690,265,4164,12212
KARNATAKA,2006,Total (Poison),26,895,1023,831,250,3025,46,552,433,213,62,1306,4331
KARNATAKA,2006,Total (Jumping),2,29,27,22,5,85,0,20,6,4,3,33,118
KARNATAKA,2007,By Over Alcoholism,0,18,60,62,13,153,0,2,4,6,3,15,168
KARNATAKA,2007,By Drowning,26,142,228,173,39,608,14,131,134,88,50,417,1025
KARNATAKA,2007,By Fire/Self Immolation,2,52,97,47,17,215,23,155,111,51,18,358,573
KARNATAKA,2007,By Fire-Arms,0,5,4,3,2,14,0,4,6,4,1,15,29
KARNATAKA,2007,By Hanging,18,712,950,723,197,2600,22,454,328,146,52,1002,3602
KARNATAKA,2007,By Consuming Insecticides,10,150,193,130,46,529,22,127,74,52,7,282,811
KARNATAKA,2007,By Consuming Other Poison,14,576,817,649,184,2240,17,347,315,174,71,924,3164
KARNATAKA,2007,By Self Infliction of injury,0,6,1,3,4,14,0,3,10,0,3,16,30
KARNATAKA,2007,By Jumping from (Building),0,13,9,9,2,33,0,4,3,2,1,10,43
KARNATAKA,2007,By Jumping from (Other sites),0,15,17,9,8,49,0,9,6,1,1,17,66
KARNATAKA,2007,By Jumping off Moving Vehicles/Trains,0,1,1,1,1,4,0,0,1,0,0,1,5
KARNATAKA,2007,By Machine,0,0,2,0,0,2,0,0,0,0,0,0,2
KARNATAKA,2007,By Overdose of sleeping pills,4,16,10,6,1,37,0,11,4,1,0,16,53
KARNATAKA,2007,By touching electric wires,1,19,17,7,8,52,1,0,2,0,0,3,55
KARNATAKA,2007,By coming under running vehicles/trains,0,102,87,136,0,325,0,15,28,15,0,58,383
KARNATAKA,2007,By Other means (please specify),34,327,491,461,204,1517,28,261,209,213,67,778,2295
KARNATAKA,2007,Total,109,2154,2984,2419,726,8392,127,1523,1235,753,274,3912,12304
KARNATAKA,2007,Total (Poison),24,732,1011,782,234,2783,39,477,399,226,81,1222,4005
KARNATAKA,2007,Total (Jumping),0,28,26,18,10,82,0,13,9,3,2,27,109
KARNATAKA,2008,By Over Alcoholism,0,18,67,50,24,159,0,22,21,14,5,62,221
KARNATAKA,2008,By Drowning,14,171,244,157,79,665,9,139,127,69,43,387,1052
KARNATAKA,2008,By Fire/Self Immolation,1,63,92,56,18,230,8,192,92,47,11,350,580
KARNATAKA,2008,By Fire-Arms,0,4,8,4,4,20,0,10,6,1,1,18,38
KARNATAKA,2008,By Hanging,15,712,889,684,220,2520,28,544,348,153,87,1160,3680
KARNATAKA,2008,By Consuming Insecticides,3,212,334,216,93,858,4,182,121,76,44,427,1285
KARNATAKA,2008,By Consuming Other Poison,6,522,707,541,155,1931,9,285,269,162,57,782,2713
KARNATAKA,2008,By Self Infliction of injury,2,13,26,7,1,49,3,28,9,4,6,50,99
KARNATAKA,2008,By Jumping from (Building),0,13,4,6,1,24,1,2,1,1,0,5,29
KARNATAKA,2008,By Jumping from (Other sites),1,15,17,5,9,47,0,8,2,5,2,17,64
KARNATAKA,2008,By Jumping off Moving Vehicles/Trains,0,1,1,0,0,2,0,6,3,2,0,11,13
KARNATAKA,2008,By Machine,0,0,0,0,0,0,0,0,0,0,0,0,0
KARNATAKA,2008,By Overdose of sleeping pills,0,2,7,0,2,11,0,3,0,1,1,5,16
KARNATAKA,2008,By touching electric wires,2,20,26,19,3,70,0,10,13,4,1,28,98
KARNATAKA,2008,By coming under running vehicles/trains,0,99,69,181,5,354,0,35,18,4,0,57,411
KARNATAKA,2008,By Other means (please specify),10,333,379,377,177,1276,18,191,231,147,60,647,1923
KARNATAKA,2008,Total,54,2198,2870,2303,791,8216,80,1657,1261,690,318,4006,12222
KARNATAKA,2008,Total (Poison),11,747,1067,764,249,2838,16,495,399,242,107,1259,4097
KARNATAKA,2008,Total (Jumping),1,28,21,11,10,71,1,10,3,6,2,22,93
KARNATAKA,2009,By Over Alcoholism,0,43,73,97,36,249,1,6,0,6,0,13,262
KARNATAKA,2009,By Drowning,5,125,232,171,68,601,7,127,145,101,54,434,1035
KARNATAKA,2009,By Fire/Self Immolation,2,56,97,41,17,213,6,171,173,64,9,423,636
KARNATAKA,2009,By Fire-Arms,1,39,36,31,5,112,4,34,29,16,2,85,197
KARNATAKA,2009,By Hanging,33,617,857,615,249,2371,20,411,335,196,73,1035,3406
KARNATAKA,2009,By Consuming Insecticides,6,187,317,215,80,805,5,158,104,73,28,368,1173
KARNATAKA,2009,By Consuming Other Poison,11,386,752,568,169,1886,15,254,253,216,79,817,2703
KARNATAKA,2009,By Self Infliction of injury,1,9,12,3,3,28,0,5,2,3,0,10,38
KARNATAKA,2009,By Jumping from (Building),0,12,21,25,13,71,11,7,4,6,9,37,108
KARNATAKA,2009,By Jumping from (Other sites),2,21,13,4,6,46,1,6,2,1,0,10,56
KARNATAKA,2009,By Jumping off Moving Vehicles/Trains,0,0,1,0,0,1,0,0,2,0,0,2,3
KARNATAKA,2009,By Machine,0,0,2,0,0,2,0,0,0,0,1,1,3
KARNATAKA,2009,By Overdose of sleeping pills,0,3,5,1,1,10,1,4,5,0,4,14,24
KARNATAKA,2009,By touching electric wires,0,37,39,17,4,97,1,17,10,10,4,42,139
KARNATAKA,2009,By coming under running vehicles/trains,2,97,157,76,30,362,0,19,25,16,13,73,435
KARNATAKA,2009,By Other means (please specify),140,187,289,467,272,1355,91,87,163,187,94,622,1977
KARNATAKA,2009,Total,203,1819,2903,2331,953,8209,163,1306,1252,895,370,3986,12195
KARNATAKA,2009,Total (Poison),18,582,1081,786,252,2719,20,417,359,292,107,1195,3914
KARNATAKA,2009,Total (Jumping),2,33,34,29,19,117,12,13,6,7,9,47,164
KARNATAKA,2010,By Over Alcoholism,0,22,36,30,41,129,0,2,3,9,12,26,155
KARNATAKA,2010,By Drowning,8,160,231,189,80,668,13,125,115,105,48,406,1074
KARNATAKA,2010,By Fire/Self Immolation,8,76,112,41,8,245,11,130,97,104,23,365,610
KARNATAKA,2010,By Fire-Arms,0,9,18,8,8,43,17,21,9,6,1,54,97
KARNATAKA,2010,By Hanging,19,634,880,738,175,2446,33,478,373,192,77,1153,3599
KARNATAKA,2010,By Consuming Insecticides,17,236,291,165,78,787,31,205,134,34,16,420,1207
KARNATAKA,2010,By Consuming Other Poison,12,509,725,761,269,2276,12,338,346,216,90,1002,3278
KARNATAKA,2010,By Self Infliction of injury,0,2,1,0,0,3,1,7,0,0,0,8,11
KARNATAKA,2010,By Jumping from (Building),0,31,20,13,10,74,0,21,8,5,0,34,108
KARNATAKA,2010,By Jumping from (Other sites),0,20,19,22,6,67,1,3,2,2,1,9,76
KARNATAKA,2010,By Jumping off Moving Vehicles/Trains,0,0,0,0,0,0,0,0,0,0,0,0,0
KARNATAKA,2010,By Machine,0,0,0,0,0,0,0,0,0,0,0,0,0
KARNATAKA,2010,By Overdose of sleeping pills,0,0,2,4,2,8,0,3,2,1,2,8,16
KARNATAKA,2010,By touching electric wires,1,20,19,13,3,56,1,15,10,7,2,35,91
KARNATAKA,2010,By coming under running vehicles/trains,2,106,149,99,50,406,2,26,24,16,6,74,480
KARNATAKA,2010,By Other means (please specify),20,245,362,305,267,1199,46,228,125,138,113,650,1849
KARNATAKA,2010,Total,87,2070,2865,2388,997,8407,168,1602,1248,835,391,4244,12651
KARNATAKA,2010,Total (Poison),29,747,1017,926,347,3066,44,550,480,250,106,1430,4496
KARNATAKA,2010,Total (Jumping),0,51,39,35,16,141,1,24,10,7,1,43,184
KARNATAKA,2011,By Over Alcoholism,1,13,66,79,34,193,0,0,2,5,2,9,202
KARNATAKA,2011,By Drowning,11,171,237,137,76,632,4,130,126,76,32,368,1000
KARNATAKA,2011,By Fire/Self Immolation,3,101,108,69,14,295,3,186,136,76,31,432,727
KARNATAKA,2011,By Fire-Arms,1,11,6,1,4,23,1,10,6,2,0,19,42
KARNATAKA,2011,By Hanging,10,681,1106,613,192,2602,20,492,343,214,48,1117,3719
KARNATAKA,2011,By Consuming Insecticides,1,229,209,151,87,677,5,158,74,64,15,316,993
KARNATAKA,2011,By Consuming Other Poison,14,539,745,532,156,1986,9,371,286,224,47,937,2923
KARNATAKA,2011,By Self Infliction of injury,0,12,12,15,18,57,1,9,12,14,10,46,103
KARNATAKA,2011,By Jumping from (Building),2,40,32,14,8,96,2,41,22,14,3,82,178
KARNATAKA,2011,By Jumping from (Other sites),0,7,9,5,1,22,0,4,1,2,0,7,29
KARNATAKA,2011,By Jumping off Moving Vehicles/Trains,0,0,1,1,2,4,0,0,0,0,0,0,4
KARNATAKA,2011,By Machine,3,5,6,6,2,22,0,0,0,0,0,0,22
KARNATAKA,2011,By Overdose of sleeping pills,0,3,11,0,0,14,0,1,2,2,0,5,19
KARNATAKA,2011,By touching electric wires,2,14,10,5,4,35,0,9,6,9,3,27,62
KARNATAKA,2011,By coming under running vehicles/trains,3,103,141,92,38,377,0,33,25,13,6,77,454
KARNATAKA,2011,By Other means (please specify),169,397,345,379,147,1437,43,168,222,160,115,708,2145
KARNATAKA,2011,Total,220,2326,3044,2099,783,8472,88,1612,1263,875,312,4150,12622
KARNATAKA,2011,Total (Poison),15,780,966,698,261,2720,15,538,372,302,72,1299,4019
KARNATAKA,2011,Total (Jumping),2,47,41,19,9,118,2,45,23,16,3,89,207
KARNATAKA,2012,By Over Alcoholism,0,10,27,13,3,53,0,0,1,0,0,1,54
KARNATAKA,2012,By Drowning,12,156,238,142,60,608,9,110,112,68,32,331,939
KARNATAKA,2012,By Fire/Self Immolation,4,82,171,70,18,345,8,175,173,81,24,461,806
KARNATAKA,2012,By Fire-Arms,0,4,5,1,4,14,1,2,3,0,0,6,20
KARNATAKA,2012,By Hanging,21,945,1213,798,245,3222,29,713,425,227,72,1466,4688
KARNATAKA,2012,By Consuming Insecticides,1,164,125,114,46,450,1,101,73,25,13,213,663
KARNATAKA,2012,By Consuming Other Poison,16,605,815,563,182,2181,10,412,298,206,66,992,3173
KARNATAKA,2012,By Self Infliction of injury,0,2,1,2,0,5,0,1,1,0,0,2,7
KARNATAKA,2012,By Jumping from (Building),0,5,7,5,1,18,1,0,0,1,1,3,21
KARNATAKA,2012,By Jumping from (Other sites),1,2,7,1,0,11,0,1,1,0,1,3,14
KARNATAKA,2012,By Jumping off Moving Vehicles/Trains,0,1,7,0,0,8,0,0,0,0,0,0,8
KARNATAKA,2012,By Machine,3,0,6,1,3,13,0,0,0,0,0,0,13
KARNATAKA,2012,By Overdose of sleeping pills,0,3,6,3,2,14,0,3,0,0,5,8,22
KARNATAKA,2012,By touching electric wires,0,7,8,5,3,23,0,8,3,8,2,21,44
KARNATAKA,2012,By coming under running vehicles/trains,0,137,125,142,28,432,0,16,30,11,4,61,493
KARNATAKA,2012,By Other means (please specify),20,235,396,380,168,1199,19,244,143,129,54,589,1788
KARNATAKA,2012,Total,78,2358,3157,2240,763,8596,78,1786,1263,756,274,4157,12753
KARNATAKA,2012,Total (Poison),17,771,941,679,228,2636,11,514,372,231,79,1207,3843
KARNATAKA,2012,Total (Jumping),1,7,14,6,1,29,1,1,1,1,2,6,35
KERALA,2001,By Over Alcoholism,0,1,22,32,7,62,0,0,0,0,0,0,62
KERALA,2001,By Drowning,4,52,102,89,80,327,6,59,64,91,92,312,639
KERALA,2001,By Fire/Self Immolation,0,35,33,53,51,172,12,140,135,95,95,477,649
KERALA,2001,By Fire-Arms,0,1,0,0,0,1,0,0,0,0,0,0,1
KERALA,2001,By Hanging,20,543,947,978,559,3047,16,298,271,237,135,957,4004
KERALA,2001,By Consuming Insecticides,9,197,453,537,328,1524,12,164,155,101,75,507,2031
KERALA,2001,By Consuming Other Poison,9,180,397,405,182,1173,1,83,129,109,59,381,1554
KERALA,2001,By Self Infliction of injury,0,2,2,5,5,14,0,0,2,2,1,5,19
KERALA,2001,By Jumping from (Building),0,6,6,1,2,15,0,5,3,2,0,10,25
KERALA,2001,By Jumping from (Other sites),0,5,6,11,4,26,0,3,7,4,3,17,43
KERALA,2001,By Jumping off Moving Vehicles/Trains,0,26,21,18,13,78,0,12,7,6,3,28,106
KERALA,2001,By Machine,0,0,0,0,0,0,0,0,0,0,0,0,0
KERALA,2001,By Overdose of sleeping pills,0,6,17,19,7,49,0,6,6,7,4,23,72
KERALA,2001,By touching electric wires,0,4,5,3,0,12,0,2,1,0,0,3,15
KERALA,2001,By coming under running vehicles/trains,0,24,63,45,36,168,0,11,11,5,6,33,201
KERALA,2001,By Other means (please specify),1,27,33,44,14,119,1,11,7,7,6,32,151
KERALA,2001,Total,43,1109,2107,2240,1288,6787,48,794,798,666,479,2785,9572
KERALA,2001,Total (Poison),18,379,852,947,515,2711,13,247,286,212,135,893,3604
KERALA,2001,Total (Jumping),0,11,12,12,6,41,0,8,10,6,3,27,68
KERALA,2002,By Over Alcoholism,0,7,45,86,31,169,0,0,3,0,1,4,173
KERALA,2002,By Drowning,3,60,81,123,117,384,7,75,103,77,64,326,710
KERALA,2002,By Fire/Self Immolation,3,31,32,38,31,135,9,89,95,86,56,335,470
KERALA,2002,By Fire-Arms,0,0,0,0,0,0,0,4,0,0,0,4,4
KERALA,2002,By Hanging,24,669,1030,956,621,3300,21,256,341,212,150,980,4280
KERALA,2002,By Consuming Insecticides,10,229,459,478,261,1437,9,137,131,112,60,449,1886
KERALA,2002,By Consuming Other Poison,11,182,378,339,321,1231,17,95,110,90,71,383,1614
KERALA,2002,By Self Infliction of injury,2,17,42,64,30,155,2,11,20,25,5,63,218
KERALA,2002,By Jumping from (Building),0,4,3,4,0,11,0,0,1,0,0,1,12
KERALA,2002,By Jumping from (Other sites),0,0,0,1,0,1,0,0,0,0,0,0,1
KERALA,2002,By Jumping off Moving Vehicles/Trains,1,7,11,9,8,36,0,3,3,1,2,9,45
KERALA,2002,By Machine,0,0,0,0,0,0,0,0,0,0,0,0,0
KERALA,2002,By Overdose of sleeping pills,0,5,13,3,7,28,0,5,6,7,6,24,52
KERALA,2002,By touching electric wires,0,1,1,2,0,4,0,0,0,0,0,0,4
KERALA,2002,By coming under running vehicles/trains,0,49,95,66,43,253,0,11,19,12,4,46,299
KERALA,2002,By Other means,0,3,6,8,4,21,0,3,8,3,7,21,42
KERALA,2002,Total,54,1264,2196,2177,1474,7165,65,689,840,625,426,2645,9810
KERALA,2002,Total (Poison),23,428,879,881,612,2823,28,243,261,227,136,895,3718
KERALA,2002,Total (Jumping),0,4,3,5,0,12,0,0,1,0,0,1,13
KERALA,2003,By Over Alcoholism,0,3,12,16,8,39,0,0,0,0,0,0,39
KERALA,2003,By Drowning,10,60,91,86,94,341,6,55,61,44,90,256,597
KERALA,2003,By Fire/Self Immolation,2,25,38,42,7,114,9,106,93,42,68,318,432
KERALA,2003,By Fire-Arms,0,2,2,4,1,9,1,2,0,0,0,3,12
KERALA,2003,By Hanging,24,632,950,915,592,3113,19,345,248,207,145,964,4077
KERALA,2003,By Consuming Insecticides,4,242,432,502,359,1539,3,136,112,105,82,438,1977
KERALA,2003,By Consuming Other Poison,3,151,370,526,317,1367,8,84,94,100,91,377,1744
KERALA,2003,By Self Infliction of injury,0,3,3,2,2,10,0,2,1,0,1,4,14
KERALA,2003,By Jumping from (Building),0,2,4,4,1,11,0,0,1,1,0,2,13
KERALA,2003,By Jumping from (Other sites),0,0,1,3,1,5,0,1,3,2,1,7,12
KERALA,2003,By Jumping off Moving Vehicles/Trains,1,8,24,10,9,52,0,9,2,1,0,12,64
KERALA,2003,By Machine,0,0,2,1,0,3,0,0,0,0,0,0,3
KERALA,2003,By Overdose of sleeping pills,0,3,8,4,1,16,0,4,4,3,0,11,27
KERALA,2003,By touching electric wires,0,6,11,3,1,21,0,3,0,0,0,3,24
KERALA,2003,By coming under running vehicles/trains,1,41,46,46,29,163,2,11,8,12,6,39,202
KERALA,2003,By Other means (please specify),5,22,38,52,15,132,1,16,20,27,5,69,201
KERALA,2003,Total,50,1200,2032,2216,1437,6935,49,774,647,544,489,2503,9438
KERALA,2003,Total (Poison),7,396,805,1030,678,2916,11,222,207,205,174,819,3735
KERALA,2003,Total (Jumping),0,2,5,7,2,16,0,1,4,3,1,9,25
KERALA,2004,By Over Alcoholism,0,3,4,14,6,27,0,0,0,0,0,0,27
KERALA,2004,By Drowning,6,86,85,71,50,298,8,41,64,55,96,264,562
KERALA,2004,By Fire/Self Immolation,2,21,39,36,19,117,10,108,73,50,61,302,419
KERALA,2004,By Fire-Arms,0,1,1,0,0,2,0,0,0,0,0,0,2
KERALA,2004,By Hanging,25,615,1050,1008,594,3292,17,358,281,197,167,1020,4312
KERALA,2004,By Consuming Insecticides,6,168,408,472,246,1300,9,108,102,113,74,406,1706
KERALA,2004,By Consuming Other Poison,5,126,319,389,285,1124,6,85,98,91,66,346,1470
KERALA,2004,By Self Infliction of injury,0,0,5,4,3,12,0,0,1,1,1,3,15
KERALA,2004,By Jumping from (Building),0,1,0,2,0,3,0,1,0,0,0,1,4
KERALA,2004,By Jumping from (Other sites),0,2,5,4,0,11,0,0,3,0,1,4,15
KERALA,2004,By Jumping off Moving Vehicles/Trains,1,17,16,11,10,55,2,5,8,4,1,20,75
KERALA,2004,By Machine,0,0,0,0,0,0,0,0,0,1,0,1,1
KERALA,2004,By Overdose of sleeping pills,0,6,5,1,0,12,0,1,3,4,1,9,21
KERALA,2004,By touching electric wires,2,9,1,1,2,15,0,1,1,1,0,3,18
KERALA,2004,By coming under running vehicles/trains,0,37,86,54,30,207,0,9,10,10,5,34,241
KERALA,2004,By Other means (please specify),1,15,43,43,21,123,1,12,10,9,10,42,165
KERALA,2004,Total,48,1107,2067,2110,1266,6598,53,729,654,536,483,2455,9053
KERALA,2004,Total (Poison),11,294,732,865,534,2436,15,193,201,205,141,755,3191
KERALA,2004,Total (Jumping),0,3,5,6,0,14,0,1,3,0,1,5,19
KERALA,2005,By Over Alcoholism,0,1,12,5,2,20,0,0,0,0,0,0,20
KERALA,2005,By Drowning,7,61,94,75,90,327,5,51,70,73,71,270,597
KERALA,2005,By Fire/Self Immolation,3,20,42,29,16,110,5,95,98,89,49,336,446
KERALA,2005,By Fire-Arms,0,0,1,1,0,2,0,0,0,0,0,0,2
KERALA,2005,By Hanging,20,627,1054,1103,546,3350,22,308,251,195,135,911,4261
KERALA,2005,By Consuming Insecticides,7,220,438,562,289,1516,5,128,118,132,101,484,2000
KERALA,2005,By Consuming Other Poison,7,215,362,335,215,1134,7,80,71,77,99,334,1468
KERALA,2005,By Self Infliction of injury,0,8,5,9,2,24,0,0,3,2,0,5,29
KERALA,2005,By Jumping from (Building),0,5,4,2,0,11,0,7,0,0,0,7,18
KERALA,2005,By Jumping from (Other sites),0,1,1,2,0,4,0,1,0,0,0,1,5
KERALA,2005,By Jumping off Moving Vehicles/Trains,0,20,19,18,7,64,0,4,5,1,4,14,78
KERALA,2005,By Machine,0,0,0,0,0,0,0,0,0,0,0,0,0
KERALA,2005,By Overdose of sleeping pills,0,2,3,2,4,11,0,0,3,1,2,6,17
KERALA,2005,By touching electric wires,0,3,4,3,2,12,0,0,0,0,0,0,12
KERALA,2005,By coming under running vehicles/trains,1,43,35,44,18,141,4,6,8,2,2,22,163
KERALA,2005,By Other means (please specify),1,12,45,17,29,104,2,10,5,4,3,24,128
KERALA,2005,Total,46,1238,2119,2207,1220,6830,50,690,632,576,466,2414,9244
KERALA,2005,Total (Poison),14,443,805,906,506,2674,12,208,192,211,200,823,3497
KERALA,2005,Total (Jumping),0,6,5,4,0,15,0,8,0,0,0,8,23
KERALA,2006,By Over Alcoholism,0,0,13,7,2,22,0,0,0,0,0,0,22
KERALA,2006,By Drowning,13,57,84,98,60,312,7,50,48,45,80,230,542
KERALA,2006,By Fire/Self Immolation,0,16,32,32,23,103,7,119,76,53,52,307,410
KERALA,2006,By Fire-Arms,0,0,0,1,0,1,0,0,0,0,0,0,1
KERALA,2006,By Hanging,25,588,1075,1075,596,3359,25,332,300,264,147,1068,4427
KERALA,2006,By Consuming Insecticides,6,151,280,465,270,1172,11,95,109,121,73,409,1581
KERALA,2006,By Consuming Other Poison,6,198,373,421,260,1258,8,65,81,92,83,329,1587
KERALA,2006,By Self Infliction of injury,0,2,4,2,5,13,0,1,0,1,1,3,16
KERALA,2006,By Jumping from (Building),0,1,3,1,0,5,0,1,0,0,1,2,7
KERALA,2006,By Jumping from (Other sites),0,0,2,3,0,5,0,0,1,0,0,1,6
KERALA,2006,By Jumping off Moving Vehicles/Trains,0,12,24,16,5,57,0,1,0,3,1,5,62
KERALA,2006,By Machine,0,0,0,0,0,0,0,0,0,0,0,0,0
KERALA,2006,By Overdose of sleeping pills,0,1,10,8,3,22,0,5,10,5,5,25,47
KERALA,2006,By touching electric wires,0,4,2,1,1,8,0,0,0,0,0,0,8
KERALA,2006,By coming under running vehicles/trains,2,34,88,56,32,212,0,11,15,13,5,44,256
KERALA,2006,By Other means (please specify),2,2,1,13,16,34,2,2,0,5,11,20,54
KERALA,2006,Total,54,1066,1991,2199,1273,6583,60,682,640,602,459,2443,9026
KERALA,2006,Total (Poison),12,351,657,888,535,2443,19,161,190,214,157,741,3184
KERALA,2006,Total (Jumping),0,1,5,4,0,10,0,1,1,0,1,3,13
KERALA,2007,By Over Alcoholism,0,0,7,10,2,19,0,0,0,0,0,0,19
KERALA,2007,By Drowning,2,65,93,89,50,299,4,49,59,57,56,225,524
KERALA,2007,By Fire/Self Immolation,0,22,30,19,11,82,10,95,83,79,50,317,399
KERALA,2007,By Fire-Arms,0,0,0,0,1,1,0,0,0,0,0,0,1
KERALA,2007,By Hanging,34,612,1067,1159,490,3362,17,295,266,243,133,954,4316
KERALA,2007,By Consuming Insecticides,4,133,293,388,204,1022,3,59,111,108,52,333,1355
KERALA,2007,By Consuming Other Poison,7,188,426,509,285,1415,9,86,118,119,88,420,1835
KERALA,2007,By Self Infliction of injury,0,3,5,1,2,11,0,1,4,1,0,6,17
KERALA,2007,By Jumping from (Building),0,10,5,4,2,21,0,3,2,1,0,6,27
KERALA,2007,By Jumping from (Other sites),0,2,3,2,0,7,0,0,2,0,0,2,9
KERALA,2007,By Jumping off Moving Vehicles/Trains,0,7,6,2,1,16,0,0,2,4,0,6,22
KERALA,2007,By Machine,0,0,1,1,0,2,0,0,1,2,0,3,5
KERALA,2007,By Overdose of sleeping pills,0,3,5,8,2,18,0,5,10,8,5,28,46
KERALA,2007,By touching electric wires,0,4,2,0,1,7,0,0,0,0,0,0,7
KERALA,2007,By coming under running vehicles/trains,0,39,110,65,42,256,0,14,17,14,4,49,305
KERALA,2007,By Other means (please specify),1,9,16,16,8,50,0,3,6,11,5,25,75
KERALA,2007,Total,48,1097,2069,2273,1101,6588,43,610,681,647,393,2374,8962
KERALA,2007,Total (Poison),11,324,724,898,491,2448,12,146,233,228,140,759,3207
KERALA,2007,Total (Jumping),0,12,8,6,2,28,0,3,4,1,0,8,36
KERALA,2008,By Over Alcoholism,0,0,3,6,4,13,0,0,0,0,0,0,13
KERALA,2008,By Drowning,4,51,101,68,77,301,1,45,52,54,65,217,518
KERALA,2008,By Fire/Self Immolation,0,16,35,31,22,104,4,121,93,75,63,356,460
KERALA,2008,By Fire-Arms,0,0,0,0,0,0,0,0,0,0,0,0,0
KERALA,2008,By Hanging,18,622,1165,1004,478,3287,29,312,296,263,142,1042,4329
KERALA,2008,By Consuming Insecticides,0,119,295,438,220,1072,3,86,114,99,62,364,1436
KERALA,2008,By Consuming Other Poison,4,135,340,353,198,1030,4,78,98,115,59,354,1384
KERALA,2008,By Self Infliction of injury,0,2,3,3,5,13,0,2,2,0,1,5,18
KERALA,2008,By Jumping from (Building),0,8,3,8,3,22,0,1,2,1,2,6,28
KERALA,2008,By Jumping from (Other sites),0,2,1,0,0,3,0,1,0,0,0,1,4
KERALA,2008,By Jumping off Moving Vehicles/Trains,0,10,10,8,1,29,0,4,5,2,1,12,41
KERALA,2008,By Machine,0,1,5,2,1,9,0,0,1,0,0,1,10
KERALA,2008,By Overdose of sleeping pills,0,10,9,5,5,29,0,4,11,6,4,25,54
KERALA,2008,By touching electric wires,0,5,6,0,0,11,0,0,0,0,0,0,11
KERALA,2008,By coming under running vehicles/trains,0,34,71,74,17,196,1,12,16,20,3,52,248
KERALA,2008,By Other means (please specify),0,1,1,1,8,11,0,0,2,2,0,4,15
KERALA,2008,Total,26,1016,2048,2001,1039,6130,42,666,692,637,402,2439,8569
KERALA,2008,Total (Poison),4,256,638,794,423,2115,7,166,214,214,122,723,2838
KERALA,2008,Total (Jumping),0,10,4,8,3,25,0,2,2,1,2,7,32
KERALA,2009,By Over Alcoholism,0,3,10,7,9,29,0,4,3,4,4,15,44
KERALA,2009,By Drowning,1,54,94,60,70,279,1,46,59,76,82,264,543
KERALA,2009,By Fire/Self Immolation,1,23,37,38,28,127,7,116,84,96,72,375,502
KERALA,2009,By Fire-Arms,0,1,1,0,0,2,0,0,0,0,0,0,2
KERALA,2009,By Hanging,28,754,1023,1060,559,3424,14,326,263,220,155,978,4402
KERALA,2009,By Consuming Insecticides,4,122,357,440,180,1103,3,69,86,100,48,306,1409
KERALA,2009,By Consuming Other Poison,1,169,341,365,186,1062,5,107,80,94,76,362,1424
KERALA,2009,By Self Infliction of injury,0,3,2,4,3,12,0,3,0,1,0,4,16
KERALA,2009,By Jumping from (Building),1,5,9,6,3,24,0,3,3,3,0,9,33
KERALA,2009,By Jumping from (Other sites),0,0,1,1,0,2,0,0,1,1,0,2,4
KERALA,2009,By Jumping off Moving Vehicles/Trains,0,10,20,6,2,38,0,4,2,1,0,7,45
KERALA,2009,By Machine,0,0,0,0,0,0,0,0,0,0,0,0,0
KERALA,2009,By Overdose of sleeping pills,0,7,10,7,0,24,0,2,6,7,1,16,40
KERALA,2009,By touching electric wires,0,0,4,0,0,4,0,2,0,1,0,3,7
KERALA,2009,By coming under running vehicles/trains,2,37,67,41,26,173,0,22,24,23,7,76,249
KERALA,2009,By Other means (please specify),0,3,3,7,6,19,0,1,5,6,4,16,35
KERALA,2009,Total,38,1191,1979,2042,1072,6322,30,705,616,633,449,2433,8755
KERALA,2009,Total (Poison),5,294,700,809,369,2177,8,179,166,195,124,672,2849
KERALA,2009,Total (Jumping),1,5,10,7,3,26,0,3,4,4,0,11,37
KERALA,2010,By Over Alcoholism,0,0,5,11,4,20,0,0,0,0,0,0,20
KERALA,2010,By Drowning,6,51,96,98,78,329,2,56,65,69,89,281,610
KERALA,2010,By Fire/Self Immolation,1,20,47,39,23,130,3,107,87,58,70,325,455
KERALA,2010,By Fire-Arms,0,1,1,1,0,3,0,0,2,0,0,2,5
KERALA,2010,By Hanging,35,632,1130,1066,487,3350,27,288,266,216,148,945,4295
KERALA,2010,By Consuming Insecticides,4,106,273,442,217,1042,10,49,85,84,44,272,1314
KERALA,2010,By Consuming Other Poison,14,159,297,423,240,1133,4,77,89,90,55,315,1448
KERALA,2010,By Self Infliction of injury,0,2,4,1,0,7,0,0,2,0,1,3,10
KERALA,2010,By Jumping from (Building),0,9,12,15,2,38,0,5,3,2,0,10,48
KERALA,2010,By Jumping from (Other sites),0,5,7,6,2,20,0,1,0,0,1,2,22
KERALA,2010,By Jumping off Moving Vehicles/Trains,0,12,19,14,2,47,0,3,2,4,0,9,56
KERALA,2010,By Machine,0,0,0,0,0,0,0,0,0,0,0,0,0
KERALA,2010,By Overdose of sleeping pills,2,3,9,10,4,28,0,1,6,5,5,17,45
KERALA,2010,By touching electric wires,0,2,1,1,3,7,0,0,0,0,0,0,7
KERALA,2010,By coming under running vehicles/trains,1,37,69,41,33,181,0,19,17,16,3,55,236
KERALA,2010,By Other means (please specify),1,1,3,3,3,11,0,2,2,0,0,4,15
KERALA,2010,Total,64,1040,1973,2171,1098,6346,46,608,626,544,416,2240,8586
KERALA,2010,Total (Poison),18,267,574,866,457,2182,14,126,176,174,100,590,2772
KERALA,2010,Total (Jumping),0,14,19,21,4,58,0,6,3,2,1,12,70
KERALA,2011,By Over Alcoholism,0,1,15,15,7,38,0,0,0,0,0,0,38
KERALA,2011,By Drowning,1,44,89,104,59,297,1,41,64,64,63,233,530
KERALA,2011,By Fire/Self Immolation,3,15,42,37,18,115,7,86,90,71,57,311,426
KERALA,2011,By Fire-Arms,0,0,1,1,0,2,0,1,0,0,0,1,3
KERALA,2011,By Hanging,20,619,1222,1332,601,3794,19,314,318,233,161,1045,4839
KERALA,2011,By Consuming Insecticides,2,90,214,357,186,849,2,57,67,72,33,231,1080
KERALA,2011,By Consuming Other Poison,2,88,211,281,233,815,4,61,84,82,58,289,1104
KERALA,2011,By Self Infliction of injury,0,7,5,3,4,19,0,4,1,1,3,9,28
KERALA,2011,By Jumping from (Building),0,5,6,4,1,16,0,0,1,2,0,3,19
KERALA,2011,By Jumping from (Other sites),0,1,0,0,0,1,0,0,3,2,1,6,7
KERALA,2011,By Jumping off Moving Vehicles/Trains,0,8,14,11,4,37,2,1,2,2,2,9,46
KERALA,2011,By Machine,0,0,0,0,0,0,0,0,0,0,0,0,0
KERALA,2011,By Overdose of sleeping pills,0,2,11,7,4,24,0,6,3,2,3,14,38
KERALA,2011,By touching electric wires,0,0,2,0,0,2,0,0,0,1,0,1,3
KERALA,2011,By coming under running vehicles/trains,1,39,60,50,26,176,1,14,22,9,6,52,228
KERALA,2011,By Other means (please specify),0,8,8,7,4,27,0,3,5,4,3,15,42
KERALA,2011,Total,29,927,1900,2209,1147,6212,36,588,660,545,390,2219,8431
KERALA,2011,Total (Poison),4,185,430,641,423,1683,6,122,152,155,94,529,2212
KERALA,2011,Total (Jumping),0,6,6,4,1,17,0,0,4,4,1,9,26
KERALA,2012,By Over Alcoholism,0,0,15,38,20,73,0,0,0,0,0,0,73
KERALA,2012,By Drowning,0,40,67,76,56,239,1,41,49,54,46,191,430
KERALA,2012,By Fire/Self Immolation,1,13,25,19,17,75,4,65,45,56,56,226,301
KERALA,2012,By Fire-Arms,0,0,1,1,0,2,0,1,1,0,0,2,4
KERALA,2012,By Hanging,27,664,1482,1503,789,4465,21,364,285,297,197,1164,5629
KERALA,2012,By Consuming Insecticides,2,74,162,285,163,686,1,37,61,61,38,198,884
KERALA,2012,By Consuming Other Poison,1,75,142,223,153,594,2,41,68,71,46,228,822
KERALA,2012,By Self Infliction of injury,0,2,6,5,4,17,0,0,1,0,0,1,18
KERALA,2012,By Jumping from (Building),0,6,4,8,3,21,0,2,1,0,0,3,24
KERALA,2012,By Jumping from (Other sites),0,0,4,2,1,7,0,3,0,0,0,3,10
KERALA,2012,By Jumping off Moving Vehicles/Trains,0,4,4,8,3,19,0,2,1,1,3,7,26
KERALA,2012,By Machine,0,0,0,0,0,0,0,1,0,0,0,1,1
KERALA,2012,By Overdose of sleeping pills,0,3,9,7,2,21,0,2,5,4,2,13,34
KERALA,2012,By touching electric wires,0,1,2,3,1,7,0,0,0,0,0,0,7
KERALA,2012,By coming under running vehicles/trains,0,38,52,55,33,178,1,12,11,10,1,35,213
KERALA,2012,By Other means (please specify),0,1,1,2,1,5,0,3,2,2,2,9,14
KERALA,2012,Total,31,921,1976,2235,1246,6409,30,574,530,556,391,2081,8490
KERALA,2012,Total (Poison),3,151,310,513,320,1297,3,78,130,132,84,427,1724
KERALA,2012,Total (Jumping),0,6,8,10,4,28,0,5,1,0,0,6,34
MADHYA PRADESH,2001,By Over Alcoholism,0,12,11,8,3,34,0,1,1,0,0,2,36
MADHYA PRADESH,2001,By Drowning,25,62,32,34,15,168,20,86,44,22,16,188,356
MADHYA PRADESH,2001,By Fire/Self Immolation,9,126,71,22,12,240,15,486,191,46,13,751,991
MADHYA PRADESH,2001,By Fire-Arms,3,4,5,3,1,16,0,5,0,0,3,8,24
MADHYA PRADESH,2001,By Hanging,33,503,409,200,110,1255,15,478,194,92,44,823,2078
MADHYA PRADESH,2001,By Consuming Insecticides,16,410,310,147,64,947,29,445,232,87,38,831,1778
MADHYA PRADESH,2001,By Consuming Other Poison,10,126,103,50,33,322,21,228,95,28,18,390,712
MADHYA PRADESH,2001,By Self Infliction of injury,0,0,1,0,0,1,0,3,1,0,0,4,5
MADHYA PRADESH,2001,By Jumping from (Building),0,1,2,5,1,9,3,1,0,0,1,5,14
MADHYA PRADESH,2001,By Jumping from (Other sites),0,11,14,2,0,27,0,24,5,2,0,31,58
MADHYA PRADESH,2001,By Jumping off Moving Vehicles/Trains,1,9,10,2,10,32,0,6,1,13,0,20,52
MADHYA PRADESH,2001,By Machine,0,1,6,2,0,9,0,2,0,0,0,2,11
MADHYA PRADESH,2001,By Overdose of sleeping pills,0,2,4,4,0,10,0,2,0,0,0,2,12
MADHYA PRADESH,2001,By touching electric wires,2,12,19,15,2,50,0,4,4,1,0,9,59
MADHYA PRADESH,2001,By coming under running vehicles/trains,1,32,34,24,9,100,0,23,12,8,3,46,146
MADHYA PRADESH,2001,By Other means (please specify),30,106,98,52,30,316,12,124,32,19,25,212,528
MADHYA PRADESH,2001,Total,130,1417,1129,570,290,3536,115,1918,812,318,161,3324,6860
MADHYA PRADESH,2001,Total (Poison),26,536,414,197,97,1270,50,676,328,115,56,1225,2495
MADHYA PRADESH,2001,Total (Jumping),0,12,16,7,1,36,3,25,5,2,1,36,72
MADHYA PRADESH,2002,By Over Alcoholism,0,7,15,10,13,45,2,11,5,2,0,20,65
MADHYA PRADESH,2002,By Drowning,8,41,44,29,11,133,11,77,47,27,15,177,310
MADHYA PRADESH,2002,By Fire/Self Immolation,1,104,41,25,17,188,5,458,179,60,22,724,912
MADHYA PRADESH,2002,By Fire-Arms,0,5,4,2,0,11,0,6,2,1,0,9,20
MADHYA PRADESH,2002,By Hanging,35,512,406,253,87,1293,25,484,204,81,27,821,2114
MADHYA PRADESH,2002,By Consuming Insecticides,27,536,353,161,62,1139,27,562,274,119,42,1024,2163
MADHYA PRADESH,2002,By Consuming Other Poison,7,144,127,74,26,378,11,182,82,25,20,320,698
MADHYA PRADESH,2002,By Self Infliction of injury,0,0,0,6,5,11,0,2,6,2,0,10,21
MADHYA PRADESH,2002,By Jumping from (Building),0,2,7,3,0,12,1,2,2,0,0,5,17
MADHYA PRADESH,2002,By Jumping from (Other sites),0,16,17,1,0,34,0,10,11,6,7,34,68
MADHYA PRADESH,2002,By Jumping off Moving Vehicles/Trains,0,7,1,6,2,16,0,6,0,1,0,7,23
MADHYA PRADESH,2002,By Machine,0,0,2,1,0,3,0,0,1,0,0,1,4
MADHYA PRADESH,2002,By Overdose of sleeping pills,0,4,14,15,22,55,0,9,12,5,6,32,87
MADHYA PRADESH,2002,By touching electric wires,2,7,17,7,1,34,2,6,2,0,2,12,46
MADHYA PRADESH,2002,By coming under running vehicles/trains,1,39,41,26,9,116,1,11,13,5,4,34,150
MADHYA PRADESH,2002,By Other means,11,31,29,14,26,111,5,39,21,8,17,90,201
MADHYA PRADESH,2002,Total,92,1455,1118,633,281,3579,90,1865,861,342,162,3320,6899
MADHYA PRADESH,2002,Total (Poison),34,680,480,241,93,1528,38,746,362,146,62,1354,2882
MADHYA PRADESH,2002,Total (Jumping),0,18,24,4,0,46,1,12,13,6,7,39,85
MADHYA PRADESH,2003,By Over Alcoholism,0,11,32,6,1,50,0,0,0,0,0,0,50
MADHYA PRADESH,2003,By Drowning,22,44,49,32,14,161,10,73,56,23,13,175,336
MADHYA PRADESH,2003,By Fire/Self Immolation,5,138,57,16,16,232,11,503,143,46,27,730,962
MADHYA PRADESH,2003,By Fire-Arms,0,12,11,6,1,30,0,9,0,0,0,9,39
MADHYA PRADESH,2003,By Hanging,30,529,456,264,113,1392,22,548,217,89,26,902,2294
MADHYA PRADESH,2003,By Consuming Insecticides,22,444,402,149,64,1081,31,532,330,85,27,1005,2086
MADHYA PRADESH,2003,By Consuming Other Poison,4,89,105,26,14,238,7,158,67,21,7,260,498
MADHYA PRADESH,2003,By Self Infliction of injury,0,0,4,3,2,9,0,9,2,0,1,12,21
MADHYA PRADESH,2003,By Jumping from (Building),0,3,1,1,4,9,0,1,0,0,0,1,10
MADHYA PRADESH,2003,By Jumping from (Other sites),0,8,6,0,0,14,0,2,0,0,0,2,16
MADHYA PRADESH,2003,By Jumping off Moving Vehicles/Trains,0,13,14,3,0,30,0,1,4,0,1,6,36
MADHYA PRADESH,2003,By Machine,0,0,0,0,0,0,0,0,0,0,0,0,0
MADHYA PRADESH,2003,By Overdose of sleeping pills,0,4,7,4,1,16,0,2,2,1,0,5,21
MADHYA PRADESH,2003,By touching electric wires,5,19,16,11,3,54,0,4,10,1,1,16,70
MADHYA PRADESH,2003,By coming under running vehicles/trains,1,23,32,21,17,94,1,20,10,4,7,42,136
MADHYA PRADESH,2003,By Other means (please specify),5,42,22,24,35,128,7,17,19,1,15,59,187
MADHYA PRADESH,2003,Total,94,1379,1214,566,285,3538,89,1879,860,271,125,3224,6762
MADHYA PRADESH,2003,Total (Poison),26,533,511,178,80,1328,38,699,399,106,35,1277,2605
MADHYA PRADESH,2003,Total (Jumping),0,11,7,1,4,23,0,3,0,0,0,3,26
MADHYA PRADESH,2004,By Over Alcoholism,0,15,22,23,5,65,0,0,0,0,0,0,65
MADHYA PRADESH,2004,By Drowning,17,59,55,36,10,177,10,107,62,25,17,221,398
MADHYA PRADESH,2004,By Fire/Self Immolation,7,45,43,18,13,126,6,338,129,52,26,551,677
MADHYA PRADESH,2004,By Fire-Arms,0,3,10,5,4,22,0,1,1,0,0,2,24
MADHYA PRADESH,2004,By Hanging,34,568,547,266,133,1548,34,572,246,95,32,979,2527
MADHYA PRADESH,2004,By Consuming Insecticides,31,490,324,154,90,1089,43,528,260,98,43,972,2061
MADHYA PRADESH,2004,By Consuming Other Poison,4,84,41,23,18,170,6,106,52,22,19,205,375
MADHYA PRADESH,2004,By Self Infliction of injury,0,1,1,3,4,9,0,2,3,2,0,7,16
MADHYA PRADESH,2004,By Jumping from (Building),4,1,7,2,1,15,0,3,2,0,0,5,20
MADHYA PRADESH,2004,By Jumping from (Other sites),1,15,20,6,1,43,0,4,5,0,0,9,52
MADHYA PRADESH,2004,By Jumping off Moving Vehicles/Trains,0,17,6,0,1,24,1,0,4,0,0,5,29
MADHYA PRADESH,2004,By Machine,0,3,3,3,1,10,0,1,1,0,0,2,12
MADHYA PRADESH,2004,By Overdose of sleeping pills,1,13,6,5,7,32,0,7,5,5,1,18,50
MADHYA PRADESH,2004,By touching electric wires,4,19,13,5,1,42,2,6,8,3,0,19,61
MADHYA PRADESH,2004,By coming under running vehicles/trains,3,28,36,17,18,102,2,15,10,8,8,43,145
MADHYA PRADESH,2004,By Other means (please specify),3,47,68,29,13,160,6,63,31,11,12,123,283
MADHYA PRADESH,2004,Total,109,1408,1202,595,320,3634,110,1753,819,321,158,3161,6795
MADHYA PRADESH,2004,Total (Poison),35,575,366,180,112,1268,49,636,315,122,62,1184,2452
MADHYA PRADESH,2004,Total (Jumping),5,16,27,8,2,58,0,7,7,0,0,14,72
MADHYA PRADESH,2005,By Over Alcoholism,0,17,23,24,3,67,0,0,1,0,0,1,68
MADHYA PRADESH,2005,By Drowning,17,64,46,13,15,155,29,136,76,21,10,272,427
MADHYA PRADESH,2005,By Fire/Self Immolation,6,29,23,8,1,67,4,301,124,26,11,466,533
MADHYA PRADESH,2005,By Fire-Arms,0,10,5,5,6,26,0,2,1,0,0,3,29
MADHYA PRADESH,2005,By Hanging,24,513,472,234,103,1346,18,508,203,83,34,846,2192
MADHYA PRADESH,2005,By Consuming Insecticides,17,294,202,93,46,652,16,400,190,55,20,681,1333
MADHYA PRADESH,2005,By Consuming Other Poison,12,107,72,35,25,251,3,91,56,17,10,177,428
MADHYA PRADESH,2005,By Self Infliction of injury,0,2,0,0,0,2,0,0,1,0,0,1,3
MADHYA PRADESH,2005,By Jumping from (Building),0,6,7,6,0,19,1,4,2,0,2,9,28
MADHYA PRADESH,2005,By Jumping from (Other sites),0,4,3,2,1,10,0,4,5,0,0,9,19
MADHYA PRADESH,2005,By Jumping off Moving Vehicles/Trains,0,7,5,9,1,22,0,1,1,0,0,2,24
MADHYA PRADESH,2005,By Machine,0,2,1,4,0,7,0,0,0,0,0,0,7
MADHYA PRADESH,2005,By Overdose of sleeping pills,0,2,5,1,4,12,0,1,2,3,1,7,19
MADHYA PRADESH,2005,By touching electric wires,0,9,19,9,1,38,3,10,5,2,0,20,58
MADHYA PRADESH,2005,By coming under running vehicles/trains,1,21,32,10,9,73,0,22,8,1,1,32,105
MADHYA PRADESH,2005,By Other means (please specify),6,37,34,19,8,104,4,47,9,4,7,71,175
MADHYA PRADESH,2005,Total,83,1124,949,472,223,2851,78,1527,684,212,96,2597,5448
MADHYA PRADESH,2005,Total (Poison),29,403,274,128,71,905,19,491,247,72,30,859,1764
MADHYA PRADESH,2005,Total (Jumping),0,10,10,8,1,29,1,8,7,0,2,18,47
MADHYA PRADESH,2006,By Over Alcoholism,4,7,24,10,6,51,0,2,0,0,0,2,53
MADHYA PRADESH,2006,By Drowning,12,72,101,44,26,255,17,118,75,30,8,248,503
MADHYA PRADESH,2006,By Fire/Self Immolation,2,54,67,21,9,153,3,302,156,32,9,502,655
MADHYA PRADESH,2006,By Fire-Arms,0,9,12,5,0,26,0,2,1,0,0,3,29
MADHYA PRADESH,2006,By Hanging,42,502,525,274,119,1462,17,529,247,72,31,896,2358
MADHYA PRADESH,2006,By Consuming Insecticides,17,257,194,145,72,685,21,316,182,70,33,622,1307
MADHYA PRADESH,2006,By Consuming Other Poison,0,111,114,61,18,304,5,138,71,36,6,256,560
MADHYA PRADESH,2006,By Self Infliction of injury,0,1,0,2,1,4,0,2,4,0,0,6,10
MADHYA PRADESH,2006,By Jumping from (Building),0,7,3,1,1,12,0,4,4,1,0,9,21
MADHYA PRADESH,2006,By Jumping from (Other sites),2,1,9,1,1,14,0,4,1,3,2,10,24
MADHYA PRADESH,2006,By Jumping off Moving Vehicles/Trains,2,15,19,17,8,61,1,9,19,10,3,42,103
MADHYA PRADESH,2006,By Machine,0,1,1,0,0,2,0,0,0,0,1,1,3
MADHYA PRADESH,2006,By Overdose of sleeping pills,1,8,12,12,6,39,1,16,6,3,0,26,65
MADHYA PRADESH,2006,By touching electric wires,0,18,12,1,1,32,0,9,9,1,0,19,51
MADHYA PRADESH,2006,By coming under running vehicles/trains,5,34,53,40,9,141,2,13,14,4,0,33,174
MADHYA PRADESH,2006,By Other means (please specify),9,70,81,80,22,262,16,95,101,23,22,257,519
MADHYA PRADESH,2006,Total,96,1167,1227,714,299,3503,83,1559,890,285,115,2932,6435
MADHYA PRADESH,2006,Total (Poison),17,369,308,208,91,993,26,456,257,106,39,884,1877
MADHYA PRADESH,2006,Total (Jumping),2,8,12,2,2,26,0,8,5,4,2,19,45
MADHYA PRADESH,2007,By Over Alcoholism,0,9,20,27,1,57,0,43,9,8,3,63,120
MADHYA PRADESH,2007,By Drowning,9,57,61,23,11,161,19,93,50,16,5,183,344
MADHYA PRADESH,2007,By Fire/Self Immolation,4,39,41,26,6,116,7,383,144,18,13,565,681
MADHYA PRADESH,2007,By Fire-Arms,1,17,11,7,1,37,0,1,1,0,0,2,39
MADHYA PRADESH,2007,By Hanging,31,578,507,283,126,1525,35,487,252,83,40,897,2422
MADHYA PRADESH,2007,By Consuming Insecticides,11,284,235,126,50,706,19,412,165,61,34,691,1397
MADHYA PRADESH,2007,By Consuming Other Poison,4,87,52,48,9,200,2,81,21,14,11,129,329
MADHYA PRADESH,2007,By Self Infliction of injury,0,2,3,9,1,15,0,1,0,2,0,3,18
MADHYA PRADESH,2007,By Jumping from (Building),0,9,15,4,2,30,3,16,0,1,0,20,50
MADHYA PRADESH,2007,By Jumping from (Other sites),0,2,2,2,0,6,0,6,1,0,0,7,13
MADHYA PRADESH,2007,By Jumping off Moving Vehicles/Trains,0,13,25,7,5,50,0,12,14,4,2,32,82
MADHYA PRADESH,2007,By Machine,0,51,22,0,0,73,0,22,2,1,0,25,98
MADHYA PRADESH,2007,By Overdose of sleeping pills,2,11,31,15,7,66,0,49,12,2,2,65,131
MADHYA PRADESH,2007,By touching electric wires,14,20,8,3,2,47,0,3,2,2,1,8,55
MADHYA PRADESH,2007,By coming under running vehicles/trains,1,47,43,33,7,131,0,17,5,0,3,25,156
MADHYA PRADESH,2007,By Other means (please specify),16,87,50,63,34,250,27,47,48,17,5,144,394
MADHYA PRADESH,2007,Total,93,1313,1126,676,262,3470,112,1673,726,229,119,2859,6329
MADHYA PRADESH,2007,Total (Poison),15,373,290,183,60,921,21,494,186,77,45,823,1744
MADHYA PRADESH,2007,Total (Jumping),0,11,17,6,2,36,3,22,1,1,0,27,63
MADHYA PRADESH,2008,By Over Alcoholism,0,47,46,51,4,148,0,0,1,0,0,1,149
MADHYA PRADESH,2008,By Drowning,13,72,88,39,35,247,13,116,75,24,13,241,488
MADHYA PRADESH,2008,By Fire/Self Immolation,2,111,80,55,8,256,4,412,241,50,13,720,976
MADHYA PRADESH,2008,By Fire-Arms,0,9,9,8,0,26,0,0,0,1,0,1,27
MADHYA PRADESH,2008,By Hanging,30,647,614,345,141,1777,25,564,223,95,25,932,2709
MADHYA PRADESH,2008,By Consuming Insecticides,11,445,319,159,81,1015,23,483,232,95,24,857,1872
MADHYA PRADESH,2008,By Consuming Other Poison,7,121,148,61,80,417,7,150,81,19,5,262,679
MADHYA PRADESH,2008,By Self Infliction of injury,0,0,3,2,5,10,0,0,0,0,0,0,10
MADHYA PRADESH,2008,By Jumping from (Building),0,4,2,1,1,8,0,3,16,0,0,19,27
MADHYA PRADESH,2008,By Jumping from (Other sites),0,0,13,0,3,16,0,0,1,0,1,2,18
MADHYA PRADESH,2008,By Jumping off Moving Vehicles/Trains,2,31,21,9,5,68,0,19,19,0,2,40,108
MADHYA PRADESH,2008,By Machine,0,2,0,2,0,4,0,0,0,1,0,1,5
MADHYA PRADESH,2008,By Overdose of sleeping pills,3,5,28,6,5,47,0,9,2,6,11,28,75
MADHYA PRADESH,2008,By touching electric wires,3,16,8,6,3,36,0,2,2,0,0,4,40
MADHYA PRADESH,2008,By coming under running vehicles/trains,0,24,46,32,4,106,2,20,27,5,3,57,163
MADHYA PRADESH,2008,By Other means (please specify),4,58,76,39,7,184,6,55,25,9,4,99,283
MADHYA PRADESH,2008,Total,75,1592,1501,815,382,4365,80,1833,945,305,101,3264,7629
MADHYA PRADESH,2008,Total (Poison),18,566,470,222,166,1442,30,633,313,114,29,1119,2561
MADHYA PRADESH,2008,Total (Jumping),0,4,15,1,4,24,0,3,17,0,1,21,45
MADHYA PRADESH,2009,By Over Alcoholism,0,14,60,47,8,129,0,0,5,1,0,6,135
MADHYA PRADESH,2009,By Drowning,40,140,114,49,25,368,19,134,75,29,9,266,634
MADHYA PRADESH,2009,By Fire/Self Immolation,6,82,95,43,31,257,13,532,282,56,16,899,1156
MADHYA PRADESH,2009,By Fire-Arms,1,12,20,10,7,50,1,3,3,0,0,7,57
MADHYA PRADESH,2009,By Hanging,44,631,515,325,103,1618,66,626,300,79,23,1094,2712
MADHYA PRADESH,2009,By Consuming Insecticides,18,456,336,250,60,1120,55,543,213,74,26,911,2031
MADHYA PRADESH,2009,By Consuming Other Poison,12,133,106,39,14,304,11,106,66,19,9,211,515
MADHYA PRADESH,2009,By Self Infliction of injury,0,0,0,1,1,2,0,0,0,0,0,0,2
MADHYA PRADESH,2009,By Jumping from (Building),3,1,6,2,1,13,2,3,18,0,0,23,36
MADHYA PRADESH,2009,By Jumping from (Other sites),1,7,14,1,3,26,0,3,5,0,0,8,34
MADHYA PRADESH,2009,By Jumping off Moving Vehicles/Trains,0,20,10,1,4,35,1,2,19,1,0,23,58
MADHYA PRADESH,2009,By Machine,0,0,0,0,0,0,0,0,0,0,0,0,0
MADHYA PRADESH,2009,By Overdose of sleeping pills,0,11,9,8,1,29,0,8,7,4,1,20,49
MADHYA PRADESH,2009,By touching electric wires,7,23,11,19,2,62,2,5,2,6,3,18,80
MADHYA PRADESH,2009,By coming under running vehicles/trains,2,26,32,26,11,97,2,19,11,12,12,56,153
MADHYA PRADESH,2009,By Other means (please specify),132,202,256,267,133,990,70,112,136,95,58,471,1461
MADHYA PRADESH,2009,Total,266,1758,1584,1088,404,5100,242,2096,1142,376,157,4013,9113
MADHYA PRADESH,2009,Total (Poison),30,589,442,290,75,1426,66,649,279,93,35,1122,2548
MADHYA PRADESH,2009,Total (Jumping),4,8,20,3,4,39,2,6,23,0,0,31,70
MADHYA PRADESH,2010,By Over Alcoholism,0,32,56,44,8,140,0,0,0,1,2,3,143
MADHYA PRADESH,2010,By Drowning,47,87,66,51,20,271,23,135,65,31,14,268,539
MADHYA PRADESH,2010,By Fire/Self Immolation,9,83,64,33,18,207,8,524,226,54,29,841,1048
MADHYA PRADESH,2010,By Fire-Arms,0,13,16,5,6,40,5,16,12,1,0,34,74
MADHYA PRADESH,2010,By Hanging,58,710,649,401,157,1975,32,598,312,90,42,1074,3049
MADHYA PRADESH,2010,By Consuming Insecticides,21,475,415,193,62,1166,43,468,288,99,41,939,2105
MADHYA PRADESH,2010,By Consuming Other Poison,18,147,130,69,33,397,17,166,67,52,10,312,709
MADHYA PRADESH,2010,By Self Infliction of injury,0,3,10,3,0,16,0,0,2,0,0,2,18
MADHYA PRADESH,2010,By Jumping from (Building),2,3,4,3,3,15,0,4,2,0,0,6,21
MADHYA PRADESH,2010,By Jumping from (Other sites),0,12,9,5,2,28,0,3,0,2,0,5,33
MADHYA PRADESH,2010,By Jumping off Moving Vehicles/Trains,0,28,27,11,12,78,0,6,3,0,0,9,87
MADHYA PRADESH,2010,By Machine,0,0,3,2,1,6,0,0,0,0,0,0,6
MADHYA PRADESH,2010,By Overdose of sleeping pills,0,6,6,5,1,18,0,1,3,2,0,6,24
MADHYA PRADESH,2010,By touching electric wires,2,17,28,21,9,77,0,4,2,3,0,9,86
MADHYA PRADESH,2010,By coming under running vehicles/trains,2,25,39,26,10,102,1,16,15,22,13,67,169
MADHYA PRADESH,2010,By Other means (please specify),56,149,146,118,82,551,32,134,108,35,32,341,892
MADHYA PRADESH,2010,Total,215,1790,1668,990,424,5087,161,2075,1105,392,183,3916,9003
MADHYA PRADESH,2010,Total (Poison),39,625,555,265,95,1579,60,634,357,151,51,1253,2832
MADHYA PRADESH,2010,Total (Jumping),2,15,13,8,5,43,0,7,2,2,0,11,54
MADHYA PRADESH,2011,By Over Alcoholism,0,29,49,22,20,120,0,2,6,2,0,10,130
MADHYA PRADESH,2011,By Drowning,14,98,78,61,20,271,20,110,99,26,17,272,543
MADHYA PRADESH,2011,By Fire/Self Immolation,13,169,115,59,15,371,18,533,273,80,40,944,1315
MADHYA PRADESH,2011,By Fire-Arms,0,12,13,4,5,34,0,3,3,0,0,6,40
MADHYA PRADESH,2011,By Hanging,66,811,756,382,172,2187,48,611,347,119,53,1178,3365
MADHYA PRADESH,2011,By Consuming Insecticides,27,476,391,183,79,1156,31,476,259,103,37,906,2062
MADHYA PRADESH,2011,By Consuming Other Poison,20,217,184,84,37,542,13,239,112,33,17,414,956
MADHYA PRADESH,2011,By Self Infliction of injury,2,9,7,1,2,21,0,4,4,0,1,9,30
MADHYA PRADESH,2011,By Jumping from (Building),0,3,6,3,4,16,2,7,2,0,0,11,27
MADHYA PRADESH,2011,By Jumping from (Other sites),0,2,2,1,0,5,1,0,0,0,0,1,6
MADHYA PRADESH,2011,By Jumping off Moving Vehicles/Trains,0,18,8,9,2,37,0,2,2,3,2,9,46
MADHYA PRADESH,2011,By Machine,0,2,6,1,1,10,0,0,1,0,0,1,11
MADHYA PRADESH,2011,By Overdose of sleeping pills,0,1,4,9,4,18,0,0,2,2,1,5,23
MADHYA PRADESH,2011,By touching electric wires,1,23,19,9,18,70,2,5,4,5,2,18,88
MADHYA PRADESH,2011,By coming under running vehicles/trains,2,43,28,29,14,116,0,14,22,9,10,55,171
MADHYA PRADESH,2011,By Other means (please specify),11,64,93,59,39,266,28,50,51,47,4,180,446
MADHYA PRADESH,2011,Total,156,1977,1759,916,432,5240,163,2056,1187,429,184,4019,9259
MADHYA PRADESH,2011,Total (Poison),49,702,582,268,118,1719,44,719,375,136,55,1329,3048
MADHYA PRADESH,2011,Total (Jumping),0,5,8,4,4,21,3,7,2,0,0,12,33
MADHYA PRADESH,2012,By Over Alcoholism,0,17,52,36,20,125,0,0,0,0,0,0,125
MADHYA PRADESH,2012,By Drowning,38,125,136,56,36,391,25,148,92,43,24,332,723
MADHYA PRADESH,2012,By Fire/Self Immolation,9,99,144,54,23,329,13,450,281,93,37,874,1203
MADHYA PRADESH,2012,By Fire-Arms,0,21,13,10,5,49,0,6,3,2,0,11,60
MADHYA PRADESH,2012,By Hanging,45,927,887,471,179,2509,34,664,337,121,37,1193,3702
MADHYA PRADESH,2012,By Consuming Insecticides,19,435,350,191,88,1083,27,460,238,99,50,874,1957
MADHYA PRADESH,2012,By Consuming Other Poison,10,189,185,112,52,548,17,215,105,42,24,403,951
MADHYA PRADESH,2012,By Self Infliction of injury,0,3,4,6,2,15,1,4,2,0,0,7,22
MADHYA PRADESH,2012,By Jumping from (Building),1,7,9,2,4,23,1,3,2,1,0,7,30
MADHYA PRADESH,2012,By Jumping from (Other sites),0,8,8,5,3,24,0,2,2,0,0,4,28
MADHYA PRADESH,2012,By Jumping off Moving Vehicles/Trains,0,3,9,4,3,19,0,1,2,1,2,6,25
MADHYA PRADESH,2012,By Machine,0,1,0,0,1,2,0,0,1,0,0,1,3
MADHYA PRADESH,2012,By Overdose of sleeping pills,1,4,6,7,4,22,0,5,8,7,0,20,42
MADHYA PRADESH,2012,By touching electric wires,7,37,32,27,8,111,1,5,7,4,3,20,131
MADHYA PRADESH,2012,By coming under running vehicles/trains,2,42,36,31,9,120,2,20,14,12,8,56,176
MADHYA PRADESH,2012,By Other means (please specify),12,78,117,136,61,404,13,77,20,61,22,193,597
MADHYA PRADESH,2012,Total,144,1996,1988,1148,498,5774,134,2060,1114,486,207,4001,9775
MADHYA PRADESH,2012,Total (Poison),29,627,539,309,142,1646,45,679,345,141,74,1284,2930
MADHYA PRADESH,2012,Total (Jumping),1,15,17,7,7,47,1,5,4,1,0,11,58
MAHARASHTRA,2001,By Over Alcoholism,0,49,125,96,46,316,0,6,5,18,1,30,346
MAHARASHTRA,2001,By Drowning,21,342,497,209,113,1182,22,387,244,81,66,800,1982
MAHARASHTRA,2001,By Fire/Self Immolation,11,213,329,155,57,765,21,752,450,131,61,1415,2180
MAHARASHTRA,2001,By Fire-Arms,0,6,4,9,2,21,0,5,0,0,0,5,26
MAHARASHTRA,2001,By Hanging,35,818,1047,565,198,2663,23,423,249,88,31,814,3477
MAHARASHTRA,2001,By Consuming Insecticides,43,935,1145,629,245,2997,48,772,457,212,82,1571,4568
MAHARASHTRA,2001,By Consuming Other Poison,6,273,301,168,68,816,17,228,149,59,26,479,1295
MAHARASHTRA,2001,By Self Infliction of injury,8,8,25,30,24,95,0,0,1,0,0,1,96
MAHARASHTRA,2001,By Jumping from (Building),0,35,26,7,5,73,1,11,9,6,4,31,104
MAHARASHTRA,2001,By Jumping from (Other sites),0,13,10,3,3,29,0,5,5,1,1,12,41
MAHARASHTRA,2001,By Jumping off Moving Vehicles/Trains,0,15,17,8,3,43,0,2,3,1,2,8,51
MAHARASHTRA,2001,By Machine,0,2,2,0,0,4,0,1,0,0,1,2,6
MAHARASHTRA,2001,By Overdose of sleeping pills,1,12,15,11,4,43,1,9,10,8,6,34,77
MAHARASHTRA,2001,By touching electric wires,1,17,18,5,5,46,0,4,4,2,1,11,57
MAHARASHTRA,2001,By coming under running vehicles/trains,2,66,107,43,24,242,0,28,21,10,8,67,309
MAHARASHTRA,2001,By Other means (please specify),0,1,2,0,0,3,0,0,0,0,0,0,3
MAHARASHTRA,2001,Total,128,2805,3670,1938,797,9338,133,2633,1607,617,290,5280,14618
MAHARASHTRA,2001,Total (Poison),57,1216,1471,827,337,3908,65,1000,607,271,108,2051,5959
MAHARASHTRA,2001,Total (Jumping),0,48,36,10,8,102,1,16,14,7,5,43,145
MAHARASHTRA,2002,By Over Alcoholism,0,36,112,79,32,259,0,1,11,9,10,31,290
MAHARASHTRA,2002,By Drowning,20,288,353,189,127,977,7,377,219,110,72,785,1762
MAHARASHTRA,2002,By Fire/Self Immolation,6,210,317,137,96,766,24,747,423,141,70,1405,2171
MAHARASHTRA,2002,By Fire-Arms,0,8,6,5,1,20,0,0,0,0,0,0,20
MAHARASHTRA,2002,By Hanging,27,825,1151,603,311,2917,23,479,239,74,40,855,3772
MAHARASHTRA,2002,By Consuming Insecticides,38,1029,1187,559,260,3073,35,722,427,136,92,1412,4485
MAHARASHTRA,2002,By Consuming Other Poison,9,315,367,179,92,962,19,256,133,50,12,470,1432
MAHARASHTRA,2002,By Self Infliction of injury,0,3,6,3,3,15,0,2,0,2,0,4,19
MAHARASHTRA,2002,By Jumping from (Building),0,24,50,27,8,109,1,27,11,8,2,49,158
MAHARASHTRA,2002,By Jumping from (Other sites),0,9,11,5,1,26,0,2,1,0,0,3,29
MAHARASHTRA,2002,By Jumping off Moving Vehicles/Trains,0,17,31,18,2,68,0,8,2,1,1,12,80
MAHARASHTRA,2002,By Machine,0,1,2,1,0,4,0,1,0,0,0,1,5
MAHARASHTRA,2002,By Overdose of sleeping pills,1,3,4,1,2,11,0,1,0,1,1,3,14
MAHARASHTRA,2002,By touching electric wires,1,11,6,9,11,38,0,2,1,1,0,4,42
MAHARASHTRA,2002,By coming under running vehicles/trains,0,64,66,51,19,200,1,20,16,5,6,48,248
MAHARASHTRA,2002,By Other means,0,1,1,0,0,2,0,0,0,0,0,0,2
MAHARASHTRA,2002,Total,102,2844,3670,1866,965,9447,110,2645,1483,538,306,5082,14529
MAHARASHTRA,2002,Total (Poison),47,1347,1560,741,355,4050,54,980,560,188,104,1886,5936
MAHARASHTRA,2002,Total (Jumping),0,33,61,32,9,135,1,29,12,8,2,52,187
MAHARASHTRA,2003,By Over Alcoholism,0,37,107,63,16,223,0,12,0,2,3,17,240
MAHARASHTRA,2003,By Drowning,7,305,371,175,92,950,11,329,223,87,72,722,1672
MAHARASHTRA,2003,By Fire/Self Immolation,10,205,299,159,59,732,16,657,422,135,49,1279,2011
MAHARASHTRA,2003,By Fire-Arms,0,1,6,3,0,10,0,0,0,0,0,0,10
MAHARASHTRA,2003,By Hanging,32,1024,1189,722,267,3234,23,513,282,71,36,925,4159
MAHARASHTRA,2003,By Consuming Insecticides,42,1069,1171,692,259,3233,34,714,395,198,70,1411,4644
MAHARASHTRA,2003,By Consuming Other Poison,6,285,408,204,66,969,7,203,195,60,25,490,1459
MAHARASHTRA,2003,By Self Infliction of injury,0,2,8,1,1,12,0,0,0,0,0,0,12
MAHARASHTRA,2003,By Jumping from (Building),0,16,22,13,4,55,1,12,2,2,2,19,74
MAHARASHTRA,2003,By Jumping from (Other sites),0,9,5,8,6,28,0,7,5,1,1,14,42
MAHARASHTRA,2003,By Jumping off Moving Vehicles/Trains,0,10,25,18,0,53,0,4,3,0,0,7,60
MAHARASHTRA,2003,By Machine,0,0,0,0,0,0,0,0,0,0,0,0,0
MAHARASHTRA,2003,By Overdose of sleeping pills,0,7,24,1,1,33,0,11,7,0,0,18,51
MAHARASHTRA,2003,By touching electric wires,1,7,9,5,0,22,0,4,2,0,0,6,28
MAHARASHTRA,2003,By coming under running vehicles/trains,1,86,101,42,19,249,0,19,16,5,1,41,290
MAHARASHTRA,2003,By Other means (please specify),0,3,2,0,2,7,0,1,0,0,0,1,8
MAHARASHTRA,2003,Total,99,3066,3747,2106,792,9810,92,2486,1552,561,259,4950,14760
MAHARASHTRA,2003,Total (Poison),48,1356,1587,897,326,4214,41,917,590,258,95,1901,6115
MAHARASHTRA,2003,Total (Jumping),0,25,27,21,10,83,1,19,7,3,3,33,116
MAHARASHTRA,2004,By Over Alcoholism,0,23,100,86,18,227,0,0,2,4,0,6,233
MAHARASHTRA,2004,By Drowning,13,212,246,153,77,701,15,329,204,102,68,718,1419
MAHARASHTRA,2004,By Fire/Self Immolation,4,178,245,136,50,613,13,565,368,132,52,1130,1743
MAHARASHTRA,2004,By Fire-Arms,0,3,4,1,1,9,0,1,0,0,0,1,10
MAHARASHTRA,2004,By Hanging,38,1118,1382,770,298,3606,27,582,257,98,34,998,4604
MAHARASHTRA,2004,By Consuming Insecticides,27,1322,1494,809,333,3985,35,902,442,162,89,1630,5615
MAHARASHTRA,2004,By Consuming Other Poison,2,127,135,110,44,418,1,145,52,28,14,240,658
MAHARASHTRA,2004,By Self Infliction of injury,0,8,6,2,0,16,0,1,1,0,0,2,18
MAHARASHTRA,2004,By Jumping from (Building),0,17,25,11,12,65,0,15,9,1,3,28,93
MAHARASHTRA,2004,By Jumping from (Other sites),0,6,7,3,2,18,0,0,1,0,0,1,19
MAHARASHTRA,2004,By Jumping off Moving Vehicles/Trains,0,13,15,15,8,51,0,5,2,1,0,8,59
MAHARASHTRA,2004,By Machine,0,0,0,0,0,0,0,0,0,0,0,0,0
MAHARASHTRA,2004,By Overdose of sleeping pills,2,3,2,2,0,9,1,8,3,1,8,21,30
MAHARASHTRA,2004,By touching electric wires,0,2,9,6,0,17,0,4,2,3,0,9,26
MAHARASHTRA,2004,By coming under running vehicles/trains,1,48,68,34,17,168,1,16,10,3,2,32,200
MAHARASHTRA,2004,By Other means (please specify),0,0,0,0,0,0,0,0,0,1,1,2,2
MAHARASHTRA,2004,Total,87,3080,3738,2138,860,9903,93,2573,1353,536,271,4826,14729
MAHARASHTRA,2004,Total (Poison),29,1457,1635,921,377,4419,36,1048,495,190,103,1872,6291
MAHARASHTRA,2004,Total (Jumping),0,23,32,14,14,83,0,15,10,1,3,29,112
MAHARASHTRA,2005,By Over Alcoholism,0,24,47,37,13,121,0,0,0,1,0,1,122
MAHARASHTRA,2005,By Drowning,11,186,270,188,118,773,9,362,186,78,76,711,1484
MAHARASHTRA,2005,By Fire/Self Immolation,4,154,277,149,63,647,15,550,361,136,72,1134,1781
MAHARASHTRA,2005,By Fire-Arms,0,1,6,4,0,11,0,2,1,0,0,3,14
MAHARASHTRA,2005,By Hanging,32,1170,1451,832,338,3823,27,697,293,99,40,1156,4979
MAHARASHTRA,2005,By Consuming Insecticides,24,1049,1208,695,289,3265,24,829,380,205,70,1508,4773
MAHARASHTRA,2005,By Consuming Other Poison,1,178,231,101,52,563,2,126,54,18,15,215,778
MAHARASHTRA,2005,By Self Infliction of injury,0,5,5,5,1,16,0,0,0,0,0,0,16
MAHARASHTRA,2005,By Jumping from (Building),0,30,27,10,10,77,1,10,5,3,5,24,101
MAHARASHTRA,2005,By Jumping from (Other sites),0,6,13,8,2,29,0,2,2,0,1,5,34
MAHARASHTRA,2005,By Jumping off Moving Vehicles/Trains,0,8,9,6,8,31,0,2,4,0,0,6,37
MAHARASHTRA,2005,By Machine,0,0,2,0,0,2,0,0,0,0,0,0,2
MAHARASHTRA,2005,By Overdose of sleeping pills,0,3,5,2,1,11,0,2,2,1,2,7,18
MAHARASHTRA,2005,By touching electric wires,1,1,9,2,2,15,0,0,0,0,0,0,15
MAHARASHTRA,2005,By coming under running vehicles/trains,1,57,69,59,19,205,1,27,4,7,3,42,247
MAHARASHTRA,2005,By Other means (please specify),1,5,2,3,3,14,0,4,4,1,2,11,25
MAHARASHTRA,2005,Total,75,2877,3631,2101,919,9603,79,2613,1296,549,286,4823,14426
MAHARASHTRA,2005,Total (Poison),25,1232,1444,801,342,3844,26,955,434,223,85,1723,5567
MAHARASHTRA,2005,Total (Jumping),0,36,40,18,12,106,1,12,7,3,6,29,135
MAHARASHTRA,2006,By Over Alcoholism,0,21,81,47,13,162,0,1,1,4,1,7,169
MAHARASHTRA,2006,By Drowning,13,268,371,257,126,1035,17,398,215,100,103,833,1868
MAHARASHTRA,2006,By Fire/Self Immolation,7,185,350,149,61,752,15,647,379,120,62,1223,1975
MAHARASHTRA,2006,By Fire-Arms,0,3,3,3,1,10,0,0,0,0,0,0,10
MAHARASHTRA,2006,By Hanging,23,1205,1424,866,332,3850,28,721,311,118,60,1238,5088
MAHARASHTRA,2006,By Consuming Insecticides,19,1034,1310,713,336,3412,15,642,310,135,71,1173,4585
MAHARASHTRA,2006,By Consuming Other Poison,5,255,340,195,79,874,9,206,118,38,15,386,1260
MAHARASHTRA,2006,By Self Infliction of injury,0,2,7,8,0,17,0,4,3,0,0,7,24
MAHARASHTRA,2006,By Jumping from (Building),0,19,34,13,9,75,1,21,5,3,4,34,109
MAHARASHTRA,2006,By Jumping from (Other sites),0,3,9,6,1,19,0,3,2,0,0,5,24
MAHARASHTRA,2006,By Jumping off Moving Vehicles/Trains,0,5,15,3,3,26,0,6,0,1,1,8,34
MAHARASHTRA,2006,By Machine,0,0,0,0,0,0,0,0,0,0,0,0,0
MAHARASHTRA,2006,By Overdose of sleeping pills,0,4,5,0,1,10,0,3,3,1,1,8,18
MAHARASHTRA,2006,By touching electric wires,0,8,6,0,0,14,0,2,0,0,0,2,16
MAHARASHTRA,2006,By coming under running vehicles/trains,0,76,81,66,23,246,0,28,17,5,6,56,302
MAHARASHTRA,2006,By Other means (please specify),1,0,6,0,1,8,0,1,2,0,1,4,12
MAHARASHTRA,2006,Total,68,3088,4042,2326,986,10510,85,2683,1366,525,325,4984,15494
MAHARASHTRA,2006,Total (Poison),24,1291,1657,916,415,4303,24,852,431,173,86,1566,5869
MAHARASHTRA,2006,Total (Jumping),0,22,43,19,10,94,1,24,7,3,4,39,133
MAHARASHTRA,2007,By Over Alcoholism,0,33,68,42,15,158,0,0,1,0,0,1,159
MAHARASHTRA,2007,By Drowning,5,242,404,240,118,1009,17,394,204,97,82,794,1803
MAHARASHTRA,2007,By Fire/Self Immolation,3,229,273,186,53,744,18,570,365,106,79,1138,1882
MAHARASHTRA,2007,By Fire-Arms,0,3,9,2,1,15,0,0,0,0,0,0,15
MAHARASHTRA,2007,By Hanging,24,1272,1551,944,360,4151,21,723,276,110,36,1166,5317
MAHARASHTRA,2007,By Consuming Insecticides,8,959,1216,793,366,3342,17,711,342,165,71,1306,4648
MAHARASHTRA,2007,By Consuming Other Poison,2,191,254,145,76,668,1,166,59,28,17,271,939
MAHARASHTRA,2007,By Self Infliction of injury,0,5,13,3,4,25,0,2,0,1,1,4,29
MAHARASHTRA,2007,By Jumping from (Building),0,22,18,11,2,53,0,19,4,2,4,29,82
MAHARASHTRA,2007,By Jumping from (Other sites),0,6,12,5,1,24,0,2,4,2,0,8,32
MAHARASHTRA,2007,By Jumping off Moving Vehicles/Trains,0,6,7,5,0,18,0,1,0,0,1,2,20
MAHARASHTRA,2007,By Machine,0,0,0,0,0,0,0,0,0,0,0,0,0
MAHARASHTRA,2007,By Overdose of sleeping pills,0,3,4,2,3,12,0,5,0,0,0,5,17
MAHARASHTRA,2007,By touching electric wires,0,4,5,1,2,12,0,0,0,0,0,0,12
MAHARASHTRA,2007,By coming under running vehicles/trains,0,45,64,40,21,170,0,20,5,4,5,34,204
MAHARASHTRA,2007,By Other means (please specify),0,2,10,6,1,19,0,5,1,0,0,6,25
MAHARASHTRA,2007,Total,42,3022,3908,2425,1023,10420,74,2618,1261,515,296,4764,15184
MAHARASHTRA,2007,Total (Poison),10,1155,1483,941,446,4035,18,879,401,194,89,1581,5616
MAHARASHTRA,2007,Total (Jumping),0,28,30,16,3,77,0,21,8,4,4,37,114
MAHARASHTRA,2008,By Over Alcoholism,0,26,62,42,9,139,0,0,2,1,2,5,144
MAHARASHTRA,2008,By Drowning,5,173,312,160,106,756,14,295,195,88,63,655,1411
MAHARASHTRA,2008,By Fire/Self Immolation,9,189,264,166,65,693,10,590,286,108,79,1073,1766
MAHARASHTRA,2008,By Fire-Arms,0,1,3,1,0,5,0,1,0,0,0,1,6
MAHARASHTRA,2008,By Hanging,24,1323,1537,938,340,4162,31,758,321,94,55,1259,5421
MAHARASHTRA,2008,By Consuming Insecticides,9,1040,1228,744,253,3274,17,608,367,126,69,1187,4461
MAHARASHTRA,2008,By Consuming Other Poison,0,211,226,120,34,591,1,120,66,31,11,229,820
MAHARASHTRA,2008,By Self Infliction of injury,0,8,11,1,1,21,0,6,1,0,0,7,28
MAHARASHTRA,2008,By Jumping from (Building),0,11,12,20,8,51,1,7,6,4,6,24,75
MAHARASHTRA,2008,By Jumping from (Other sites),0,3,3,6,0,12,0,4,0,0,1,5,17
MAHARASHTRA,2008,By Jumping off Moving Vehicles/Trains,0,4,4,2,0,10,0,0,0,0,0,0,10
MAHARASHTRA,2008,By Machine,0,0,0,0,0,0,0,0,0,0,0,0,0
MAHARASHTRA,2008,By Overdose of sleeping pills,0,2,3,5,4,14,0,6,1,1,1,9,23
MAHARASHTRA,2008,By touching electric wires,0,3,3,3,0,9,0,1,0,0,0,1,10
MAHARASHTRA,2008,By coming under running vehicles/trains,0,40,57,38,14,149,0,14,6,5,2,27,176
MAHARASHTRA,2008,By Other means (please specify),0,2,0,1,0,3,0,2,0,0,1,3,6
MAHARASHTRA,2008,Total,47,3036,3725,2247,834,9889,74,2412,1251,458,290,4485,14374
MAHARASHTRA,2008,Total (Poison),9,1259,1465,865,288,3886,18,734,434,157,80,1423,5309
MAHARASHTRA,2008,Total (Jumping),0,14,15,26,8,63,1,11,6,4,7,29,92
MAHARASHTRA,2009,By Over Alcoholism,0,25,71,67,5,168,0,2,2,0,0,4,172
MAHARASHTRA,2009,By Drowning,0,153,232,141,95,621,8,258,210,95,65,636,1257
MAHARASHTRA,2009,By Fire/Self Immolation,1,188,284,167,63,703,13,548,334,117,77,1089,1792
MAHARASHTRA,2009,By Fire-Arms,0,3,3,3,2,11,0,0,0,0,0,0,11
MAHARASHTRA,2009,By Hanging,34,1286,1585,852,386,4143,19,729,307,108,45,1208,5351
MAHARASHTRA,2009,By Consuming Insecticides,11,1032,1262,794,330,3429,13,665,372,151,66,1267,4696
MAHARASHTRA,2009,By Consuming Other Poison,0,126,152,105,44,427,2,145,48,24,9,228,655
MAHARASHTRA,2009,By Self Infliction of injury,0,9,8,8,5,30,0,5,2,0,1,8,38
MAHARASHTRA,2009,By Jumping from (Building),0,19,18,13,12,62,0,15,7,6,4,32,94
MAHARASHTRA,2009,By Jumping from (Other sites),0,4,2,0,3,9,0,1,1,1,1,4,13
MAHARASHTRA,2009,By Jumping off Moving Vehicles/Trains,0,10,10,9,3,32,0,4,1,0,3,8,40
MAHARASHTRA,2009,By Machine,0,0,0,0,0,0,0,0,0,0,0,0,0
MAHARASHTRA,2009,By Overdose of sleeping pills,0,4,8,1,1,14,0,3,1,0,1,5,19
MAHARASHTRA,2009,By touching electric wires,0,0,0,0,0,0,0,0,0,0,0,0,0
MAHARASHTRA,2009,By coming under running vehicles/trains,2,38,49,30,11,130,0,10,7,1,4,22,152
MAHARASHTRA,2009,By Other means (please specify),0,4,2,0,0,6,0,2,2,0,0,4,10
MAHARASHTRA,2009,Total,48,2901,3686,2190,960,9785,55,2387,1294,503,276,4515,14300
MAHARASHTRA,2009,Total (Poison),11,1167,1422,907,379,3886,15,815,422,175,76,1503,5389
MAHARASHTRA,2009,Total (Jumping),0,23,20,13,15,71,0,16,8,7,5,36,107
MAHARASHTRA,2010,By Over Alcoholism,0,15,46,28,5,94,0,0,0,0,0,0,94
MAHARASHTRA,2010,By Drowning,1,206,246,169,107,729,6,325,196,90,74,691,1420
MAHARASHTRA,2010,By Fire/Self Immolation,1,203,286,131,67,688,17,552,313,90,76,1048,1736
MAHARASHTRA,2010,By Fire-Arms,0,5,4,8,4,21,0,0,0,0,0,0,21
MAHARASHTRA,2010,By Hanging,36,1542,1725,978,353,4634,44,972,373,117,48,1554,6188
MAHARASHTRA,2010,By Consuming Insecticides,9,1113,1260,805,334,3521,16,692,316,159,76,1259,4780
MAHARASHTRA,2010,By Consuming Other Poison,2,311,303,181,91,888,12,216,112,56,22,418,1306
MAHARASHTRA,2010,By Self Infliction of injury,0,12,9,6,2,29,0,6,5,1,1,13,42
MAHARASHTRA,2010,By Jumping from (Building),0,21,21,10,7,59,0,8,8,4,2,22,81
MAHARASHTRA,2010,By Jumping from (Other sites),0,2,4,3,0,9,0,2,1,0,0,3,12
MAHARASHTRA,2010,By Jumping off Moving Vehicles/Trains,0,15,12,6,1,34,0,5,0,0,0,5,39
MAHARASHTRA,2010,By Machine,0,0,0,0,0,0,0,0,0,0,0,0,0
MAHARASHTRA,2010,By Overdose of sleeping pills,0,0,3,0,0,3,0,5,2,0,1,8,11
MAHARASHTRA,2010,By touching electric wires,0,1,0,0,0,1,0,0,0,0,0,0,1
MAHARASHTRA,2010,By coming under running vehicles/trains,0,39,51,37,12,139,0,21,8,7,1,37,176
MAHARASHTRA,2010,By Other means (please specify),0,0,2,1,6,9,0,0,0,0,0,0,9
MAHARASHTRA,2010,Total,49,3485,3972,2363,989,10858,95,2804,1334,524,301,5058,15916
MAHARASHTRA,2010,Total (Poison),11,1436,1572,992,427,4438,28,914,433,216,99,1690,6128
MAHARASHTRA,2010,Total (Jumping),0,23,25,13,7,68,0,10,9,4,2,25,93
MAHARASHTRA,2011,By Over Alcoholism,0,31,52,38,12,133,0,1,0,0,0,1,134
MAHARASHTRA,2011,By Drowning,2,217,319,184,111,833,9,292,182,85,81,649,1482
MAHARASHTRA,2011,By Fire/Self Immolation,3,225,277,160,64,729,10,551,359,122,70,1112,1841
MAHARASHTRA,2011,By Fire-Arms,0,4,2,1,0,7,0,0,0,0,0,0,7
MAHARASHTRA,2011,By Hanging,25,1633,1679,964,393,4694,34,978,381,110,43,1546,6240
MAHARASHTRA,2011,By Consuming Insecticides,14,1016,1211,770,349,3360,20,662,332,141,71,1226,4586
MAHARASHTRA,2011,By Consuming Other Poison,2,267,326,189,98,882,6,196,149,67,22,440,1322
MAHARASHTRA,2011,By Self Infliction of injury,0,10,9,2,4,25,1,5,1,1,2,10,35
MAHARASHTRA,2011,By Jumping from (Building),0,15,14,10,9,48,0,8,9,5,2,24,72
MAHARASHTRA,2011,By Jumping from (Other sites),0,3,5,1,1,10,0,12,0,0,1,13,23
MAHARASHTRA,2011,By Jumping off Moving Vehicles/Trains,0,14,12,8,1,35,0,10,1,0,0,11,46
MAHARASHTRA,2011,By Machine,0,1,0,0,0,1,0,0,0,0,0,0,1
MAHARASHTRA,2011,By Overdose of sleeping pills,0,1,1,1,3,6,0,5,2,0,1,8,14
MAHARASHTRA,2011,By touching electric wires,0,1,1,0,0,2,0,1,0,0,0,1,3
MAHARASHTRA,2011,By coming under running vehicles/trains,0,37,49,20,10,116,0,6,6,2,3,17,133
MAHARASHTRA,2011,By Other means (please specify),0,2,3,1,0,6,0,1,0,1,0,2,8
MAHARASHTRA,2011,Total,46,3477,3960,2349,1055,10887,80,2728,1422,534,296,5060,15947
MAHARASHTRA,2011,Total (Poison),16,1293,1546,961,451,4267,27,863,482,209,95,1676,5943
MAHARASHTRA,2011,Total (Jumping),0,18,19,11,10,58,0,20,9,5,3,37,95
MAHARASHTRA,2012,By Over Alcoholism,0,49,81,77,18,225,0,1,0,1,1,3,228
MAHARASHTRA,2012,By Drowning,5,222,270,202,107,806,4,233,192,68,60,557,1363
MAHARASHTRA,2012,By Fire/Self Immolation,3,191,277,153,65,689,8,492,289,125,71,985,1674
MAHARASHTRA,2012,By Fire-Arms,0,0,1,4,0,5,0,0,0,1,1,2,7
MAHARASHTRA,2012,By Hanging,58,1900,1836,1165,424,5383,45,1030,410,126,61,1672,7055
MAHARASHTRA,2012,By Consuming Insecticides,5,817,1038,770,292,2922,19,528,242,141,80,1010,3932
MAHARASHTRA,2012,By Consuming Other Poison,1,204,339,218,109,871,4,181,153,92,23,453,1324
MAHARASHTRA,2012,By Self Infliction of injury,0,7,13,9,8,37,0,9,4,6,1,20,57
MAHARASHTRA,2012,By Jumping from (Building),0,27,27,14,6,74,2,25,6,7,7,47,121
MAHARASHTRA,2012,By Jumping from (Other sites),0,12,40,18,3,73,0,1,1,0,1,3,76
MAHARASHTRA,2012,By Jumping off Moving Vehicles/Trains,0,19,24,14,4,61,1,5,5,1,1,13,74
MAHARASHTRA,2012,By Machine,0,3,3,0,0,6,0,1,0,0,0,1,7
MAHARASHTRA,2012,By Overdose of sleeping pills,0,4,7,3,4,18,0,11,2,2,0,15,33
MAHARASHTRA,2012,By touching electric wires,0,2,0,1,0,3,0,0,0,0,0,0,3
MAHARASHTRA,2012,By coming under running vehicles/trains,0,33,39,26,15,113,0,7,6,2,0,15,128
MAHARASHTRA,2012,By Other means (please specify),1,6,3,5,3,18,0,7,3,2,0,12,30
MAHARASHTRA,2012,Total,73,3496,3998,2679,1058,11304,83,2531,1313,574,307,4808,16112
MAHARASHTRA,2012,Total (Poison),6,1028,1390,997,409,3830,23,718,399,239,104,1483,5313
MAHARASHTRA,2012,Total (Jumping),0,39,67,32,9,147,2,26,7,7,8,50,197
MANIPUR,2001,By Over Alcoholism,0,0,0,0,0,0,0,0,0,0,0,0,0
MANIPUR,2001,By Drowning,0,0,0,0,0,0,0,0,0,0,0,0,0
MANIPUR,2001,By Fire/Self Immolation,0,0,0,0,0,0,0,1,0,0,0,1,1
MANIPUR,2001,By Fire-Arms,0,0,0,1,0,1,0,0,0,0,0,0,1
MANIPUR,2001,By Hanging,1,6,2,2,0,11,0,6,3,0,0,9,20
MANIPUR,2001,By Consuming Insecticides,0,0,0,0,0,0,0,0,1,0,0,1,1
MANIPUR,2001,By Consuming Other Poison,0,5,2,2,1,10,0,4,1,1,0,6,16
MANIPUR,2001,By Self Infliction of injury,0,0,0,0,0,0,0,0,0,0,0,0,0
MANIPUR,2001,By Jumping from (Building),0,0,0,0,0,0,0,0,0,0,0,0,0
MANIPUR,2001,By Jumping from (Other sites),0,0,0,0,0,0,0,0,0,0,0,0,0
MANIPUR,2001,By Jumping off Moving Vehicles/Trains,0,0,0,0,0,0,0,0,0,0,0,0,0
MANIPUR,2001,By Machine,0,0,0,0,0,0,0,0,0,0,0,0,0
MANIPUR,2001,By Overdose of sleeping pills,0,0,0,0,0,0,0,0,0,0,0,0,0
MANIPUR,2001,By touching electric wires,0,0,0,0,0,0,0,0,0,0,0,0,0
MANIPUR,2001,By coming under running vehicles/trains,0,0,0,0,0,0,0,0,0,0,0,0,0
MANIPUR,2001,By Other means (please specify),0,1,1,0,0,2,0,0,0,0,0,0,2
MANIPUR,2001,Total,1,12,5,5,1,24,0,11,5,1,0,17,41
MANIPUR,2001,Total (Poison),0,5,2,2,1,10,0,4,2,1,0,7,17
MANIPUR,2001,Total (Jumping),0,0,0,0,0,0,0,0,0,0,0,0,0
MANIPUR,2002,By Over Alcoholism,0,0,0,0,0,0,0,0,0,0,0,0,0
MANIPUR,2002,By Drowning,0,0,0,0,0,0,0,0,0,0,0,0,0
MANIPUR,2002,By Fire/Self Immolation,0,0,0,0,0,0,0,0,0,0,0,0,0
MANIPUR,2002,By Fire-Arms,0,0,3,0,0,3,0,0,0,0,0,0,3
MANIPUR,2002,By Hanging,0,3,4,4,3,14,0,5,1,1,0,7,21
MANIPUR,2002,By Consuming Insecticides,0,0,0,0,0,0,0,0,0,0,0,0,0
MANIPUR,2002,By Consuming Other Poison,0,6,0,5,1,12,0,2,0,0,0,2,14
MANIPUR,2002,By Self Infliction of injury,0,0,0,0,0,0,0,0,0,0,0,0,0
MANIPUR,2002,By Jumping from (Building),0,0,0,0,0,0,0,0,0,0,0,0,0
MANIPUR,2002,By Jumping from (Other sites),0,0,0,0,0,0,0,0,0,0,0,0,0
MANIPUR,2002,By Jumping off Moving Vehicles/Trains,0,0,0,0,0,0,0,0,0,0,0,0,0
MANIPUR,2002,By Machine,0,0,0,0,0,0,0,0,0,0,0,0,0
MANIPUR,2002,By Overdose of sleeping pills,0,0,0,0,0,0,0,0,0,0,0,0,0
MANIPUR,2002,By touching electric wires,0,0,0,0,0,0,0,0,0,0,0,0,0
MANIPUR,2002,By coming under running vehicles/trains,0,0,0,0,0,0,0,0,0,0,0,0,0
MANIPUR,2002,By Other means,0,0,1,0,0,1,0,0,0,0,0,0,1
MANIPUR,2002,Total,0,9,8,9,4,30,0,7,1,1,0,9,39
MANIPUR,2002,Total (Poison),0,6,0,5,1,12,0,2,0,0,0,2,14
MANIPUR,2002,Total (Jumping),0,0,0,0,0,0,0,0,0,0,0,0,0
MANIPUR,2003,By Over Alcoholism,0,0,0,0,0,0,0,0,0,0,0,0,0
MANIPUR,2003,By Drowning,0,0,0,0,0,0,0,0,0,0,0,0,0
MANIPUR,2003,By Fire/Self Immolation,0,0,0,0,0,0,0,0,0,0,0,0,0
MANIPUR,2003,By Fire-Arms,0,0,1,2,0,3,0,0,0,0,0,0,3
MANIPUR,2003,By Hanging,0,6,5,1,1,13,0,2,0,0,0,2,15
MANIPUR,2003,By Consuming Insecticides,0,1,0,0,0,1,0,1,0,0,0,1,2
MANIPUR,2003,By Consuming Other Poison,0,2,0,0,2,4,0,1,0,0,1,2,6
MANIPUR,2003,By Self Infliction of injury,0,0,0,0,0,0,0,0,0,0,0,0,0
MANIPUR,2003,By Jumping from (Building),0,0,0,0,0,0,0,0,0,0,0,0,0
MANIPUR,2003,By Jumping from (Other sites),0,0,0,0,0,0,0,0,0,0,0,0,0
MANIPUR,2003,By Jumping off Moving Vehicles/Trains,0,0,0,0,0,0,0,0,0,0,0,0,0
MANIPUR,2003,By Machine,0,0,0,0,0,0,0,0,0,0,0,0,0
MANIPUR,2003,By Overdose of sleeping pills,0,0,0,0,0,0,0,0,0,0,0,0,0
MANIPUR,2003,By touching electric wires,0,0,0,0,0,0,0,0,0,0,0,0,0
MANIPUR,2003,By coming under running vehicles/trains,0,0,0,0,0,0,0,0,0,0,0,0,0
MANIPUR,2003,By Other means (please specify),0,0,0,0,0,0,0,0,0,0,0,0,0
MANIPUR,2003,Total,0,9,6,3,3,21,0,4,0,0,1,5,26
MANIPUR,2003,Total (Poison),0,3,0,0,2,5,0,2,0,0,1,3,8
MANIPUR,2003,Total (Jumping),0,0,0,0,0,0,0,0,0,0,0,0,0
MANIPUR,2004,By Over Alcoholism,0,0,0,0,0,0,0,0,0,0,0,0,0
MANIPUR,2004,By Drowning,0,1,0,0,0,1,0,0,0,0,0,0,1
MANIPUR,2004,By Fire/Self Immolation,0,2,0,0,0,2,0,1,0,0,0,1,3
MANIPUR,2004,By Fire-Arms,0,2,5,1,0,8,0,0,0,0,0,0,8
MANIPUR,2004,By Hanging,0,7,6,2,0,15,1,2,2,0,0,5,20
MANIPUR,2004,By Consuming Insecticides,0,0,1,0,0,1,0,0,0,0,0,0,1
MANIPUR,2004,By Consuming Other Poison,0,1,0,0,0,1,0,2,1,0,0,3,4
MANIPUR,2004,By Self Infliction of injury,0,0,0,0,0,0,0,0,0,0,0,0,0
MANIPUR,2004,By Jumping from (Building),0,0,0,0,0,0,0,0,0,0,0,0,0
MANIPUR,2004,By Jumping from (Other sites),0,0,0,0,0,0,0,0,0,0,0,0,0
MANIPUR,2004,By Jumping off Moving Vehicles/Trains,0,0,0,0,0,0,0,0,0,0,0,0,0
MANIPUR,2004,By Machine,0,0,0,0,0,0,0,0,0,0,0,0,0
MANIPUR,2004,By Overdose of sleeping pills,0,2,0,0,0,2,0,0,0,0,0,0,2
MANIPUR,2004,By touching electric wires,0,0,0,0,0,0,0,0,0,0,0,0,0
MANIPUR,2004,By coming under running vehicles/trains,0,0,0,0,0,0,0,0,0,0,0,0,0
MANIPUR,2004,By Other means (please specify),0,2,0,0,0,2,0,0,0,0,0,0,2
MANIPUR,2004,Total,0,17,12,3,0,32,1,5,3,0,0,9,41
MANIPUR,2004,Total (Poison),0,1,1,0,0,2,0,2,1,0,0,3,5
MANIPUR,2004,Total (Jumping),0,0,0,0,0,0,0,0,0,0,0,0,0
MANIPUR,2005,By Over Alcoholism,0,0,0,0,0,0,0,0,0,0,0,0,0
MANIPUR,2005,By Drowning,0,0,0,0,0,0,0,0,0,0,0,0,0
MANIPUR,2005,By Fire/Self Immolation,0,0,1,0,0,1,0,0,0,0,0,0,1
MANIPUR,2005,By Fire-Arms,0,1,4,0,0,5,0,0,0,0,0,0,5
MANIPUR,2005,By Hanging,0,4,7,1,0,12,0,1,0,0,0,1,13
MANIPUR,2005,By Consuming Insecticides,0,0,2,0,0,2,0,0,0,0,0,0,2
MANIPUR,2005,By Consuming Other Poison,0,0,2,0,0,2,0,0,1,0,0,1,3
MANIPUR,2005,By Self Infliction of injury,0,0,0,0,0,0,0,0,0,0,0,0,0
MANIPUR,2005,By Jumping from (Building),0,0,0,0,0,0,0,0,0,0,0,0,0
MANIPUR,2005,By Jumping from (Other sites),0,0,0,0,0,0,0,0,0,0,0,0,0
MANIPUR,2005,By Jumping off Moving Vehicles/Trains,0,0,0,0,0,0,0,0,0,0,0,0,0
MANIPUR,2005,By Machine,0,0,0,0,0,0,0,0,0,0,0,0,0
MANIPUR,2005,By Overdose of sleeping pills,0,0,0,0,0,0,0,0,0,0,0,0,0
MANIPUR,2005,By touching electric wires,0,0,0,0,0,0,0,0,0,0,0,0,0
MANIPUR,2005,By coming under running vehicles/trains,0,0,0,0,0,0,0,0,1,0,0,1,1
MANIPUR,2005,By Other means (please specify),0,0,1,0,0,1,0,1,0,0,0,1,2
MANIPUR,2005,Total,0,5,17,1,0,23,0,2,2,0,0,4,27
MANIPUR,2005,Total (Poison),0,0,4,0,0,4,0,0,1,0,0,1,5
MANIPUR,2005,Total (Jumping),0,0,0,0,0,0,0,0,0,0,0,0,0
MANIPUR,2006,By Over Alcoholism,0,0,0,0,0,0,0,0,0,0,0,0,0
MANIPUR,2006,By Drowning,0,0,0,0,0,0,0,0,0,0,0,0,0
MANIPUR,2006,By Fire/Self Immolation,0,0,0,0,0,0,0,1,0,0,0,1,1
MANIPUR,2006,By Fire-Arms,0,2,5,2,0,9,0,0,0,0,0,0,9
MANIPUR,2006,By Hanging,0,4,6,3,1,14,0,9,1,0,0,10,24
MANIPUR,2006,By Consuming Insecticides,0,0,0,0,0,0,0,0,0,0,0,0,0
MANIPUR,2006,By Consuming Other Poison,0,0,0,0,0,0,0,1,0,0,0,1,1
MANIPUR,2006,By Self Infliction of injury,0,1,0,0,0,1,0,0,0,0,0,0,1
MANIPUR,2006,By Jumping from (Building),0,0,0,0,0,0,0,0,0,0,0,0,0
MANIPUR,2006,By Jumping from (Other sites),0,0,0,0,0,0,0,0,0,0,0,0,0
MANIPUR,2006,By Jumping off Moving Vehicles/Trains,0,0,0,0,0,0,0,0,0,0,0,0,0
MANIPUR,2006,By Machine,0,0,0,0,0,0,0,0,0,0,0,0,0
MANIPUR,2006,By Overdose of sleeping pills,0,0,0,0,0,0,0,0,0,0,0,0,0
MANIPUR,2006,By touching electric wires,0,0,0,0,0,0,0,0,0,0,0,0,0
MANIPUR,2006,By coming under running vehicles/trains,0,0,0,0,0,0,0,0,0,0,0,0,0
MANIPUR,2006,By Other means (please specify),0,0,0,0,0,0,0,0,0,0,0,0,0
MANIPUR,2006,Total,0,7,11,5,1,24,0,11,1,0,0,12,36
MANIPUR,2006,Total (Poison),0,1,0,0,0,1,0,1,0,0,0,1,2
MANIPUR,2006,Total (Jumping),0,0,0,0,0,0,0,0,0,0,0,0,0
MANIPUR,2007,By Over Alcoholism,0,0,0,0,0,0,0,0,0,0,0,0,0
MANIPUR,2007,By Drowning,0,0,0,0,0,0,0,0,0,0,0,0,0
MANIPUR,2007,By Fire/Self Immolation,0,0,0,0,0,0,0,0,0,0,0,0,0
MANIPUR,2007,By Fire-Arms,0,1,8,2,0,11,0,0,0,0,0,0,11
MANIPUR,2007,By Hanging,1,3,7,1,0,12,0,4,3,0,0,7,19
MANIPUR,2007,By Consuming Insecticides,0,0,0,0,0,0,0,0,2,0,0,2,2
MANIPUR,2007,By Consuming Other Poison,0,1,2,0,0,3,0,0,1,0,0,1,4
MANIPUR,2007,By Self Infliction of injury,0,0,0,0,0,0,0,0,0,0,0,0,0
MANIPUR,2007,By Jumping from (Building),0,0,0,0,0,0,0,0,0,0,0,0,0
MANIPUR,2007,By Jumping from (Other sites),0,0,0,0,0,0,0,0,0,0,0,0,0
MANIPUR,2007,By Jumping off Moving Vehicles/Trains,0,0,0,0,0,0,0,0,0,0,0,0,0
MANIPUR,2007,By Machine,0,0,0,0,0,0,0,0,0,0,0,0,0
MANIPUR,2007,By Overdose of sleeping pills,0,0,0,0,0,0,0,0,0,0,0,0,0
MANIPUR,2007,By touching electric wires,0,0,0,0,0,0,0,0,0,0,0,0,0
MANIPUR,2007,By coming under running vehicles/trains,0,0,0,0,0,0,0,0,0,0,0,0,0
MANIPUR,2007,By Other means (please specify),0,2,0,0,0,2,0,0,0,1,0,1,3
MANIPUR,2007,Total,1,7,17,3,0,28,0,4,6,1,0,11,39
MANIPUR,2007,Total (Poison),0,1,2,0,0,3,0,0,3,0,0,3,6
MANIPUR,2007,Total (Jumping),0,0,0,0,0,0,0,0,0,0,0,0,0
MANIPUR,2008,By Over Alcoholism,0,0,0,0,0,0,0,0,0,0,0,0,0
MANIPUR,2008,By Drowning,0,0,0,0,0,0,0,0,0,0,0,0,0
MANIPUR,2008,By Fire/Self Immolation,0,0,0,0,0,0,0,0,0,0,0,0,0
MANIPUR,2008,By Fire-Arms,0,1,3,0,0,4,0,0,0,0,0,0,4
MANIPUR,2008,By Hanging,0,7,7,0,0,14,0,1,1,0,0,2,16
MANIPUR,2008,By Consuming Insecticides,0,1,0,0,0,1,0,0,0,0,0,0,1
MANIPUR,2008,By Consuming Other Poison,0,2,2,0,0,4,1,6,1,1,0,9,13
MANIPUR,2008,By Self Infliction of injury,0,0,0,0,0,0,0,0,0,0,0,0,0
MANIPUR,2008,By Jumping from (Building),0,0,0,0,0,0,0,0,0,0,0,0,0
MANIPUR,2008,By Jumping from (Other sites),0,0,0,0,0,0,0,0,0,0,0,0,0
MANIPUR,2008,By Jumping off Moving Vehicles/Trains,0,0,0,0,0,0,0,0,0,0,0,0,0
MANIPUR,2008,By Machine,0,0,0,0,0,0,0,0,0,0,0,0,0
MANIPUR,2008,By Overdose of sleeping pills,0,0,0,0,0,0,0,0,0,0,0,0,0
MANIPUR,2008,By touching electric wires,0,0,0,0,0,0,0,0,0,0,0,0,0
MANIPUR,2008,By coming under running vehicles/trains,0,0,0,0,0,0,0,0,0,0,0,0,0
MANIPUR,2008,By Other means (please specify),0,0,0,0,0,0,0,0,0,0,0,0,0
MANIPUR,2008,Total,0,11,12,0,0,23,1,7,2,1,0,11,34
MANIPUR,2008,Total (Poison),0,3,2,0,0,5,1,6,1,1,0,9,14
MANIPUR,2008,Total (Jumping),0,0,0,0,0,0,0,0,0,0,0,0,0
MANIPUR,2009,By Over Alcoholism,0,0,0,0,0,0,0,0,0,0,0,0,0
MANIPUR,2009,By Drowning,0,0,0,0,0,0,0,0,0,0,0,0,0
MANIPUR,2009,By Fire/Self Immolation,0,0,0,0,0,0,0,0,0,0,0,0,0
MANIPUR,2009,By Fire-Arms,0,3,5,1,0,9,0,0,0,0,0,0,9
MANIPUR,2009,By Hanging,0,1,4,0,0,5,0,4,1,0,0,5,10
MANIPUR,2009,By Consuming Insecticides,0,0,1,0,0,1,0,1,2,0,0,3,4
MANIPUR,2009,By Consuming Other Poison,0,2,1,0,0,3,0,1,0,0,0,1,4
MANIPUR,2009,By Self Infliction of injury,0,0,0,0,0,0,0,0,0,0,0,0,0
MANIPUR,2009,By Jumping from (Building),0,0,0,0,0,0,0,0,0,0,0,0,0
MANIPUR,2009,By Jumping from (Other sites),0,0,0,0,0,0,0,0,0,0,0,0,0
MANIPUR,2009,By Jumping off Moving Vehicles/Trains,0,0,0,0,0,0,0,0,0,0,0,0,0
MANIPUR,2009,By Machine,0,0,0,0,0,0,0,0,0,0,0,0,0
MANIPUR,2009,By Overdose of sleeping pills,0,0,0,0,0,0,0,0,0,0,0,0,0
MANIPUR,2009,By touching electric wires,0,0,0,0,0,0,0,0,0,0,0,0,0
MANIPUR,2009,By coming under running vehicles/trains,0,0,0,0,0,0,0,0,0,0,0,0,0
MANIPUR,2009,By Other means (please specify),0,0,0,0,0,0,0,0,0,0,0,0,0
MANIPUR,2009,Total,0,6,11,1,0,18,0,6,3,0,0,9,27
MANIPUR,2009,Total (Poison),0,2,2,0,0,4,0,2,2,0,0,4,8
MANIPUR,2009,Total (Jumping),0,0,0,0,0,0,0,0,0,0,0,0,0
MANIPUR,2010,By Over Alcoholism,0,0,0,0,0,0,0,0,0,0,0,0,0
MANIPUR,2010,By Drowning,0,0,0,0,0,0,0,0,0,0,0,0,0
MANIPUR,2010,By Fire/Self Immolation,0,0,0,0,0,0,0,0,0,0,0,0,0
MANIPUR,2010,By Fire-Arms,0,1,1,0,0,2,0,0,0,0,0,0,2
MANIPUR,2010,By Hanging,0,5,11,3,0,19,0,5,3,0,0,8,27
MANIPUR,2010,By Consuming Insecticides,0,0,0,0,0,0,0,1,0,0,0,1,1
MANIPUR,2010,By Consuming Other Poison,0,1,1,1,0,3,0,2,1,1,0,4,7
MANIPUR,2010,By Self Infliction of injury,0,0,0,0,0,0,0,0,0,0,0,0,0
MANIPUR,2010,By Jumping from (Building),0,0,0,0,0,0,0,0,0,0,0,0,0
MANIPUR,2010,By Jumping from (Other sites),0,0,0,0,0,0,0,0,0,0,0,0,0
MANIPUR,2010,By Jumping off Moving Vehicles/Trains,0,0,0,0,0,0,0,0,0,0,0,0,0
MANIPUR,2010,By Machine,0,0,0,0,0,0,0,0,0,0,0,0,0
MANIPUR,2010,By Overdose of sleeping pills,0,0,0,0,0,0,0,0,0,0,0,0,0
MANIPUR,2010,By touching electric wires,0,0,0,0,0,0,0,0,0,0,0,0,0
MANIPUR,2010,By coming under running vehicles/trains,0,0,0,0,0,0,0,0,0,0,0,0,0
MANIPUR,2010,By Other means (please specify),0,0,0,0,0,0,0,0,0,0,0,0,0
MANIPUR,2010,Total,0,7,13,4,0,24,0,8,4,1,0,13,37
MANIPUR,2010,Total (Poison),0,1,1,1,0,3,0,3,1,1,0,5,8
MANIPUR,2010,Total (Jumping),0,0,0,0,0,0,0,0,0,0,0,0,0
MANIPUR,2011,By Over Alcoholism,0,0,0,0,0,0,0,0,0,0,0,0,0
MANIPUR,2011,By Drowning,0,0,0,0,0,0,0,0,0,0,0,0,0
MANIPUR,2011,By Fire/Self Immolation,0,0,0,0,0,0,0,0,0,0,0,0,0
MANIPUR,2011,By Fire-Arms,0,0,3,1,0,4,0,0,0,0,0,0,4
MANIPUR,2011,By Hanging,0,4,6,2,0,12,0,4,2,1,0,7,19
MANIPUR,2011,By Consuming Insecticides,0,0,0,0,0,0,0,5,0,0,0,5,5
MANIPUR,2011,By Consuming Other Poison,0,1,0,0,0,1,0,3,0,0,0,3,4
MANIPUR,2011,By Self Infliction of injury,0,0,0,0,0,0,0,0,0,0,0,0,0
MANIPUR,2011,By Jumping from (Building),0,0,0,0,0,0,0,0,0,0,0,0,0
MANIPUR,2011,By Jumping from (Other sites),0,0,0,0,0,0,0,0,0,0,0,0,0
MANIPUR,2011,By Jumping off Moving Vehicles/Trains,0,0,0,0,0,0,0,0,0,0,0,0,0
MANIPUR,2011,By Machine,0,0,0,0,0,0,0,0,0,0,0,0,0
MANIPUR,2011,By Overdose of sleeping pills,0,0,0,0,0,0,0,0,0,0,0,0,0
MANIPUR,2011,By touching electric wires,0,0,0,0,0,0,0,0,0,0,0,0,0
MANIPUR,2011,By coming under running vehicles/trains,0,0,0,0,0,0,0,0,0,0,0,0,0
MANIPUR,2011,By Other means (please specify),0,1,0,0,0,1,0,0,0,0,0,0,1
MANIPUR,2011,Total,0,6,9,3,0,18,0,12,2,1,0,15,33
MANIPUR,2011,Total (Poison),0,1,0,0,0,1,0,8,0,0,0,8,9
MANIPUR,2011,Total (Jumping),0,0,0,0,0,0,0,0,0,0,0,0,0
MANIPUR,2012,By Over Alcoholism,0,0,0,0,0,0,0,0,0,0,0,0,0
MANIPUR,2012,By Drowning,0,0,0,0,0,0,0,0,0,0,0,0,0
MANIPUR,2012,By Fire/Self Immolation,0,0,0,0,0,0,0,0,1,0,0,1,1
MANIPUR,2012,By Fire-Arms,0,1,3,0,0,4,0,0,0,0,0,0,4
MANIPUR,2012,By Hanging,0,11,6,0,0,17,1,10,2,0,1,14,31
MANIPUR,2012,By Consuming Insecticides,0,1,0,0,0,1,0,0,0,0,0,0,1
MANIPUR,2012,By Consuming Other Poison,0,0,0,0,0,0,0,1,1,1,0,3,3
MANIPUR,2012,By Self Infliction of injury,0,0,0,0,0,0,0,0,0,0,0,0,0
MANIPUR,2012,By Jumping from (Building),0,0,0,0,0,0,0,0,0,0,0,0,0
MANIPUR,2012,By Jumping from (Other sites),0,0,0,0,0,0,0,0,0,0,0,0,0
MANIPUR,2012,By Jumping off Moving Vehicles/Trains,0,0,0,0,0,0,0,0,0,0,0,0,0
MANIPUR,2012,By Machine,0,0,0,0,0,0,0,0,0,0,0,0,0
MANIPUR,2012,By Overdose of sleeping pills,0,0,0,0,0,0,0,0,0,0,0,0,0
MANIPUR,2012,By touching electric wires,0,0,0,0,0,0,0,0,0,0,0,0,0
MANIPUR,2012,By coming under running vehicles/trains,0,0,0,0,0,0,0,0,0,0,0,0,0
MANIPUR,2012,By Other means (please specify),0,1,0,0,0,1,0,0,0,0,0,0,1
MANIPUR,2012,Total,0,14,9,0,0,23,1,11,4,1,1,18,41
MANIPUR,2012,Total (Poison),0,1,0,0,0,1,0,1,1,1,0,3,4
MANIPUR,2012,Total (Jumping),0,0,0,0,0,0,0,0,0,0,0,0,0
MEGHALAYA,2001,By Over Alcoholism,0,1,0,0,0,1,0,0,0,0,0,0,1
MEGHALAYA,2001,By Drowning,0,2,2,0,0,4,0,1,0,0,0,1,5
MEGHALAYA,2001,By Fire/Self Immolation,0,0,2,0,2,4,0,2,1,0,0,3,7
MEGHALAYA,2001,By Fire-Arms,0,0,3,0,1,4,0,2,0,0,0,2,6
MEGHALAYA,2001,By Hanging,1,12,8,1,2,24,0,4,1,0,0,5,29
MEGHALAYA,2001,By Consuming Insecticides,0,0,0,0,0,0,0,0,0,0,0,0,0
MEGHALAYA,2001,By Consuming Other Poison,0,0,0,0,0,0,0,0,0,0,0,0,0
MEGHALAYA,2001,By Self Infliction of injury,0,0,0,0,0,0,0,0,0,0,0,0,0
MEGHALAYA,2001,By Jumping from (Building),0,0,0,0,0,0,0,0,0,0,0,0,0
MEGHALAYA,2001,By Jumping from (Other sites),0,0,2,0,0,2,0,0,0,0,0,0,2
MEGHALAYA,2001,By Jumping off Moving Vehicles/Trains,0,1,0,0,0,1,0,0,0,0,0,0,1
MEGHALAYA,2001,By Machine,0,0,0,0,0,0,0,0,0,0,0,0,0
MEGHALAYA,2001,By Overdose of sleeping pills,0,0,0,0,0,0,0,0,0,0,0,0,0
MEGHALAYA,2001,By touching electric wires,0,1,0,0,0,1,0,0,0,0,0,0,1
MEGHALAYA,2001,By coming under running vehicles/trains,0,0,0,0,0,0,0,0,0,0,0,0,0
MEGHALAYA,2001,By Other means (please specify),0,5,19,4,0,28,0,2,0,3,2,7,35
MEGHALAYA,2001,Total,1,22,36,5,5,69,0,11,2,3,2,18,87
MEGHALAYA,2001,Total (Poison),0,0,0,0,0,0,0,0,0,0,0,0,0
MEGHALAYA,2001,Total (Jumping),0,0,2,0,0,2,0,0,0,0,0,0,2
MEGHALAYA,2002,By Over Alcoholism,0,1,2,0,0,3,0,0,0,0,0,0,3
MEGHALAYA,2002,By Drowning,1,0,4,4,0,9,0,2,2,0,0,4,13
MEGHALAYA,2002,By Fire/Self Immolation,0,0,0,0,0,0,0,0,0,0,0,0,0
MEGHALAYA,2002,By Fire-Arms,0,0,1,0,0,1,0,0,0,0,0,0,1
MEGHALAYA,2002,By Hanging,2,6,10,5,3,26,2,4,3,2,0,11,37
MEGHALAYA,2002,By Consuming Insecticides,0,0,0,0,0,0,0,0,0,0,0,0,0
MEGHALAYA,2002,By Consuming Other Poison,0,0,0,0,0,0,0,0,0,0,0,0,0
MEGHALAYA,2002,By Self Infliction of injury,0,0,0,0,0,0,0,0,0,0,0,0,0
MEGHALAYA,2002,By Jumping from (Building),0,0,0,0,0,0,0,0,0,0,0,0,0
MEGHALAYA,2002,By Jumping from (Other sites),0,1,1,0,0,2,0,1,0,0,0,1,3
MEGHALAYA,2002,By Jumping off Moving Vehicles/Trains,0,0,0,0,0,0,0,0,0,0,0,0,0
MEGHALAYA,2002,By Machine,0,0,0,0,0,0,0,0,0,0,0,0,0
MEGHALAYA,2002,By Overdose of sleeping pills,0,0,0,0,0,0,0,0,0,0,0,0,0
MEGHALAYA,2002,By touching electric wires,0,0,0,0,0,0,0,0,0,0,0,0,0
MEGHALAYA,2002,By coming under running vehicles/trains,0,0,0,0,0,0,0,0,0,0,0,0,0
MEGHALAYA,2002,By Other means,0,1,3,4,0,8,0,1,1,0,0,2,10
MEGHALAYA,2002,Total,3,9,21,13,3,49,2,8,6,2,0,18,67
MEGHALAYA,2002,Total (Poison),0,0,0,0,0,0,0,0,0,0,0,0,0
MEGHALAYA,2002,Total (Jumping),0,1,1,0,0,2,0,1,0,0,0,1,3
MEGHALAYA,2003,By Over Alcoholism,0,0,0,0,0,0,0,0,0,0,0,0,0
MEGHALAYA,2003,By Drowning,3,2,2,0,0,7,0,0,0,0,0,0,7
MEGHALAYA,2003,By Fire/Self Immolation,0,0,0,0,0,0,0,1,0,0,0,1,1
MEGHALAYA,2003,By Fire-Arms,0,0,2,1,0,3,0,0,0,0,0,0,3
MEGHALAYA,2003,By Hanging,0,5,9,6,1,21,1,4,2,0,1,8,29
MEGHALAYA,2003,By Consuming Insecticides,0,0,0,0,0,0,0,0,0,0,0,0,0
MEGHALAYA,2003,By Consuming Other Poison,0,0,0,0,0,0,0,0,0,0,0,0,0
MEGHALAYA,2003,By Self Infliction of injury,0,0,0,0,0,0,0,0,0,0,0,0,0
MEGHALAYA,2003,By Jumping from (Building),0,0,0,0,0,0,0,0,0,0,0,0,0
MEGHALAYA,2003,By Jumping from (Other sites),0,0,0,0,0,0,0,0,0,0,0,0,0
MEGHALAYA,2003,By Jumping off Moving Vehicles/Trains,0,0,0,0,0,0,0,0,0,0,0,0,0
MEGHALAYA,2003,By Machine,0,0,0,0,0,0,0,0,0,0,0,0,0
MEGHALAYA,2003,By Overdose of sleeping pills,0,0,0,0,0,0,0,0,0,0,0,0,0
MEGHALAYA,2003,By touching electric wires,0,0,0,0,0,0,0,0,0,0,0,0,0
MEGHALAYA,2003,By coming under running vehicles/trains,0,0,0,0,0,0,0,0,0,0,0,0,0
MEGHALAYA,2003,By Other means (please specify),0,0,1,0,0,1,0,0,0,0,0,0,1
MEGHALAYA,2003,Total,3,7,14,7,1,32,1,5,2,0,1,9,41
MEGHALAYA,2003,Total (Poison),0,0,0,0,0,0,0,0,0,0,0,0,0
MEGHALAYA,2003,Total (Jumping),0,0,0,0,0,0,0,0,0,0,0,0,0
MEGHALAYA,2004,By Over Alcoholism,0,0,0,0,0,0,0,0,0,0,0,0,0
MEGHALAYA,2004,By Drowning,0,4,3,0,0,7,0,1,0,0,0,1,8
MEGHALAYA,2004,By Fire/Self Immolation,0,0,2,0,0,2,0,5,1,0,0,6,8
MEGHALAYA,2004,By Fire-Arms,0,1,3,0,0,4,0,0,0,0,0,0,4
MEGHALAYA,2004,By Hanging,0,4,10,8,2,24,0,8,1,0,0,9,33
MEGHALAYA,2004,By Consuming Insecticides,0,0,0,0,0,0,0,0,0,0,0,0,0
MEGHALAYA,2004,By Consuming Other Poison,0,1,0,0,0,1,0,0,0,0,0,0,1
MEGHALAYA,2004,By Self Infliction of injury,0,0,0,0,0,0,0,0,0,0,0,0,0
MEGHALAYA,2004,By Jumping from (Building),0,0,0,0,0,0,0,0,0,0,0,0,0
MEGHALAYA,2004,By Jumping from (Other sites),0,1,0,0,0,1,0,0,0,0,0,0,1
MEGHALAYA,2004,By Jumping off Moving Vehicles/Trains,0,0,0,0,0,0,0,0,0,0,0,0,0
MEGHALAYA,2004,By Machine,0,0,0,0,0,0,0,0,0,0,0,0,0
MEGHALAYA,2004,By Overdose of sleeping pills,0,0,0,0,0,0,0,0,0,0,0,0,0
MEGHALAYA,2004,By touching electric wires,0,0,0,0,0,0,0,0,0,0,0,0,0
MEGHALAYA,2004,By coming under running vehicles/trains,0,0,0,0,0,0,0,0,0,0,0,0,0
MEGHALAYA,2004,By Other means (please specify),0,0,0,0,0,0,0,0,0,0,0,0,0
MEGHALAYA,2004,Total,0,11,18,8,2,39,0,14,2,0,0,16,55
MEGHALAYA,2004,Total (Poison),0,1,0,0,0,1,0,0,0,0,0,0,1
MEGHALAYA,2004,Total (Jumping),0,1,0,0,0,1,0,0,0,0,0,0,1
MEGHALAYA,2005,By Over Alcoholism,0,0,2,1,0,3,0,0,0,0,0,0,3
MEGHALAYA,2005,By Drowning,1,0,1,0,0,2,0,1,1,1,1,4,6
MEGHALAYA,2005,By Fire/Self Immolation,0,0,0,0,0,0,0,0,0,0,0,0,0
MEGHALAYA,2005,By Fire-Arms,0,0,0,0,0,0,0,1,0,0,0,1,1
MEGHALAYA,2005,By Hanging,2,13,10,5,4,34,0,11,4,1,0,16,50
MEGHALAYA,2005,By Consuming Insecticides,0,0,0,1,1,2,0,0,0,0,0,0,2
MEGHALAYA,2005,By Consuming Other Poison,0,0,1,1,0,2,0,0,0,0,0,0,2
MEGHALAYA,2005,By Self Infliction of injury,0,0,0,0,0,0,0,0,0,0,0,0,0
MEGHALAYA,2005,By Jumping from (Building),0,1,0,0,0,1,0,0,0,0,0,0,1
MEGHALAYA,2005,By Jumping from (Other sites),0,1,0,1,1,3,0,0,0,0,0,0,3
MEGHALAYA,2005,By Jumping off Moving Vehicles/Trains,0,0,0,0,0,0,0,0,0,0,0,0,0
MEGHALAYA,2005,By Machine,0,0,0,0,0,0,0,0,0,0,0,0,0
MEGHALAYA,2005,By Overdose of sleeping pills,0,0,0,0,0,0,0,0,0,0,0,0,0
MEGHALAYA,2005,By touching electric wires,0,0,0,1,0,1,0,0,0,0,0,0,1
MEGHALAYA,2005,By coming under running vehicles/trains,0,0,0,0,0,0,0,0,0,0,0,0,0
MEGHALAYA,2005,By Other means (please specify),0,1,0,0,1,2,0,0,0,0,0,0,2
MEGHALAYA,2005,Total,3,16,14,10,7,50,0,13,5,2,1,21,71
MEGHALAYA,2005,Total (Poison),0,0,1,2,1,4,0,0,0,0,0,0,4
MEGHALAYA,2005,Total (Jumping),0,2,0,1,1,4,0,0,0,0,0,0,4
MEGHALAYA,2006,By Over Alcoholism,0,1,1,0,0,2,0,0,0,0,0,0,2
MEGHALAYA,2006,By Drowning,0,2,0,0,0,2,0,1,3,0,0,4,6
MEGHALAYA,2006,By Fire/Self Immolation,0,0,0,0,0,0,0,1,0,0,0,1,1
MEGHALAYA,2006,By Fire-Arms,0,0,2,0,0,2,0,0,0,0,0,0,2
MEGHALAYA,2006,By Hanging,1,29,15,4,4,53,1,12,2,0,0,15,68
MEGHALAYA,2006,By Consuming Insecticides,0,1,1,0,0,2,0,1,0,0,0,1,3
MEGHALAYA,2006,By Consuming Other Poison,0,2,0,0,0,2,0,1,0,0,0,1,3
MEGHALAYA,2006,By Self Infliction of injury,0,1,0,0,0,1,0,0,0,0,0,0,1
MEGHALAYA,2006,By Jumping from (Building),0,0,0,0,0,0,0,0,0,0,0,0,0
MEGHALAYA,2006,By Jumping from (Other sites),0,0,0,0,0,0,0,0,0,0,0,0,0
MEGHALAYA,2006,By Jumping off Moving Vehicles/Trains,0,0,0,0,0,0,0,0,0,0,0,0,0
MEGHALAYA,2006,By Machine,0,1,0,0,0,1,0,0,0,0,0,0,1
MEGHALAYA,2006,By Overdose of sleeping pills,0,0,0,0,0,0,0,0,0,0,0,0,0
MEGHALAYA,2006,By touching electric wires,0,0,0,0,0,0,0,0,0,0,0,0,0
MEGHALAYA,2006,By coming under running vehicles/trains,0,0,0,0,0,0,0,0,0,0,0,0,0
MEGHALAYA,2006,By Other means (please specify),0,3,0,1,0,4,0,1,0,0,0,1,5
MEGHALAYA,2006,Total,1,40,19,5,4,69,1,17,5,0,0,23,92
MEGHALAYA,2006,Total (Poison),0,4,1,0,0,5,0,2,0,0,0,2,7
MEGHALAYA,2006,Total (Jumping),0,0,0,0,0,0,0,0,0,0,0,0,0
MEGHALAYA,2007,By Over Alcoholism,0,0,0,0,0,0,0,0,0,0,0,0,0
MEGHALAYA,2007,By Drowning,0,2,1,0,0,3,0,0,0,0,0,0,3
MEGHALAYA,2007,By Fire/Self Immolation,0,0,0,0,0,0,0,0,0,0,0,0,0
MEGHALAYA,2007,By Fire-Arms,0,0,0,1,0,1,0,0,0,0,0,0,1
MEGHALAYA,2007,By Hanging,1,17,14,6,3,41,0,12,10,0,0,22,63
MEGHALAYA,2007,By Consuming Insecticides,0,1,1,0,0,2,0,0,0,0,0,0,2
MEGHALAYA,2007,By Consuming Other Poison,0,2,2,0,0,4,0,2,0,0,0,2,6
MEGHALAYA,2007,By Self Infliction of injury,0,0,0,0,0,0,0,0,0,0,0,0,0
MEGHALAYA,2007,By Jumping from (Building),0,0,0,0,0,0,0,0,0,0,0,0,0
MEGHALAYA,2007,By Jumping from (Other sites),0,0,0,0,0,0,0,0,0,0,0,0,0
MEGHALAYA,2007,By Jumping off Moving Vehicles/Trains,0,0,0,0,0,0,0,0,0,0,0,0,0
MEGHALAYA,2007,By Machine,0,0,0,0,0,0,0,0,0,0,0,0,0
MEGHALAYA,2007,By Overdose of sleeping pills,0,0,0,0,0,0,0,0,0,0,0,0,0
MEGHALAYA,2007,By touching electric wires,0,0,0,0,0,0,0,0,0,0,0,0,0
MEGHALAYA,2007,By coming under running vehicles/trains,0,0,0,0,0,0,0,0,0,0,0,0,0
MEGHALAYA,2007,By Other means (please specify),0,6,3,0,0,9,0,1,2,0,0,3,12
MEGHALAYA,2007,Total,1,28,21,7,3,60,0,15,12,0,0,27,87
MEGHALAYA,2007,Total (Poison),0,3,3,0,0,6,0,2,0,0,0,2,8
MEGHALAYA,2007,Total (Jumping),0,0,0,0,0,0,0,0,0,0,0,0,0
MEGHALAYA,2008,By Over Alcoholism,0,0,0,0,0,0,0,0,0,0,0,0,0
MEGHALAYA,2008,By Drowning,0,4,2,2,0,8,0,2,0,0,0,2,10
MEGHALAYA,2008,By Fire/Self Immolation,0,0,0,0,0,0,0,0,0,0,0,0,0
MEGHALAYA,2008,By Fire-Arms,0,0,1,1,0,2,0,0,0,0,0,0,2
MEGHALAYA,2008,By Hanging,0,15,21,6,1,43,1,6,12,2,2,23,66
MEGHALAYA,2008,By Consuming Insecticides,0,0,0,0,0,0,0,0,0,0,0,0,0
MEGHALAYA,2008,By Consuming Other Poison,0,0,0,1,0,1,0,0,0,0,0,0,1
MEGHALAYA,2008,By Self Infliction of injury,0,0,0,0,0,0,0,0,0,0,0,0,0
MEGHALAYA,2008,By Jumping from (Building),0,0,0,0,0,0,0,0,0,0,0,0,0
MEGHALAYA,2008,By Jumping from (Other sites),0,0,0,0,0,0,0,0,0,0,0,0,0
MEGHALAYA,2008,By Jumping off Moving Vehicles/Trains,0,0,0,0,0,0,0,0,0,0,0,0,0
MEGHALAYA,2008,By Machine,0,0,0,0,0,0,0,0,0,0,0,0,0
MEGHALAYA,2008,By Overdose of sleeping pills,0,0,0,0,0,0,0,0,0,0,0,0,0
MEGHALAYA,2008,By touching electric wires,0,0,0,0,0,0,0,0,0,0,0,0,0
MEGHALAYA,2008,By coming under running vehicles/trains,0,0,0,0,0,0,0,0,0,0,0,0,0
MEGHALAYA,2008,By Other means (please specify),0,0,3,0,0,3,0,3,0,0,0,3,6
MEGHALAYA,2008,Total,0,19,27,10,1,57,1,11,12,2,2,28,85
MEGHALAYA,2008,Total (Poison),0,0,0,1,0,1,0,0,0,0,0,0,1
MEGHALAYA,2008,Total (Jumping),0,0,0,0,0,0,0,0,0,0,0,0,0
MEGHALAYA,2009,By Over Alcoholism,0,2,2,2,0,6,0,0,0,0,0,0,6
MEGHALAYA,2009,By Drowning,1,1,1,3,0,6,0,1,0,2,0,3,9
MEGHALAYA,2009,By Fire/Self Immolation,0,0,0,0,0,0,0,0,0,2,0,2,2
MEGHALAYA,2009,By Fire-Arms,0,1,0,1,0,2,0,0,0,0,0,0,2
MEGHALAYA,2009,By Hanging,0,13,5,17,3,38,0,13,4,6,0,23,61
MEGHALAYA,2009,By Consuming Insecticides,0,0,0,1,0,1,0,0,0,1,0,1,2
MEGHALAYA,2009,By Consuming Other Poison,0,2,0,0,0,2,0,1,1,0,0,2,4
MEGHALAYA,2009,By Self Infliction of injury,0,1,1,0,0,2,0,0,0,0,0,0,2
MEGHALAYA,2009,By Jumping from (Building),0,0,0,2,0,2,0,0,0,0,0,0,2
MEGHALAYA,2009,By Jumping from (Other sites),0,0,0,0,0,0,0,0,0,0,0,0,0
MEGHALAYA,2009,By Jumping off Moving Vehicles/Trains,0,0,0,0,0,0,0,0,0,0,0,0,0
MEGHALAYA,2009,By Machine,0,2,0,0,0,2,0,0,0,0,0,0,2
MEGHALAYA,2009,By Overdose of sleeping pills,0,0,0,0,0,0,0,0,0,0,0,0,0
MEGHALAYA,2009,By touching electric wires,0,1,1,0,0,2,0,0,0,0,0,0,2
MEGHALAYA,2009,By coming under running vehicles/trains,0,0,0,0,0,0,0,0,0,0,0,0,0
MEGHALAYA,2009,By Other means (please specify),0,1,1,1,1,4,1,3,1,6,3,14,18
MEGHALAYA,2009,Total,1,24,11,27,4,67,1,18,6,17,3,45,112
MEGHALAYA,2009,Total (Poison),0,3,1,1,0,5,0,1,1,1,0,3,8
MEGHALAYA,2009,Total (Jumping),0,0,0,2,0,2,0,0,0,0,0,0,2
MEGHALAYA,2010,By Over Alcoholism,0,0,1,1,0,2,0,0,0,0,0,0,2
MEGHALAYA,2010,By Drowning,1,4,1,0,0,6,1,0,1,0,0,2,8
MEGHALAYA,2010,By Fire/Self Immolation,0,1,0,0,0,1,0,1,1,0,0,2,3
MEGHALAYA,2010,By Fire-Arms,0,0,0,0,0,0,0,0,0,0,0,0,0
MEGHALAYA,2010,By Hanging,1,29,17,10,5,62,0,14,5,1,1,21,83
MEGHALAYA,2010,By Consuming Insecticides,0,0,0,0,0,0,0,0,1,0,0,1,1
MEGHALAYA,2010,By Consuming Other Poison,0,0,1,0,0,1,0,0,0,0,0,0,1
MEGHALAYA,2010,By Self Infliction of injury,0,0,0,0,0,0,0,0,0,1,0,1,1
MEGHALAYA,2010,By Jumping from (Building),0,0,0,0,0,0,0,0,0,0,0,0,0
MEGHALAYA,2010,By Jumping from (Other sites),0,0,0,0,0,0,0,0,0,0,0,0,0
MEGHALAYA,2010,By Jumping off Moving Vehicles/Trains,0,0,0,0,0,0,0,0,0,0,0,0,0
MEGHALAYA,2010,By Machine,0,0,0,0,0,0,0,0,0,0,0,0,0
MEGHALAYA,2010,By Overdose of sleeping pills,0,0,0,0,0,0,0,0,0,0,0,0,0
MEGHALAYA,2010,By touching electric wires,0,0,0,0,0,0,0,0,0,0,0,0,0
MEGHALAYA,2010,By coming under running vehicles/trains,0,0,0,0,0,0,0,0,0,0,0,0,0
MEGHALAYA,2010,By Other means (please specify),0,3,3,2,0,8,0,0,1,0,0,1,9
MEGHALAYA,2010,Total,2,37,23,13,5,80,1,15,9,2,1,28,108
MEGHALAYA,2010,Total (Poison),0,0,1,0,0,1,0,0,1,1,0,2,3
MEGHALAYA,2010,Total (Jumping),0,0,0,0,0,0,0,0,0,0,0,0,0
MEGHALAYA,2011,By Over Alcoholism,0,0,0,0,0,0,0,0,0,0,0,0,0
MEGHALAYA,2011,By Drowning,2,8,1,1,0,12,0,0,0,0,0,0,12
MEGHALAYA,2011,By Fire/Self Immolation,0,3,1,0,0,4,0,2,1,1,1,5,9
MEGHALAYA,2011,By Fire-Arms,0,2,1,1,0,4,0,0,0,0,0,0,4
MEGHALAYA,2011,By Hanging,0,39,14,11,2,66,1,19,7,4,1,32,98
MEGHALAYA,2011,By Consuming Insecticides,0,1,0,0,0,1,0,0,0,0,0,0,1
MEGHALAYA,2011,By Consuming Other Poison,0,0,0,0,0,0,0,0,0,0,0,0,0
MEGHALAYA,2011,By Self Infliction of injury,0,0,0,0,0,0,0,0,0,0,0,0,0
MEGHALAYA,2011,By Jumping from (Building),0,1,0,0,0,1,0,0,0,0,0,0,1
MEGHALAYA,2011,By Jumping from (Other sites),0,0,0,0,0,0,0,0,0,0,0,0,0
MEGHALAYA,2011,By Jumping off Moving Vehicles/Trains,0,0,0,0,0,0,0,0,0,0,0,0,0
MEGHALAYA,2011,By Machine,0,0,0,0,0,0,0,0,0,0,0,0,0
MEGHALAYA,2011,By Overdose of sleeping pills,0,0,0,0,0,0,0,0,0,0,0,0,0
MEGHALAYA,2011,By touching electric wires,0,0,0,0,0,0,0,0,0,0,0,0,0
MEGHALAYA,2011,By coming under running vehicles/trains,0,0,0,0,0,0,0,0,0,0,0,0,0
MEGHALAYA,2011,By Other means (please specify),2,13,8,0,0,23,0,0,5,0,0,5,28
MEGHALAYA,2011,Total,4,67,25,13,2,111,1,21,13,5,2,42,153
MEGHALAYA,2011,Total (Poison),0,1,0,0,0,1,0,0,0,0,0,0,1
MEGHALAYA,2011,Total (Jumping),0,1,0,0,0,1,0,0,0,0,0,0,1
MEGHALAYA,2012,By Over Alcoholism,0,0,0,0,0,0,0,0,0,0,0,0,0
MEGHALAYA,2012,By Drowning,0,0,0,0,0,0,0,0,0,0,0,0,0
MEGHALAYA,2012,By Fire/Self Immolation,0,0,1,0,0,1,0,3,1,0,0,4,5
MEGHALAYA,2012,By Fire-Arms,0,0,1,0,0,1,0,0,0,0,0,0,1
MEGHALAYA,2012,By Hanging,3,40,28,16,1,88,2,21,5,2,0,30,118
MEGHALAYA,2012,By Consuming Insecticides,0,0,0,0,0,0,0,2,0,0,0,2,2
MEGHALAYA,2012,By Consuming Other Poison,0,0,0,0,0,0,0,0,0,0,0,0,0
MEGHALAYA,2012,By Self Infliction of injury,0,0,0,0,0,0,0,0,1,0,0,1,1
MEGHALAYA,2012,By Jumping from (Building),0,0,0,0,0,0,0,0,0,0,0,0,0
MEGHALAYA,2012,By Jumping from (Other sites),0,0,0,0,0,0,0,1,0,0,0,1,1
MEGHALAYA,2012,By Jumping off Moving Vehicles/Trains,0,0,0,0,0,0,0,0,0,0,0,0,0
MEGHALAYA,2012,By Machine,0,0,0,0,0,0,0,0,0,0,0,0,0
MEGHALAYA,2012,By Overdose of sleeping pills,0,0,0,0,0,0,0,0,0,0,0,0,0
MEGHALAYA,2012,By touching electric wires,0,0,0,0,0,0,0,0,0,0,0,0,0
MEGHALAYA,2012,By coming under running vehicles/trains,0,0,0,0,0,0,0,0,0,0,0,0,0
MEGHALAYA,2012,By Other means (please specify),0,0,0,0,0,0,0,0,0,0,0,0,0
MEGHALAYA,2012,Total,3,40,30,16,1,90,2,27,7,2,0,38,128
MEGHALAYA,2012,Total (Poison),0,0,0,0,0,0,0,2,1,0,0,3,3
MEGHALAYA,2012,Total (Jumping),0,0,0,0,0,0,0,1,0,0,0,1,1
MIZORAM,2001,By Over Alcoholism,0,0,0,0,0,0,0,0,0,0,0,0,0
MIZORAM,2001,By Drowning,0,0,0,0,0,0,0,0,0,0,0,0,0
MIZORAM,2001,By Fire/Self Immolation,0,0,0,0,0,0,0,0,0,0,0,0,0
MIZORAM,2001,By Fire-Arms,0,0,1,0,0,1,0,0,0,0,0,0,1
MIZORAM,2001,By Hanging,2,18,9,4,1,34,0,3,2,1,0,6,40
MIZORAM,2001,By Consuming Insecticides,0,0,0,0,0,0,0,0,0,0,0,0,0
MIZORAM,2001,By Consuming Other Poison,0,0,0,0,0,0,0,0,0,0,0,0,0
MIZORAM,2001,By Self Infliction of injury,0,0,0,0,0,0,0,0,0,0,0,0,0
MIZORAM,2001,By Jumping from (Building),0,0,0,0,0,0,0,0,0,0,0,0,0
MIZORAM,2001,By Jumping from (Other sites),0,0,0,0,0,0,0,0,0,0,0,0,0
MIZORAM,2001,By Jumping off Moving Vehicles/Trains,0,0,0,0,0,0,0,0,0,0,0,0,0
MIZORAM,2001,By Machine,0,0,0,0,0,0,0,0,0,0,0,0,0
MIZORAM,2001,By Overdose of sleeping pills,5,0,0,0,0,5,0,0,0,0,0,0,5
MIZORAM,2001,By touching electric wires,0,0,0,0,0,0,0,0,0,0,0,0,0
MIZORAM,2001,By coming under running vehicles/trains,0,0,0,0,0,0,0,0,0,0,0,0,0
MIZORAM,2001,By Other means (please specify),0,4,0,1,1,6,0,0,0,1,1,2,8
MIZORAM,2001,Total,7,22,10,5,2,46,0,3,2,2,1,8,54
MIZORAM,2001,Total (Poison),0,0,0,0,0,0,0,0,0,0,0,0,0
MIZORAM,2001,Total (Jumping),0,0,0,0,0,0,0,0,0,0,0,0,0
MIZORAM,2002,By Over Alcoholism,0,0,0,0,0,0,0,0,0,0,0,0,0
MIZORAM,2002,By Drowning,0,2,0,0,0,2,0,0,0,0,0,0,2
MIZORAM,2002,By Fire/Self Immolation,0,0,0,0,0,0,0,0,0,0,0,0,0
MIZORAM,2002,By Fire-Arms,0,1,2,0,0,3,0,0,0,0,0,0,3
MIZORAM,2002,By Hanging,0,24,17,8,2,51,0,5,2,3,0,10,61
MIZORAM,2002,By Consuming Insecticides,0,0,0,0,0,0,0,0,0,0,0,0,0
MIZORAM,2002,By Consuming Other Poison,0,0,0,0,0,0,0,0,0,0,0,0,0
MIZORAM,2002,By Self Infliction of injury,0,0,0,0,0,0,0,0,0,0,0,0,0
MIZORAM,2002,By Jumping from (Building),0,0,0,0,0,0,0,0,0,0,0,0,0
MIZORAM,2002,By Jumping from (Other sites),0,0,0,0,0,0,0,0,0,0,0,0,0
MIZORAM,2002,By Jumping off Moving Vehicles/Trains,0,0,0,0,0,0,0,0,0,0,0,0,0
MIZORAM,2002,By Machine,0,0,0,0,0,0,0,0,0,0,0,0,0
MIZORAM,2002,By Overdose of sleeping pills,0,0,0,0,0,0,0,0,0,0,0,0,0
MIZORAM,2002,By touching electric wires,0,0,0,0,0,0,0,0,0,0,0,0,0
MIZORAM,2002,By coming under running vehicles/trains,0,0,0,0,0,0,0,0,0,0,0,0,0
MIZORAM,2002,By Other means,0,0,0,0,0,0,0,0,0,0,0,0,0
MIZORAM,2002,Total,0,27,19,8,2,56,0,5,2,3,0,10,66
MIZORAM,2002,Total (Poison),0,0,0,0,0,0,0,0,0,0,0,0,0
MIZORAM,2002,Total (Jumping),0,0,0,0,0,0,0,0,0,0,0,0,0
MIZORAM,2003,By Over Alcoholism,0,0,0,0,0,0,0,0,0,0,0,0,0
MIZORAM,2003,By Drowning,0,1,0,0,0,1,0,0,0,0,0,0,1
MIZORAM,2003,By Fire/Self Immolation,0,0,0,1,0,1,0,0,0,0,0,0,1
MIZORAM,2003,By Fire-Arms,0,4,0,0,0,4,0,0,0,0,0,0,4
MIZORAM,2003,By Hanging,1,12,16,5,0,34,0,3,7,1,0,11,45
MIZORAM,2003,By Consuming Insecticides,0,1,0,0,0,1,0,0,0,0,0,0,1
MIZORAM,2003,By Consuming Other Poison,0,0,0,0,0,0,0,0,0,0,0,0,0
MIZORAM,2003,By Self Infliction of injury,0,0,0,0,0,0,0,0,0,0,0,0,0
MIZORAM,2003,By Jumping from (Building),0,0,0,0,0,0,0,0,0,0,0,0,0
MIZORAM,2003,By Jumping from (Other sites),0,0,0,0,0,0,0,0,0,0,0,0,0
MIZORAM,2003,By Jumping off Moving Vehicles/Trains,0,0,0,0,0,0,0,0,0,0,0,0,0
MIZORAM,2003,By Machine,0,0,0,0,0,0,0,0,0,0,0,0,0
MIZORAM,2003,By Overdose of sleeping pills,0,0,0,0,0,0,0,0,0,0,0,0,0
MIZORAM,2003,By touching electric wires,0,0,0,0,0,0,0,0,0,0,0,0,0
MIZORAM,2003,By coming under running vehicles/trains,0,0,0,0,0,0,0,0,0,0,0,0,0
MIZORAM,2003,By Other means (please specify),0,0,0,0,0,0,0,0,0,0,0,0,0
MIZORAM,2003,Total,1,18,16,6,0,41,0,3,7,1,0,11,52
MIZORAM,2003,Total (Poison),0,1,0,0,0,1,0,0,0,0,0,0,1
MIZORAM,2003,Total (Jumping),0,0,0,0,0,0,0,0,0,0,0,0,0
MIZORAM,2004,By Over Alcoholism,0,0,0,0,0,0,0,0,0,0,0,0,0
MIZORAM,2004,By Drowning,0,4,1,0,0,5,0,0,0,0,0,0,5
MIZORAM,2004,By Fire/Self Immolation,0,0,0,0,0,0,0,0,0,0,0,0,0
MIZORAM,2004,By Fire-Arms,0,0,2,0,0,2,0,0,0,0,0,0,2
MIZORAM,2004,By Hanging,0,25,14,7,0,46,0,6,1,0,0,7,53
MIZORAM,2004,By Consuming Insecticides,0,0,0,0,0,0,0,0,0,0,0,0,0
MIZORAM,2004,By Consuming Other Poison,0,0,0,0,0,0,0,0,0,0,0,0,0
MIZORAM,2004,By Self Infliction of injury,0,0,0,0,0,0,0,0,0,0,0,0,0
MIZORAM,2004,By Jumping from (Building),0,0,0,0,0,0,0,0,0,0,0,0,0
MIZORAM,2004,By Jumping from (Other sites),0,0,0,0,0,0,0,0,0,0,0,0,0
MIZORAM,2004,By Jumping off Moving Vehicles/Trains,0,0,0,0,0,0,0,0,0,0,0,0,0
MIZORAM,2004,By Machine,0,0,0,0,0,0,0,0,0,0,0,0,0
MIZORAM,2004,By Overdose of sleeping pills,0,0,0,0,0,0,0,0,0,0,0,0,0
MIZORAM,2004,By touching electric wires,0,0,0,0,0,0,0,0,0,0,0,0,0
MIZORAM,2004,By coming under running vehicles/trains,0,0,0,0,0,0,0,0,0,0,0,0,0
MIZORAM,2004,By Other means (please specify),0,0,0,0,0,0,0,0,0,0,0,0,0
MIZORAM,2004,Total,0,29,17,7,0,53,0,6,1,0,0,7,60
MIZORAM,2004,Total (Poison),0,0,0,0,0,0,0,0,0,0,0,0,0
MIZORAM,2004,Total (Jumping),0,0,0,0,0,0,0,0,0,0,0,0,0
MIZORAM,2005,By Over Alcoholism,0,0,0,0,0,0,0,0,0,0,0,0,0
MIZORAM,2005,By Drowning,1,2,3,0,0,6,0,0,1,0,0,1,7
MIZORAM,2005,By Fire/Self Immolation,0,0,0,0,0,0,0,0,0,0,0,0,0
MIZORAM,2005,By Fire-Arms,0,0,2,0,0,2,0,0,0,0,0,0,2
MIZORAM,2005,By Hanging,0,12,7,0,0,19,0,1,1,0,0,2,21
MIZORAM,2005,By Consuming Insecticides,0,0,0,0,0,0,0,0,0,0,0,0,0
MIZORAM,2005,By Consuming Other Poison,0,0,0,0,0,0,0,0,0,0,0,0,0
MIZORAM,2005,By Self Infliction of injury,0,0,0,0,0,0,0,0,0,0,0,0,0
MIZORAM,2005,By Jumping from (Building),0,0,0,0,0,0,0,0,0,0,0,0,0
MIZORAM,2005,By Jumping from (Other sites),0,0,0,0,0,0,0,0,0,0,0,0,0
MIZORAM,2005,By Jumping off Moving Vehicles/Trains,0,1,0,0,0,1,0,0,0,0,0,0,1
MIZORAM,2005,By Machine,0,1,0,0,0,1,0,0,0,0,0,0,1
MIZORAM,2005,By Overdose of sleeping pills,0,0,0,0,0,0,0,0,0,0,0,0,0
MIZORAM,2005,By touching electric wires,0,0,0,0,0,0,0,0,0,0,0,0,0
MIZORAM,2005,By coming under running vehicles/trains,0,0,0,0,0,0,0,0,0,0,0,0,0
MIZORAM,2005,By Other means (please specify),1,3,8,4,2,18,0,2,2,1,0,5,23
MIZORAM,2005,Total,2,19,20,4,2,47,0,3,4,1,0,8,55
MIZORAM,2005,Total (Poison),0,0,0,0,0,0,0,0,0,0,0,0,0
MIZORAM,2005,Total (Jumping),0,0,0,0,0,0,0,0,0,0,0,0,0
MIZORAM,2006,By Over Alcoholism,0,0,0,0,0,0,0,0,0,0,0,0,0
MIZORAM,2006,By Drowning,0,2,1,0,0,3,0,0,0,0,0,0,3
MIZORAM,2006,By Fire/Self Immolation,0,0,0,0,0,0,0,0,0,0,0,0,0
MIZORAM,2006,By Fire-Arms,0,0,0,0,0,0,0,0,0,0,0,0,0
MIZORAM,2006,By Hanging,0,20,14,2,4,40,0,2,2,3,0,7,47
MIZORAM,2006,By Consuming Insecticides,0,0,0,0,0,0,0,0,0,0,0,0,0
MIZORAM,2006,By Consuming Other Poison,0,0,0,0,0,0,0,0,0,0,0,0,0
MIZORAM,2006,By Self Infliction of injury,0,0,0,0,0,0,0,0,0,0,0,0,0
MIZORAM,2006,By Jumping from (Building),0,0,0,0,0,0,0,0,0,0,0,0,0
MIZORAM,2006,By Jumping from (Other sites),0,0,0,0,0,0,0,0,0,0,0,0,0
MIZORAM,2006,By Jumping off Moving Vehicles/Trains,0,0,0,0,0,0,0,0,0,0,0,0,0
MIZORAM,2006,By Machine,0,0,0,0,0,0,0,0,0,0,0,0,0
MIZORAM,2006,By Overdose of sleeping pills,0,0,0,0,0,0,0,0,0,0,0,0,0
MIZORAM,2006,By touching electric wires,0,0,0,0,0,0,0,0,0,0,0,0,0
MIZORAM,2006,By coming under running vehicles/trains,0,0,0,0,0,0,0,0,0,0,0,0,0
MIZORAM,2006,By Other means (please specify),0,9,7,1,0,17,0,3,0,0,0,3,20
MIZORAM,2006,Total,0,31,22,3,4,60,0,5,2,3,0,10,70
MIZORAM,2006,Total (Poison),0,0,0,0,0,0,0,0,0,0,0,0,0
MIZORAM,2006,Total (Jumping),0,0,0,0,0,0,0,0,0,0,0,0,0
MIZORAM,2007,By Over Alcoholism,0,0,0,0,0,0,0,0,0,0,0,0,0
MIZORAM,2007,By Drowning,0,0,0,0,0,0,0,0,0,0,0,0,0
MIZORAM,2007,By Fire/Self Immolation,0,0,0,0,0,0,0,0,0,0,0,0,0
MIZORAM,2007,By Fire-Arms,0,1,0,0,0,1,0,0,0,0,0,0,1
MIZORAM,2007,By Hanging,1,8,7,2,2,20,0,1,2,2,0,5,25
MIZORAM,2007,By Consuming Insecticides,0,0,0,0,0,0,0,0,0,0,0,0,0
MIZORAM,2007,By Consuming Other Poison,0,0,0,0,0,0,0,0,0,0,0,0,0
MIZORAM,2007,By Self Infliction of injury,0,0,0,0,0,0,0,0,0,0,0,0,0
MIZORAM,2007,By Jumping from (Building),0,0,0,0,0,0,0,0,0,0,0,0,0
MIZORAM,2007,By Jumping from (Other sites),0,0,1,0,0,1,0,0,0,0,0,0,1
MIZORAM,2007,By Jumping off Moving Vehicles/Trains,0,0,0,0,0,0,0,0,0,0,0,0,0
MIZORAM,2007,By Machine,0,0,0,0,0,0,0,0,0,0,0,0,0
MIZORAM,2007,By Overdose of sleeping pills,0,0,0,0,0,0,0,0,0,0,0,0,0
MIZORAM,2007,By touching electric wires,0,0,0,0,0,0,0,0,0,0,0,0,0
MIZORAM,2007,By coming under running vehicles/trains,0,0,0,0,0,0,0,0,0,0,0,0,0
MIZORAM,2007,By Other means (please specify),0,0,0,0,0,0,0,0,1,0,0,1,1
MIZORAM,2007,Total,1,9,8,2,2,22,0,1,3,2,0,6,28
MIZORAM,2007,Total (Poison),0,0,0,0,0,0,0,0,0,0,0,0,0
MIZORAM,2007,Total (Jumping),0,0,1,0,0,1,0,0,0,0,0,0,1
MIZORAM,2008,By Over Alcoholism,0,0,0,0,0,0,0,0,0,0,0,0,0
MIZORAM,2008,By Drowning,0,0,0,0,0,0,0,1,1,0,0,2,2
MIZORAM,2008,By Fire/Self Immolation,0,0,0,0,0,0,0,0,0,0,0,0,0
MIZORAM,2008,By Fire-Arms,0,2,0,0,0,2,0,0,0,0,0,0,2
MIZORAM,2008,By Hanging,0,5,13,7,0,25,0,1,2,1,0,4,29
MIZORAM,2008,By Consuming Insecticides,0,0,0,0,0,0,0,0,0,0,0,0,0
MIZORAM,2008,By Consuming Other Poison,0,0,0,0,0,0,0,0,0,0,0,0,0
MIZORAM,2008,By Self Infliction of injury,0,0,0,0,0,0,0,0,0,0,0,0,0
MIZORAM,2008,By Jumping from (Building),0,0,0,0,0,0,0,0,0,0,0,0,0
MIZORAM,2008,By Jumping from (Other sites),0,0,0,0,0,0,0,0,0,0,0,0,0
MIZORAM,2008,By Jumping off Moving Vehicles/Trains,0,0,0,0,0,0,0,0,0,0,0,0,0
MIZORAM,2008,By Machine,0,2,0,0,0,2,0,0,0,0,0,0,2
MIZORAM,2008,By Overdose of sleeping pills,0,0,0,0,0,0,0,0,0,0,0,0,0
MIZORAM,2008,By touching electric wires,0,1,0,0,0,1,0,0,0,0,0,0,1
MIZORAM,2008,By coming under running vehicles/trains,0,0,0,0,0,0,0,0,0,0,0,0,0
MIZORAM,2008,By Other means (please specify),0,2,3,0,0,5,0,0,0,0,0,0,5
MIZORAM,2008,Total,0,12,16,7,0,35,0,2,3,1,0,6,41
MIZORAM,2008,Total (Poison),0,0,0,0,0,0,0,0,0,0,0,0,0
MIZORAM,2008,Total (Jumping),0,0,0,0,0,0,0,0,0,0,0,0,0
MIZORAM,2009,By Over Alcoholism,0,0,0,0,0,0,0,0,0,0,0,0,0
MIZORAM,2009,By Drowning,0,6,3,0,0,9,0,0,0,0,0,0,9
MIZORAM,2009,By Fire/Self Immolation,0,0,0,0,0,0,0,0,0,0,0,0,0
MIZORAM,2009,By Fire-Arms,0,0,1,0,0,1,0,0,0,0,0,0,1
MIZORAM,2009,By Hanging,1,23,11,3,1,39,0,2,2,2,0,6,45
MIZORAM,2009,By Consuming Insecticides,0,0,0,0,0,0,0,0,0,0,0,0,0
MIZORAM,2009,By Consuming Other Poison,0,0,0,0,0,0,0,0,0,0,0,0,0
MIZORAM,2009,By Self Infliction of injury,0,1,0,0,0,1,0,0,0,0,0,0,1
MIZORAM,2009,By Jumping from (Building),0,0,1,0,0,1,0,0,0,0,0,0,1
MIZORAM,2009,By Jumping from (Other sites),0,1,1,0,0,2,0,1,0,0,0,1,3
MIZORAM,2009,By Jumping off Moving Vehicles/Trains,0,0,0,0,0,0,0,0,0,0,0,0,0
MIZORAM,2009,By Machine,0,0,0,0,0,0,0,0,0,0,0,0,0
MIZORAM,2009,By Overdose of sleeping pills,0,0,0,0,0,0,0,0,0,0,0,0,0
MIZORAM,2009,By touching electric wires,0,0,0,0,0,0,0,0,0,0,0,0,0
MIZORAM,2009,By coming under running vehicles/trains,0,0,0,0,0,0,0,0,0,0,0,0,0
MIZORAM,2009,By Other means (please specify),0,0,8,1,0,9,0,0,0,0,0,0,9
MIZORAM,2009,Total,1,31,25,4,1,62,0,3,2,2,0,7,69
MIZORAM,2009,Total (Poison),0,1,0,0,0,1,0,0,0,0,0,0,1
MIZORAM,2009,Total (Jumping),0,1,2,0,0,3,0,1,0,0,0,1,4
MIZORAM,2010,By Over Alcoholism,0,0,0,0,0,0,0,0,0,0,0,0,0
MIZORAM,2010,By Drowning,0,2,0,0,0,2,0,0,0,0,0,0,2
MIZORAM,2010,By Fire/Self Immolation,0,0,2,0,0,2,0,0,1,0,0,1,3
MIZORAM,2010,By Fire-Arms,0,0,0,0,0,0,0,0,0,0,0,0,0
MIZORAM,2010,By Hanging,4,23,21,6,2,56,0,5,0,0,0,5,61
MIZORAM,2010,By Consuming Insecticides,0,0,0,0,0,0,0,0,0,0,0,0,0
MIZORAM,2010,By Consuming Other Poison,0,0,0,0,0,0,0,3,0,0,0,3,3
MIZORAM,2010,By Self Infliction of injury,0,0,1,0,0,1,0,0,0,0,0,0,1
MIZORAM,2010,By Jumping from (Building),0,0,0,0,0,0,0,0,0,0,0,0,0
MIZORAM,2010,By Jumping from (Other sites),0,0,0,0,0,0,0,0,0,0,0,0,0
MIZORAM,2010,By Jumping off Moving Vehicles/Trains,0,0,0,0,0,0,0,0,0,0,0,0,0
MIZORAM,2010,By Machine,0,0,0,0,0,0,0,0,0,0,0,0,0
MIZORAM,2010,By Overdose of sleeping pills,0,1,1,0,0,2,0,0,0,0,0,0,2
MIZORAM,2010,By touching electric wires,0,0,0,0,0,0,0,0,0,0,0,0,0
MIZORAM,2010,By coming under running vehicles/trains,0,0,0,0,0,0,0,0,0,0,0,0,0
MIZORAM,2010,By Other means (please specify),0,4,0,0,0,4,0,0,0,0,0,0,4
MIZORAM,2010,Total,4,30,25,6,2,67,0,8,1,0,0,9,76
MIZORAM,2010,Total (Poison),0,0,1,0,0,1,0,3,0,0,0,3,4
MIZORAM,2010,Total (Jumping),0,0,0,0,0,0,0,0,0,0,0,0,0
MIZORAM,2011,By Over Alcoholism,0,0,0,0,0,0,0,0,0,0,0,0,0
MIZORAM,2011,By Drowning,0,0,0,0,0,0,0,0,0,0,0,0,0
MIZORAM,2011,By Fire/Self Immolation,0,0,0,0,0,0,0,0,0,0,0,0,0
MIZORAM,2011,By Fire-Arms,0,0,1,1,0,2,0,0,0,0,0,0,2
MIZORAM,2011,By Hanging,2,37,27,6,2,74,0,5,6,2,0,13,87
MIZORAM,2011,By Consuming Insecticides,0,0,0,0,0,0,0,0,0,0,0,0,0
MIZORAM,2011,By Consuming Other Poison,0,0,0,0,0,0,0,0,0,0,0,0,0
MIZORAM,2011,By Self Infliction of injury,0,0,1,0,0,1,0,0,0,0,0,0,1
MIZORAM,2011,By Jumping from (Building),0,0,0,0,0,0,0,0,0,0,0,0,0
MIZORAM,2011,By Jumping from (Other sites),0,0,0,0,0,0,0,0,0,0,0,0,0
MIZORAM,2011,By Jumping off Moving Vehicles/Trains,0,0,0,0,0,0,0,0,0,0,0,0,0
MIZORAM,2011,By Machine,0,0,0,0,0,0,0,0,0,0,0,0,0
MIZORAM,2011,By Overdose of sleeping pills,0,0,0,0,0,0,0,0,0,0,0,0,0
MIZORAM,2011,By touching electric wires,0,0,0,0,0,0,0,0,0,0,0,0,0
MIZORAM,2011,By coming under running vehicles/trains,0,0,0,0,0,0,0,0,0,0,0,0,0
MIZORAM,2011,By Other means (please specify),0,0,0,0,0,0,0,0,0,0,0,0,0
MIZORAM,2011,Total,2,37,29,7,2,77,0,5,6,2,0,13,90
MIZORAM,2011,Total (Poison),0,0,1,0,0,1,0,0,0,0,0,0,1
MIZORAM,2011,Total (Jumping),0,0,0,0,0,0,0,0,0,0,0,0,0
MIZORAM,2012,By Over Alcoholism,1,0,0,0,0,1,0,0,0,0,0,0,1
MIZORAM,2012,By Drowning,0,3,2,2,0,7,0,1,0,0,0,1,8
MIZORAM,2012,By Fire/Self Immolation,0,2,0,1,0,3,0,0,0,0,0,0,3
MIZORAM,2012,By Fire-Arms,0,0,1,2,0,3,0,0,0,0,0,0,3
MIZORAM,2012,By Hanging,1,45,33,3,3,85,3,4,0,2,0,9,94
MIZORAM,2012,By Consuming Insecticides,0,0,0,0,0,0,0,0,0,0,0,0,0
MIZORAM,2012,By Consuming Other Poison,0,0,0,0,0,0,0,0,0,0,0,0,0
MIZORAM,2012,By Self Infliction of injury,0,0,0,0,0,0,0,0,0,0,0,0,0
MIZORAM,2012,By Jumping from (Building),0,2,0,2,0,4,0,0,0,0,0,0,4
MIZORAM,2012,By Jumping from (Other sites),3,10,0,2,0,15,0,0,0,2,0,2,17
MIZORAM,2012,By Jumping off Moving Vehicles/Trains,0,0,0,0,0,0,0,0,0,0,0,0,0
MIZORAM,2012,By Machine,0,0,0,0,3,3,0,0,0,0,0,0,3
MIZORAM,2012,By Overdose of sleeping pills,0,0,0,0,0,0,0,0,0,0,0,0,0
MIZORAM,2012,By touching electric wires,2,1,1,3,2,9,0,2,0,0,0,2,11
MIZORAM,2012,By coming under running vehicles/trains,0,0,0,0,0,0,0,0,0,0,1,1,1
MIZORAM,2012,By Other means (please specify),0,7,20,0,0,27,0,0,1,0,0,1,28
MIZORAM,2012,Total,7,70,57,15,8,157,3,7,1,4,1,16,173
MIZORAM,2012,Total (Poison),0,0,0,0,0,0,0,0,0,0,0,0,0
MIZORAM,2012,Total (Jumping),3,12,0,4,0,19,0,0,0,2,0,2,21
NAGALAND,2001,By Over Alcoholism,0,0,0,0,0,0,0,0,0,0,0,0,0
NAGALAND,2001,By Drowning,0,2,2,0,0,4,0,0,0,0,0,0,4
NAGALAND,2001,By Fire/Self Immolation,0,0,0,0,0,0,0,0,0,0,0,0,0
NAGALAND,2001,By Fire-Arms,0,0,1,0,0,1,0,0,0,0,0,0,1
NAGALAND,2001,By Hanging,0,3,8,1,0,12,0,6,1,0,0,7,19
NAGALAND,2001,By Consuming Insecticides,0,0,0,0,0,0,0,0,0,0,0,0,0
NAGALAND,2001,By Consuming Other Poison,0,0,0,0,0,0,0,0,0,0,0,0,0
NAGALAND,2001,By Self Infliction of injury,0,0,0,0,0,0,0,0,0,0,0,0,0
NAGALAND,2001,By Jumping from (Building),0,0,0,0,0,0,0,0,0,0,0,0,0
NAGALAND,2001,By Jumping from (Other sites),0,0,0,0,0,0,0,0,0,0,0,0,0
NAGALAND,2001,By Jumping off Moving Vehicles/Trains,0,1,0,0,0,1,0,0,0,0,0,0,1
NAGALAND,2001,By Machine,0,0,0,0,0,0,0,0,0,0,0,0,0
NAGALAND,2001,By Overdose of sleeping pills,0,0,2,0,0,2,0,0,0,0,0,0,2
NAGALAND,2001,By touching electric wires,0,0,0,0,0,0,0,0,0,0,0,0,0
NAGALAND,2001,By coming under running vehicles/trains,0,0,0,0,0,0,0,0,0,0,0,0,0
NAGALAND,2001,By Other means (please specify),0,2,2,1,0,5,0,1,4,3,0,8,13
NAGALAND,2001,Total,0,8,15,2,0,25,0,7,5,3,0,15,40
NAGALAND,2001,Total (Poison),0,0,0,0,0,0,0,0,0,0,0,0,0
NAGALAND,2001,Total (Jumping),0,0,0,0,0,0,0,0,0,0,0,0,0
NAGALAND,2002,By Over Alcoholism,0,0,0,0,0,0,0,0,0,0,0,0,0
NAGALAND,2002,By Drowning,0,0,1,1,0,2,1,0,0,0,0,1,3
NAGALAND,2002,By Fire/Self Immolation,0,0,0,0,0,0,0,0,1,0,0,1,1
NAGALAND,2002,By Fire-Arms,0,0,0,0,0,0,0,0,0,0,0,0,0
NAGALAND,2002,By Hanging,0,0,6,0,0,6,1,1,0,0,0,2,8
NAGALAND,2002,By Consuming Insecticides,0,0,0,0,0,0,0,0,0,0,0,0,0
NAGALAND,2002,By Consuming Other Poison,0,0,0,0,0,0,0,1,0,0,0,1,1
NAGALAND,2002,By Self Infliction of injury,0,0,0,0,0,0,0,0,0,0,0,0,0
NAGALAND,2002,By Jumping from (Building),0,0,0,0,0,0,0,0,0,0,0,0,0
NAGALAND,2002,By Jumping from (Other sites),0,0,0,0,0,0,0,0,0,0,0,0,0
NAGALAND,2002,By Jumping off Moving Vehicles/Trains,1,0,2,0,0,3,0,0,0,0,0,0,3
NAGALAND,2002,By Machine,0,0,0,0,0,0,0,0,0,0,0,0,0
NAGALAND,2002,By Overdose of sleeping pills,0,0,0,0,0,0,0,0,0,0,0,0,0
NAGALAND,2002,By touching electric wires,0,0,1,0,0,1,0,0,0,0,0,0,1
NAGALAND,2002,By coming under running vehicles/trains,0,0,0,0,0,0,0,0,0,0,0,0,0
NAGALAND,2002,By Other means,0,2,5,0,0,7,0,1,2,0,0,3,10
NAGALAND,2002,Total,1,2,15,1,0,19,2,3,3,0,0,8,27
NAGALAND,2002,Total (Poison),0,0,0,0,0,0,0,1,0,0,0,1,1
NAGALAND,2002,Total (Jumping),0,0,0,0,0,0,0,0,0,0,0,0,0
NAGALAND,2003,By Over Alcoholism,0,0,0,0,0,0,0,0,0,0,0,0,0
NAGALAND,2003,By Drowning,0,0,0,0,0,0,0,0,0,0,0,0,0
NAGALAND,2003,By Fire/Self Immolation,0,0,2,0,0,2,0,0,0,0,0,0,2
NAGALAND,2003,By Fire-Arms,0,0,0,0,0,0,0,1,0,0,0,1,1
NAGALAND,2003,By Hanging,0,4,4,0,0,8,0,4,0,0,0,4,12
NAGALAND,2003,By Consuming Insecticides,0,0,0,0,0,0,0,0,0,0,0,0,0
NAGALAND,2003,By Consuming Other Poison,0,0,0,0,0,0,0,0,0,0,0,0,0
NAGALAND,2003,By Self Infliction of injury,0,0,0,0,0,0,0,0,0,0,0,0,0
NAGALAND,2003,By Jumping from (Building),0,0,0,0,0,0,0,0,0,0,0,0,0
NAGALAND,2003,By Jumping from (Other sites),0,0,0,0,0,0,0,0,0,0,0,0,0
NAGALAND,2003,By Jumping off Moving Vehicles/Trains,0,0,0,0,0,0,0,0,0,0,0,0,0
NAGALAND,2003,By Machine,0,0,0,0,0,0,0,0,0,0,0,0,0
NAGALAND,2003,By Overdose of sleeping pills,0,0,1,0,0,1,0,0,0,0,0,0,1
NAGALAND,2003,By touching electric wires,0,0,0,0,0,0,0,0,0,0,0,0,0
NAGALAND,2003,By coming under running vehicles/trains,0,0,0,0,0,0,0,0,0,0,0,0,0
NAGALAND,2003,By Other means (please specify),0,2,4,0,0,6,0,0,0,0,0,0,6
NAGALAND,2003,Total,0,6,11,0,0,17,0,5,0,0,0,5,22
NAGALAND,2003,Total (Poison),0,0,0,0,0,0,0,0,0,0,0,0,0
NAGALAND,2003,Total (Jumping),0,0,0,0,0,0,0,0,0,0,0,0,0
NAGALAND,2004,By Over Alcoholism,0,0,0,0,0,0,0,0,0,0,0,0,0
NAGALAND,2004,By Drowning,0,0,1,0,0,1,0,0,0,0,0,0,1
NAGALAND,2004,By Fire/Self Immolation,0,0,0,0,0,0,0,0,0,0,0,0,0
NAGALAND,2004,By Fire-Arms,0,0,2,0,0,2,0,1,0,0,0,1,3
NAGALAND,2004,By Hanging,0,2,3,0,0,5,0,3,0,0,0,3,8
NAGALAND,2004,By Consuming Insecticides,0,1,0,0,0,1,0,0,0,0,0,0,1
NAGALAND,2004,By Consuming Other Poison,0,0,1,0,0,1,0,0,0,0,0,0,1
NAGALAND,2004,By Self Infliction of injury,0,0,0,0,0,0,0,0,0,0,0,0,0
NAGALAND,2004,By Jumping from (Building),0,0,0,0,0,0,0,0,1,0,0,1,1
NAGALAND,2004,By Jumping from (Other sites),0,0,0,0,0,0,0,0,0,0,0,0,0
NAGALAND,2004,By Jumping off Moving Vehicles/Trains,0,0,0,0,0,0,0,0,0,0,0,0,0
NAGALAND,2004,By Machine,0,0,0,0,0,0,0,0,0,0,0,0,0
NAGALAND,2004,By Overdose of sleeping pills,0,1,0,0,0,1,0,0,0,0,0,0,1
NAGALAND,2004,By touching electric wires,0,0,3,0,0,3,0,0,0,0,0,0,3
NAGALAND,2004,By coming under running vehicles/trains,0,0,0,0,0,0,0,0,0,0,0,0,0
NAGALAND,2004,By Other means (please specify),0,6,3,2,0,11,0,0,1,0,0,1,12
NAGALAND,2004,Total,0,10,13,2,0,25,0,4,2,0,0,6,31
NAGALAND,2004,Total (Poison),0,1,1,0,0,2,0,0,0,0,0,0,2
NAGALAND,2004,Total (Jumping),0,0,0,0,0,0,0,0,1,0,0,1,1
NAGALAND,2005,By Over Alcoholism,0,0,0,0,0,0,0,0,0,0,0,0,0
NAGALAND,2005,By Drowning,0,0,0,0,0,0,0,0,0,0,0,0,0
NAGALAND,2005,By Fire/Self Immolation,0,0,0,0,0,0,0,0,0,0,0,0,0
NAGALAND,2005,By Fire-Arms,0,1,0,0,0,1,0,1,0,0,0,1,2
NAGALAND,2005,By Hanging,0,3,9,2,0,14,0,1,2,0,0,3,17
NAGALAND,2005,By Consuming Insecticides,0,0,0,0,0,0,0,0,0,0,0,0,0
NAGALAND,2005,By Consuming Other Poison,0,0,0,0,0,0,0,0,0,0,0,0,0
NAGALAND,2005,By Self Infliction of injury,0,0,1,0,0,1,0,0,0,0,0,0,1
NAGALAND,2005,By Jumping from (Building),0,0,0,0,0,0,0,0,0,0,0,0,0
NAGALAND,2005,By Jumping from (Other sites),0,0,0,0,0,0,0,0,0,0,0,0,0
NAGALAND,2005,By Jumping off Moving Vehicles/Trains,0,0,0,0,0,0,0,0,0,0,0,0,0
NAGALAND,2005,By Machine,0,0,0,0,0,0,0,0,0,0,0,0,0
NAGALAND,2005,By Overdose of sleeping pills,0,0,0,0,0,0,0,0,0,0,0,0,0
NAGALAND,2005,By touching electric wires,0,0,0,0,0,0,0,0,0,0,0,0,0
NAGALAND,2005,By coming under running vehicles/trains,0,0,0,0,0,0,0,0,0,0,0,0,0
NAGALAND,2005,By Other means (please specify),0,0,3,2,0,5,0,1,1,0,0,2,7
NAGALAND,2005,Total,0,4,13,4,0,21,0,3,3,0,0,6,27
NAGALAND,2005,Total (Poison),0,0,1,0,0,1,0,0,0,0,0,0,1
NAGALAND,2005,Total (Jumping),0,0,0,0,0,0,0,0,0,0,0,0,0
NAGALAND,2006,By Over Alcoholism,0,1,0,0,0,1,0,0,0,0,0,0,1
NAGALAND,2006,By Drowning,0,0,0,1,0,1,0,0,0,1,0,1,2
NAGALAND,2006,By Fire/Self Immolation,0,0,0,0,0,0,0,0,0,0,0,0,0
NAGALAND,2006,By Fire-Arms,0,2,2,0,0,4,0,0,0,0,0,0,4
NAGALAND,2006,By Hanging,1,3,3,2,0,9,0,2,2,0,0,4,13
NAGALAND,2006,By Consuming Insecticides,0,0,0,0,0,0,0,0,0,0,0,0,0
NAGALAND,2006,By Consuming Other Poison,0,1,0,0,0,1,0,0,1,0,0,1,2
NAGALAND,2006,By Self Infliction of injury,0,0,0,0,0,0,0,0,0,0,0,0,0
NAGALAND,2006,By Jumping from (Building),0,0,0,0,0,0,0,0,0,0,0,0,0
NAGALAND,2006,By Jumping from (Other sites),0,0,0,0,0,0,0,0,0,0,0,0,0
NAGALAND,2006,By Jumping off Moving Vehicles/Trains,0,1,0,0,0,1,0,0,0,0,0,0,1
NAGALAND,2006,By Machine,0,0,0,0,0,0,0,0,0,0,0,0,0
NAGALAND,2006,By Overdose of sleeping pills,0,0,0,0,0,0,0,0,0,0,0,0,0
NAGALAND,2006,By touching electric wires,0,0,0,0,0,0,0,0,0,0,0,0,0
NAGALAND,2006,By coming under running vehicles/trains,0,0,0,0,0,0,0,0,1,0,0,1,1
NAGALAND,2006,By Other means (please specify),0,1,1,0,0,2,0,2,0,0,0,2,4
NAGALAND,2006,Total,1,9,6,3,0,19,0,4,4,1,0,9,28
NAGALAND,2006,Total (Poison),0,1,0,0,0,1,0,0,1,0,0,1,2
NAGALAND,2006,Total (Jumping),0,0,0,0,0,0,0,0,0,0,0,0,0
NAGALAND,2007,By Over Alcoholism,0,0,0,0,0,0,0,0,0,0,0,0,0
NAGALAND,2007,By Drowning,0,0,0,0,0,0,0,0,0,0,0,0,0
NAGALAND,2007,By Fire/Self Immolation,0,0,0,0,0,0,0,1,1,0,0,2,2
NAGALAND,2007,By Fire-Arms,0,0,2,0,0,2,0,0,0,0,0,0,2
NAGALAND,2007,By Hanging,0,4,2,5,0,11,0,2,2,0,0,4,15
NAGALAND,2007,By Consuming Insecticides,0,0,0,0,0,0,0,0,0,0,0,0,0
NAGALAND,2007,By Consuming Other Poison,0,0,1,0,0,1,0,0,0,0,0,0,1
NAGALAND,2007,By Self Infliction of injury,0,0,0,0,0,0,0,0,0,0,0,0,0
NAGALAND,2007,By Jumping from (Building),0,0,0,0,0,0,0,0,0,0,0,0,0
NAGALAND,2007,By Jumping from (Other sites),0,0,0,0,0,0,0,0,0,0,0,0,0
NAGALAND,2007,By Jumping off Moving Vehicles/Trains,0,0,1,0,0,1,0,0,0,0,0,0,1
NAGALAND,2007,By Machine,0,0,0,0,0,0,0,0,0,0,0,0,0
NAGALAND,2007,By Overdose of sleeping pills,0,0,1,0,0,1,0,0,1,0,0,1,2
NAGALAND,2007,By touching electric wires,0,0,0,0,0,0,0,0,0,0,0,0,0
NAGALAND,2007,By coming under running vehicles/trains,0,0,0,0,0,0,0,0,0,0,0,0,0
NAGALAND,2007,By Other means (please specify),0,0,1,0,0,1,0,0,0,0,0,0,1
NAGALAND,2007,Total,0,4,8,5,0,17,0,3,4,0,0,7,24
NAGALAND,2007,Total (Poison),0,0,1,0,0,1,0,0,0,0,0,0,1
NAGALAND,2007,Total (Jumping),0,0,0,0,0,0,0,0,0,0,0,0,0
NAGALAND,2008,By Over Alcoholism,0,0,0,0,0,0,0,0,0,0,0,0,0
NAGALAND,2008,By Drowning,0,0,0,0,0,0,0,0,0,0,0,0,0
NAGALAND,2008,By Fire/Self Immolation,0,0,2,0,0,2,0,1,2,0,0,3,5
NAGALAND,2008,By Fire-Arms,0,0,4,0,0,4,0,1,0,0,0,1,5
NAGALAND,2008,By Hanging,0,0,10,10,0,20,0,4,0,0,0,4,24
NAGALAND,2008,By Consuming Insecticides,0,0,0,0,0,0,0,0,0,0,0,0,0
NAGALAND,2008,By Consuming Other Poison,0,2,2,0,0,4,0,2,0,0,0,2,6
NAGALAND,2008,By Self Infliction of injury,0,0,0,0,0,0,0,0,0,0,0,0,0
NAGALAND,2008,By Jumping from (Building),0,0,0,0,0,0,0,0,0,0,0,0,0
NAGALAND,2008,By Jumping from (Other sites),0,0,0,0,0,0,0,0,0,0,0,0,0
NAGALAND,2008,By Jumping off Moving Vehicles/Trains,0,0,0,0,0,0,0,0,0,0,0,0,0
NAGALAND,2008,By Machine,0,0,0,0,0,0,0,0,0,0,0,0,0
NAGALAND,2008,By Overdose of sleeping pills,0,0,2,0,0,2,0,0,0,0,0,0,2
NAGALAND,2008,By touching electric wires,0,0,0,0,0,0,0,0,0,0,0,0,0
NAGALAND,2008,By coming under running vehicles/trains,0,0,0,0,0,0,0,0,0,0,0,0,0
NAGALAND,2008,By Other means (please specify),0,0,0,0,0,0,0,0,0,0,0,0,0
NAGALAND,2008,Total,0,2,20,10,0,32,0,8,2,0,0,10,42
NAGALAND,2008,Total (Poison),0,2,2,0,0,4,0,2,0,0,0,2,6
NAGALAND,2008,Total (Jumping),0,0,0,0,0,0,0,0,0,0,0,0,0
NAGALAND,2009,By Over Alcoholism,0,1,0,0,0,1,0,0,0,0,0,0,1
NAGALAND,2009,By Drowning,0,0,0,0,0,0,0,0,0,0,0,0,0
NAGALAND,2009,By Fire/Self Immolation,0,0,0,0,0,0,0,0,0,0,0,0,0
NAGALAND,2009,By Fire-Arms,0,0,1,1,0,2,0,0,0,0,0,0,2
NAGALAND,2009,By Hanging,2,8,3,3,0,16,0,3,2,0,0,5,21
NAGALAND,2009,By Consuming Insecticides,0,0,0,0,0,0,0,0,0,0,0,0,0
NAGALAND,2009,By Consuming Other Poison,0,0,2,0,0,2,0,0,0,0,0,0,2
NAGALAND,2009,By Self Infliction of injury,0,1,0,0,0,1,0,0,0,0,0,0,1
NAGALAND,2009,By Jumping from (Building),0,0,0,0,0,0,0,0,0,0,0,0,0
NAGALAND,2009,By Jumping from (Other sites),0,0,0,0,0,0,0,0,0,0,0,0,0
NAGALAND,2009,By Jumping off Moving Vehicles/Trains,0,0,0,0,0,0,0,0,0,0,0,0,0
NAGALAND,2009,By Machine,0,0,0,0,0,0,0,0,0,0,0,0,0
NAGALAND,2009,By Overdose of sleeping pills,0,0,1,0,0,1,0,0,0,0,0,0,1
NAGALAND,2009,By touching electric wires,0,0,0,0,0,0,0,0,0,0,0,0,0
NAGALAND,2009,By coming under running vehicles/trains,0,0,0,0,0,0,0,1,0,0,0,1,1
NAGALAND,2009,By Other means (please specify),0,2,0,0,0,2,0,0,0,0,0,0,2
NAGALAND,2009,Total,2,12,7,4,0,25,0,4,2,0,0,6,31
NAGALAND,2009,Total (Poison),0,1,2,0,0,3,0,0,0,0,0,0,3
NAGALAND,2009,Total (Jumping),0,0,0,0,0,0,0,0,0,0,0,0,0
NAGALAND,2010,By Over Alcoholism,0,3,2,0,0,5,0,0,0,0,0,0,5
NAGALAND,2010,By Drowning,0,0,0,0,0,0,0,0,0,0,0,0,0
NAGALAND,2010,By Fire/Self Immolation,0,0,0,0,0,0,0,0,0,0,0,0,0
NAGALAND,2010,By Fire-Arms,0,0,0,0,0,0,0,0,0,0,0,0,0
NAGALAND,2010,By Hanging,0,1,4,1,0,6,0,1,0,0,0,1,7
NAGALAND,2010,By Consuming Insecticides,0,0,0,0,0,0,0,0,0,0,0,0,0
NAGALAND,2010,By Consuming Other Poison,0,0,0,0,0,0,0,0,0,0,0,0,0
NAGALAND,2010,By Self Infliction of injury,0,0,0,0,0,0,0,0,0,0,0,0,0
NAGALAND,2010,By Jumping from (Building),0,0,0,0,0,0,0,0,0,0,0,0,0
NAGALAND,2010,By Jumping from (Other sites),0,0,0,0,0,0,0,0,0,0,0,0,0
NAGALAND,2010,By Jumping off Moving Vehicles/Trains,0,0,0,0,0,0,0,0,0,0,0,0,0
NAGALAND,2010,By Machine,0,0,0,0,0,0,0,0,0,0,0,0,0
NAGALAND,2010,By Overdose of sleeping pills,0,0,0,0,0,0,0,0,0,0,0,0,0
NAGALAND,2010,By touching electric wires,0,0,0,0,0,0,0,0,0,0,0,0,0
NAGALAND,2010,By coming under running vehicles/trains,0,0,0,0,0,0,0,0,0,0,0,0,0
NAGALAND,2010,By Other means (please specify),0,0,0,0,0,0,0,0,0,0,0,0,0
NAGALAND,2010,Total,0,4,6,1,0,11,0,1,0,0,0,1,12
NAGALAND,2010,Total (Poison),0,0,0,0,0,0,0,0,0,0,0,0,0
NAGALAND,2010,Total (Jumping),0,0,0,0,0,0,0,0,0,0,0,0,0
NAGALAND,2011,By Over Alcoholism,0,0,0,0,0,0,0,0,0,0,0,0,0
NAGALAND,2011,By Drowning,0,0,0,0,0,0,0,0,0,0,0,0,0
NAGALAND,2011,By Fire/Self Immolation,0,0,0,0,0,0,0,0,0,0,0,0,0
NAGALAND,2011,By Fire-Arms,0,0,3,0,0,3,0,0,0,0,0,0,3
NAGALAND,2011,By Hanging,0,5,8,8,0,21,0,6,2,0,0,8,29
NAGALAND,2011,By Consuming Insecticides,0,0,0,0,0,0,0,0,0,0,0,0,0
NAGALAND,2011,By Consuming Other Poison,0,0,0,0,0,0,0,0,0,0,0,0,0
NAGALAND,2011,By Self Infliction of injury,0,0,0,0,0,0,0,0,0,0,0,0,0
NAGALAND,2011,By Jumping from (Building),0,1,0,0,0,1,0,0,0,0,0,0,1
NAGALAND,2011,By Jumping from (Other sites),0,0,0,0,0,0,0,0,0,0,0,0,0
NAGALAND,2011,By Jumping off Moving Vehicles/Trains,0,0,0,0,0,0,0,0,0,0,0,0,0
NAGALAND,2011,By Machine,0,0,0,0,0,0,0,0,0,0,0,0,0
NAGALAND,2011,By Overdose of sleeping pills,0,0,0,0,0,0,0,0,0,0,0,0,0
NAGALAND,2011,By touching electric wires,0,0,0,0,0,0,0,0,0,0,0,0,0
NAGALAND,2011,By coming under running vehicles/trains,0,0,0,0,0,0,0,0,0,0,0,0,0
NAGALAND,2011,By Other means (please specify),0,0,0,0,0,0,0,0,0,0,0,0,0
NAGALAND,2011,Total,0,6,11,8,0,25,0,6,2,0,0,8,33
NAGALAND,2011,Total (Poison),0,0,0,0,0,0,0,0,0,0,0,0,0
NAGALAND,2011,Total (Jumping),0,1,0,0,0,1,0,0,0,0,0,0,1
NAGALAND,2012,By Over Alcoholism,0,0,0,0,0,0,0,0,0,0,0,0,0
NAGALAND,2012,By Drowning,0,0,0,0,0,0,0,0,0,0,0,0,0
NAGALAND,2012,By Fire/Self Immolation,0,0,0,0,0,0,0,0,0,0,0,0,0
NAGALAND,2012,By Fire-Arms,0,0,0,0,0,0,0,0,0,0,0,0,0
NAGALAND,2012,By Hanging,0,10,8,4,0,22,1,3,1,0,0,5,27
NAGALAND,2012,By Consuming Insecticides,0,0,0,0,0,0,0,0,0,0,0,0,0
NAGALAND,2012,By Consuming Other Poison,0,0,0,0,0,0,0,0,0,0,0,0,0
NAGALAND,2012,By Self Infliction of injury,0,0,0,1,0,1,0,0,0,0,0,0,1
NAGALAND,2012,By Jumping from (Building),0,0,0,0,0,0,0,0,0,0,0,0,0
NAGALAND,2012,By Jumping from (Other sites),0,0,0,0,0,0,0,1,0,0,0,1,1
NAGALAND,2012,By Jumping off Moving Vehicles/Trains,0,0,0,0,0,0,0,0,0,0,0,0,0
NAGALAND,2012,By Machine,0,0,0,0,0,0,0,0,0,0,0,0,0
NAGALAND,2012,By Overdose of sleeping pills,0,0,0,0,0,0,0,0,0,0,0,0,0
NAGALAND,2012,By touching electric wires,0,0,0,0,0,0,0,0,0,0,0,0,0
NAGALAND,2012,By coming under running vehicles/trains,0,0,0,0,0,0,0,0,0,0,0,0,0
NAGALAND,2012,By Other means (please specify),0,1,0,0,0,1,0,0,0,0,0,0,1
NAGALAND,2012,Total,0,11,8,5,0,24,1,4,1,0,0,6,30
NAGALAND,2012,Total (Poison),0,0,0,1,0,1,0,0,0,0,0,0,1
NAGALAND,2012,Total (Jumping),0,0,0,0,0,0,0,1,0,0,0,1,1
ODISHA,2001,By Over Alcoholism,0,0,2,1,1,4,0,0,0,0,0,0,4
ODISHA,2001,By Drowning,6,33,46,21,7,113,6,28,21,8,5,68,181
ODISHA,2001,By Fire/Self Immolation,2,3,4,1,0,10,0,20,10,4,0,34,44
ODISHA,2001,By Fire-Arms,2,2,0,1,0,5,0,2,4,0,1,7,12
ODISHA,2001,By Hanging,3,221,202,168,34,628,7,290,205,76,27,605,1233
ODISHA,2001,By Consuming Insecticides,9,144,134,75,12,374,14,204,105,46,7,376,750
ODISHA,2001,By Consuming Other Poison,2,118,129,80,25,354,5,185,176,67,15,448,802
ODISHA,2001,By Self Infliction of injury,1,0,0,0,0,1,1,1,0,0,0,2,3
ODISHA,2001,By Jumping from (Building),0,0,9,0,0,9,0,1,0,0,0,1,10
ODISHA,2001,By Jumping from (Other sites),2,12,24,13,4,55,5,6,13,3,2,29,84
ODISHA,2001,By Jumping off Moving Vehicles/Trains,0,1,0,0,0,1,0,0,0,0,0,0,1
ODISHA,2001,By Machine,0,0,0,0,0,0,0,0,0,0,0,0,0
ODISHA,2001,By Overdose of sleeping pills,0,2,0,0,1,3,0,1,0,0,2,3,6
ODISHA,2001,By touching electric wires,0,7,10,0,0,17,0,0,1,0,0,1,18
ODISHA,2001,By coming under running vehicles/trains,1,58,58,47,22,186,2,21,27,9,1,60,246
ODISHA,2001,By Other means (please specify),8,107,91,85,38,329,22,122,117,47,21,329,658
ODISHA,2001,Total,36,708,709,492,144,2089,62,881,679,260,81,1963,4052
ODISHA,2001,Total (Poison),12,262,263,155,37,729,20,390,281,113,22,826,1555
ODISHA,2001,Total (Jumping),2,12,33,13,4,64,5,7,13,3,2,30,94
ODISHA,2002,By Over Alcoholism,0,1,9,4,0,14,0,0,0,0,0,0,14
ODISHA,2002,By Drowning,6,17,31,27,2,83,7,11,11,8,2,39,122
ODISHA,2002,By Fire/Self Immolation,2,12,11,8,0,33,0,19,15,2,0,36,69
ODISHA,2002,By Fire-Arms,0,2,5,2,3,12,1,5,5,1,0,12,24
ODISHA,2002,By Hanging,8,216,258,151,43,676,12,226,194,87,22,541,1217
ODISHA,2002,By Consuming Insecticides,8,128,129,93,23,381,12,211,117,39,8,387,768
ODISHA,2002,By Consuming Other Poison,9,137,130,97,33,406,6,167,91,75,11,350,756
ODISHA,2002,By Self Infliction of injury,0,0,1,0,0,1,0,0,0,0,0,0,1
ODISHA,2002,By Jumping from (Building),0,1,2,0,3,6,0,1,0,7,2,10,16
ODISHA,2002,By Jumping from (Other sites),1,11,23,20,8,63,2,6,10,0,1,19,82
ODISHA,2002,By Jumping off Moving Vehicles/Trains,0,2,6,5,0,13,0,3,6,5,2,16,29
ODISHA,2002,By Machine,0,0,0,0,0,0,0,0,0,0,0,0,0
ODISHA,2002,By Overdose of sleeping pills,0,11,16,7,3,37,0,9,11,4,0,24,61
ODISHA,2002,By touching electric wires,0,5,16,9,2,32,0,5,4,0,0,9,41
ODISHA,2002,By coming under running vehicles/trains,3,65,48,27,15,158,0,13,16,12,2,43,201
ODISHA,2002,By Other means,18,244,260,164,30,716,29,107,86,26,23,271,987
ODISHA,2002,Total,55,852,945,614,165,2631,69,783,566,266,73,1757,4388
ODISHA,2002,Total (Poison),17,265,260,190,56,788,18,378,208,114,19,737,1525
ODISHA,2002,Total (Jumping),1,12,25,20,11,69,2,7,10,7,3,29,98
ODISHA,2003,By Over Alcoholism,4,4,9,6,0,23,2,0,11,4,0,17,40
ODISHA,2003,By Drowning,6,24,28,39,2,99,3,19,11,10,4,47,146
ODISHA,2003,By Fire/Self Immolation,1,6,13,10,0,30,0,23,40,25,1,89,119
ODISHA,2003,By Fire-Arms,0,16,15,15,1,47,2,16,14,1,0,33,80
ODISHA,2003,By Hanging,7,240,258,166,55,726,15,222,122,73,14,446,1172
ODISHA,2003,By Consuming Insecticides,7,258,184,113,18,580,5,233,140,82,10,470,1050
ODISHA,2003,By Consuming Other Poison,11,150,143,57,28,389,11,136,60,39,11,257,646
ODISHA,2003,By Self Infliction of injury,0,1,3,0,0,4,0,0,3,0,0,3,7
ODISHA,2003,By Jumping from (Building),0,1,0,1,0,2,0,9,0,6,0,15,17
ODISHA,2003,By Jumping from (Other sites),0,7,6,5,0,18,0,1,1,2,2,6,24
ODISHA,2003,By Jumping off Moving Vehicles/Trains,0,0,0,0,0,0,0,0,0,0,0,0,0
ODISHA,2003,By Machine,0,0,0,2,0,2,0,0,0,0,0,0,2
ODISHA,2003,By Overdose of sleeping pills,0,0,0,0,0,0,0,0,0,0,0,0,0
ODISHA,2003,By touching electric wires,1,9,17,16,6,49,1,2,1,1,0,5,54
ODISHA,2003,By coming under running vehicles/trains,0,46,61,40,17,164,1,15,19,10,6,51,215
ODISHA,2003,By Other means (please specify),30,164,172,191,50,607,6,126,61,28,20,241,848
ODISHA,2003,Total,67,926,909,661,177,2740,46,802,483,281,68,1680,4420
ODISHA,2003,Total (Poison),18,409,330,170,46,973,16,369,203,121,21,730,1703
ODISHA,2003,Total (Jumping),0,8,6,6,0,20,0,10,1,8,2,21,41
ODISHA,2004,By Over Alcoholism,0,3,4,7,1,15,0,0,0,0,0,0,15
ODISHA,2004,By Drowning,26,25,33,32,9,125,16,19,14,17,7,73,198
ODISHA,2004,By Fire/Self Immolation,0,9,21,17,7,54,0,27,11,13,6,57,111
ODISHA,2004,By Fire-Arms,0,0,1,0,0,1,0,1,0,1,0,2,3
ODISHA,2004,By Hanging,7,203,251,183,27,671,16,261,176,67,16,536,1207
ODISHA,2004,By Consuming Insecticides,15,190,207,116,42,570,21,228,132,33,29,443,1013
ODISHA,2004,By Consuming Other Poison,2,100,154,78,30,364,1,86,57,50,5,199,563
ODISHA,2004,By Self Infliction of injury,2,26,11,1,0,40,1,28,11,1,0,41,81
ODISHA,2004,By Jumping from (Building),0,4,0,1,0,5,0,0,0,0,0,0,5
ODISHA,2004,By Jumping from (Other sites),5,2,3,9,0,19,2,1,8,6,1,18,37
ODISHA,2004,By Jumping off Moving Vehicles/Trains,0,0,7,2,0,9,0,0,0,0,0,0,9
ODISHA,2004,By Machine,0,0,1,0,0,1,0,0,0,0,0,0,1
ODISHA,2004,By Overdose of sleeping pills,0,0,0,1,0,1,1,0,0,0,0,1,2
ODISHA,2004,By touching electric wires,0,16,18,11,0,45,1,2,2,0,0,5,50
ODISHA,2004,By coming under running vehicles/trains,4,62,79,36,18,199,0,19,29,12,4,64,263
ODISHA,2004,By Other means (please specify),23,107,114,122,59,425,20,113,56,27,16,232,657
ODISHA,2004,Total,84,747,904,616,193,2544,79,785,496,227,84,1671,4215
ODISHA,2004,Total (Poison),19,316,372,195,72,974,23,342,200,84,34,683,1657
ODISHA,2004,Total (Jumping),5,6,3,10,0,24,2,1,8,6,1,18,42
ODISHA,2005,By Over Alcoholism,0,0,3,4,2,9,0,0,0,0,1,1,10
ODISHA,2005,By Drowning,14,25,37,39,9,124,11,25,15,5,6,62,186
ODISHA,2005,By Fire/Self Immolation,0,9,24,8,6,47,3,28,16,8,7,62,109
ODISHA,2005,By Fire-Arms,0,0,0,0,0,0,0,0,1,0,0,1,1
ODISHA,2005,By Hanging,10,224,297,237,32,800,7,238,187,53,11,496,1296
ODISHA,2005,By Consuming Insecticides,15,277,253,219,97,861,21,259,224,124,28,656,1517
ODISHA,2005,By Consuming Other Poison,5,79,84,29,11,208,11,54,40,19,1,125,333
ODISHA,2005,By Self Infliction of injury,0,0,0,0,0,0,0,0,0,0,0,0,0
ODISHA,2005,By Jumping from (Building),0,2,4,0,0,6,0,2,13,4,0,19,25
ODISHA,2005,By Jumping from (Other sites),1,0,2,0,0,3,0,1,0,0,0,1,4
ODISHA,2005,By Jumping off Moving Vehicles/Trains,0,1,0,0,0,1,0,0,0,0,0,0,1
ODISHA,2005,By Machine,0,0,0,0,0,0,0,0,0,0,0,0,0
ODISHA,2005,By Overdose of sleeping pills,0,1,0,0,0,1,0,0,0,0,0,0,1
ODISHA,2005,By touching electric wires,3,6,7,3,1,20,1,5,3,5,0,14,34
ODISHA,2005,By coming under running vehicles/trains,0,48,69,20,35,172,2,18,18,16,14,68,240
ODISHA,2005,By Other means (please specify),10,54,139,59,40,302,4,56,55,29,5,149,451
ODISHA,2005,Total,58,726,919,618,233,2554,60,686,572,263,73,1654,4208
ODISHA,2005,Total (Poison),20,356,337,248,108,1069,32,313,264,143,29,781,1850
ODISHA,2005,Total (Jumping),1,2,6,0,0,9,0,3,13,4,0,20,29
ODISHA,2006,By Over Alcoholism,0,1,6,4,0,11,0,0,0,0,0,0,11
ODISHA,2006,By Drowning,8,18,11,6,13,56,10,22,24,7,8,71,127
ODISHA,2006,By Fire/Self Immolation,1,8,18,20,2,49,4,23,24,4,0,55,104
ODISHA,2006,By Fire-Arms,0,0,2,0,0,2,0,0,0,0,0,0,2
ODISHA,2006,By Hanging,8,204,274,147,45,678,5,264,165,52,12,498,1176
ODISHA,2006,By Consuming Insecticides,3,197,203,63,19,485,23,209,146,59,8,445,930
ODISHA,2006,By Consuming Other Poison,3,128,109,69,45,354,3,123,93,55,5,279,633
ODISHA,2006,By Self Infliction of injury,0,0,0,0,0,0,0,0,0,0,0,0,0
ODISHA,2006,By Jumping from (Building),0,0,0,0,1,1,0,0,0,0,0,0,1
ODISHA,2006,By Jumping from (Other sites),1,3,2,0,0,6,0,4,0,2,0,6,12
ODISHA,2006,By Jumping off Moving Vehicles/Trains,1,24,34,10,5,74,0,8,7,1,1,17,91
ODISHA,2006,By Machine,0,0,0,0,0,0,0,0,0,0,0,0,0
ODISHA,2006,By Overdose of sleeping pills,0,0,0,0,0,0,0,0,0,0,0,0,0
ODISHA,2006,By touching electric wires,0,10,4,2,2,18,0,3,1,0,1,5,23
ODISHA,2006,By coming under running vehicles/trains,2,28,50,24,20,124,0,12,15,11,13,51,175
ODISHA,2006,By Other means (please specify),16,120,157,148,74,515,14,79,90,56,26,265,780
ODISHA,2006,Total,43,741,870,493,226,2373,59,747,565,247,74,1692,4065
ODISHA,2006,Total (Poison),6,325,312,132,64,839,26,332,239,114,13,724,1563
ODISHA,2006,Total (Jumping),1,3,2,0,1,7,0,4,0,2,0,6,13
ODISHA,2007,By Over Alcoholism,0,0,2,1,0,3,0,0,0,0,0,0,3
ODISHA,2007,By Drowning,13,26,22,19,5,85,5,20,8,4,3,40,125
ODISHA,2007,By Fire/Self Immolation,0,4,12,10,3,29,1,18,21,8,0,48,77
ODISHA,2007,By Fire-Arms,0,3,0,0,0,3,0,2,1,0,1,4,7
ODISHA,2007,By Hanging,14,235,240,135,28,652,10,270,171,48,7,506,1158
ODISHA,2007,By Consuming Insecticides,10,238,233,149,92,722,25,344,142,60,21,592,1314
ODISHA,2007,By Consuming Other Poison,10,99,81,38,12,240,7,93,76,63,9,248,488
ODISHA,2007,By Self Infliction of injury,0,1,0,0,0,1,0,0,0,0,0,0,1
ODISHA,2007,By Jumping from (Building),0,1,0,0,0,1,0,1,0,0,0,1,2
ODISHA,2007,By Jumping from (Other sites),2,2,2,0,0,6,1,0,0,0,0,1,7
ODISHA,2007,By Jumping off Moving Vehicles/Trains,0,23,65,32,26,146,1,11,20,13,9,54,200
ODISHA,2007,By Machine,0,0,0,0,0,0,0,0,0,0,0,0,0
ODISHA,2007,By Overdose of sleeping pills,0,0,2,0,0,2,0,0,0,0,0,0,2
ODISHA,2007,By touching electric wires,1,8,4,2,0,15,0,1,1,0,0,2,17
ODISHA,2007,By coming under running vehicles/trains,0,14,21,9,4,48,0,2,4,1,1,8,56
ODISHA,2007,By Other means (please specify),27,122,164,146,76,535,20,116,112,46,22,316,851
ODISHA,2007,Total,77,776,848,541,246,2488,70,878,556,243,73,1820,4308
ODISHA,2007,Total (Poison),20,338,314,187,104,963,32,437,218,123,30,840,1803
ODISHA,2007,Total (Jumping),2,3,2,0,0,7,1,1,0,0,0,2,9
ODISHA,2008,By Over Alcoholism,0,0,0,3,0,3,0,0,0,0,0,0,3
ODISHA,2008,By Drowning,6,45,29,17,0,97,7,13,9,5,4,38,135
ODISHA,2008,By Fire/Self Immolation,4,28,13,24,4,73,3,33,55,20,23,134,207
ODISHA,2008,By Fire-Arms,0,0,1,0,0,1,0,0,1,0,0,1,2
ODISHA,2008,By Hanging,7,241,269,177,42,736,9,218,174,74,28,503,1239
ODISHA,2008,By Consuming Insecticides,5,175,193,118,30,521,16,239,155,47,9,466,987
ODISHA,2008,By Consuming Other Poison,8,333,159,102,43,645,2,97,80,36,18,233,878
ODISHA,2008,By Self Infliction of injury,0,0,0,0,0,0,0,0,0,0,0,0,0
ODISHA,2008,By Jumping from (Building),0,0,0,0,0,0,0,0,0,0,0,0,0
ODISHA,2008,By Jumping from (Other sites),5,3,2,0,0,10,1,1,0,0,0,2,12
ODISHA,2008,By Jumping off Moving Vehicles/Trains,0,3,5,2,1,11,0,0,1,0,0,1,12
ODISHA,2008,By Machine,0,0,0,0,0,0,0,0,0,0,0,0,0
ODISHA,2008,By Overdose of sleeping pills,0,0,0,0,0,0,0,0,0,0,0,0,0
ODISHA,2008,By touching electric wires,2,13,6,2,0,23,0,0,0,0,0,0,23
ODISHA,2008,By coming under running vehicles/trains,2,40,71,57,37,207,0,19,20,22,9,70,277
ODISHA,2008,By Other means (please specify),75,163,273,211,106,828,17,100,101,55,28,301,1129
ODISHA,2008,Total,114,1044,1021,713,263,3155,55,720,596,259,119,1749,4904
ODISHA,2008,Total (Poison),13,508,352,220,73,1166,18,336,235,83,27,699,1865
ODISHA,2008,Total (Jumping),5,3,2,0,0,10,1,1,0,0,0,2,12
ODISHA,2009,By Over Alcoholism,0,0,1,0,0,1,0,0,0,0,0,0,1
ODISHA,2009,By Drowning,13,57,30,25,3,128,6,14,15,7,3,45,173
ODISHA,2009,By Fire/Self Immolation,1,10,13,6,0,30,2,17,39,17,1,76,106
ODISHA,2009,By Fire-Arms,0,0,2,0,0,2,0,1,0,1,0,2,4
ODISHA,2009,By Hanging,7,263,256,103,17,646,1,204,144,68,5,422,1068
ODISHA,2009,By Consuming Insecticides,22,224,240,111,57,654,21,264,172,62,24,543,1197
ODISHA,2009,By Consuming Other Poison,13,127,146,84,20,390,14,124,109,41,16,304,694
ODISHA,2009,By Self Infliction of injury,0,1,0,0,0,1,0,1,0,0,0,1,2
ODISHA,2009,By Jumping from (Building),0,1,0,0,0,1,0,0,0,0,0,0,1
ODISHA,2009,By Jumping from (Other sites),0,0,6,5,0,11,2,0,2,0,1,5,16
ODISHA,2009,By Jumping off Moving Vehicles/Trains,0,3,15,9,0,27,0,0,3,0,0,3,30
ODISHA,2009,By Machine,0,0,0,0,0,0,0,1,0,0,0,1,1
ODISHA,2009,By Overdose of sleeping pills,0,0,0,0,0,0,0,3,0,0,0,3,3
ODISHA,2009,By touching electric wires,1,6,7,2,0,16,1,0,0,0,0,1,17
ODISHA,2009,By coming under running vehicles/trains,0,4,5,8,3,20,0,2,2,3,1,8,28
ODISHA,2009,By Other means (please specify),12,150,193,175,110,640,20,152,111,66,35,384,1024
ODISHA,2009,Total,69,846,914,528,210,2567,67,783,597,265,86,1798,4365
ODISHA,2009,Total (Poison),35,352,386,195,77,1045,35,389,281,103,40,848,1893
ODISHA,2009,Total (Jumping),0,1,6,5,0,12,2,0,2,0,1,5,17
ODISHA,2010,By Over Alcoholism,1,4,2,3,0,10,0,1,2,1,0,4,14
ODISHA,2010,By Drowning,19,33,17,6,4,79,3,8,11,3,2,27,106
ODISHA,2010,By Fire/Self Immolation,1,5,8,1,0,15,1,32,19,6,3,61,76
ODISHA,2010,By Fire-Arms,0,1,12,5,0,18,0,11,5,2,3,21,39
ODISHA,2010,By Hanging,13,258,242,138,43,694,12,254,143,74,12,495,1189
ODISHA,2010,By Consuming Insecticides,22,217,285,189,36,749,26,314,180,99,14,633,1382
ODISHA,2010,By Consuming Other Poison,5,89,77,39,15,225,11,92,46,24,11,184,409
ODISHA,2010,By Self Infliction of injury,6,27,24,13,4,74,4,20,16,6,0,46,120
ODISHA,2010,By Jumping from (Building),0,0,1,0,0,1,0,0,0,0,0,0,1
ODISHA,2010,By Jumping from (Other sites),2,5,3,1,0,11,0,0,0,1,0,1,12
ODISHA,2010,By Jumping off Moving Vehicles/Trains,0,5,4,3,0,12,1,1,3,0,0,5,17
ODISHA,2010,By Machine,0,0,1,0,0,1,0,0,0,0,0,0,1
ODISHA,2010,By Overdose of sleeping pills,0,0,0,0,0,0,0,1,0,0,0,1,1
ODISHA,2010,By touching electric wires,1,3,4,2,0,10,0,1,0,0,0,1,11
ODISHA,2010,By coming under running vehicles/trains,0,34,50,34,9,127,2,15,12,17,2,48,175
ODISHA,2010,By Other means (please specify),29,116,112,99,48,404,17,103,117,41,20,298,702
ODISHA,2010,Total,99,797,842,533,159,2430,77,853,554,274,67,1825,4255
ODISHA,2010,Total (Poison),33,333,386,241,55,1048,41,426,242,129,25,863,1911
ODISHA,2010,Total (Jumping),2,5,4,1,0,12,0,0,0,1,0,1,13
ODISHA,2011,By Over Alcoholism,1,4,8,4,0,17,0,2,2,1,0,5,22
ODISHA,2011,By Drowning,15,46,27,20,1,109,6,16,15,6,0,43,152
ODISHA,2011,By Fire/Self Immolation,0,5,6,5,0,16,3,17,25,5,0,50,66
ODISHA,2011,By Fire-Arms,0,3,1,0,0,4,0,0,0,0,0,0,4
ODISHA,2011,By Hanging,13,236,262,172,22,705,18,237,200,64,21,540,1245
ODISHA,2011,By Consuming Insecticides,29,196,164,107,20,516,32,241,150,71,17,511,1027
ODISHA,2011,By Consuming Other Poison,16,155,147,97,37,452,19,158,138,63,14,392,844
ODISHA,2011,By Self Infliction of injury,0,21,11,4,0,36,0,8,2,0,0,10,46
ODISHA,2011,By Jumping from (Building),0,7,8,3,4,22,0,1,1,0,0,2,24
ODISHA,2011,By Jumping from (Other sites),3,13,15,7,3,41,2,4,3,3,1,13,54
ODISHA,2011,By Jumping off Moving Vehicles/Trains,0,1,3,3,0,7,1,2,1,1,0,5,12
ODISHA,2011,By Machine,0,0,0,0,0,0,0,0,0,0,0,0,0
ODISHA,2011,By Overdose of sleeping pills,0,2,1,1,0,4,0,3,1,1,0,5,9
ODISHA,2011,By touching electric wires,3,9,10,6,0,28,0,6,2,0,0,8,36
ODISHA,2011,By coming under running vehicles/trains,1,41,69,38,19,168,1,18,19,5,7,50,218
ODISHA,2011,By Other means (please specify),63,277,294,180,121,935,39,159,146,136,67,547,1482
ODISHA,2011,Total,144,1016,1026,647,227,3060,121,872,705,356,127,2181,5241
ODISHA,2011,Total (Poison),45,372,322,208,57,1004,51,407,290,134,31,913,1917
ODISHA,2011,Total (Jumping),3,20,23,10,7,63,2,5,4,3,1,15,78
ODISHA,2012,By Over Alcoholism,4,6,5,8,1,24,2,1,1,1,1,6,30
ODISHA,2012,By Drowning,10,32,18,15,1,76,3,18,21,7,1,50,126
ODISHA,2012,By Fire/Self Immolation,0,5,4,4,1,14,0,13,16,0,0,29,43
ODISHA,2012,By Fire-Arms,0,3,1,0,0,4,0,0,0,0,0,0,4
ODISHA,2012,By Hanging,9,242,249,127,23,650,25,236,210,60,12,543,1193
ODISHA,2012,By Consuming Insecticides,15,163,169,144,39,530,31,217,147,78,15,488,1018
ODISHA,2012,By Consuming Other Poison,13,91,128,99,28,359,16,105,70,43,12,246,605
ODISHA,2012,By Self Infliction of injury,0,0,2,0,0,2,0,0,0,0,0,0,2
ODISHA,2012,By Jumping from (Building),0,0,0,0,0,0,0,0,0,0,0,0,0
ODISHA,2012,By Jumping from (Other sites),2,6,4,2,0,14,0,2,1,0,0,3,17
ODISHA,2012,By Jumping off Moving Vehicles/Trains,0,2,5,4,1,12,0,5,3,2,0,10,22
ODISHA,2012,By Machine,0,0,0,0,0,0,0,0,0,0,0,0,0
ODISHA,2012,By Overdose of sleeping pills,0,0,0,0,0,0,0,1,1,0,0,2,2
ODISHA,2012,By touching electric wires,3,7,4,3,1,18,1,3,8,0,2,14,32
ODISHA,2012,By coming under running vehicles/trains,0,28,26,16,16,86,1,11,7,7,2,28,114
ODISHA,2012,By Other means (please specify),88,282,349,257,131,1107,64,217,236,131,64,712,1819
ODISHA,2012,Total,144,867,964,679,242,2896,143,829,721,329,109,2131,5027
ODISHA,2012,Total (Poison),28,254,299,243,67,891,47,322,217,121,27,734,1625
ODISHA,2012,Total (Jumping),2,6,4,2,0,14,0,2,1,0,0,3,17
PUNJAB,2001,By Over Alcoholism,0,0,3,0,0,3,0,0,0,0,0,0,3
PUNJAB,2001,By Drowning,0,4,1,3,2,10,0,5,2,0,0,7,17
PUNJAB,2001,By Fire/Self Immolation,0,1,4,2,0,7,0,15,10,0,1,26,33
PUNJAB,2001,By Fire-Arms,0,5,2,1,2,10,0,0,0,0,0,0,10
PUNJAB,2001,By Hanging,0,14,12,12,0,38,0,10,6,0,0,16,54
PUNJAB,2001,By Consuming Insecticides,1,38,8,11,5,63,0,29,7,1,1,38,101
PUNJAB,2001,By Consuming Other Poison,0,11,4,7,4,26,0,11,5,0,0,16,42
PUNJAB,2001,By Self Infliction of injury,0,3,3,0,3,9,0,7,2,0,0,9,18
PUNJAB,2001,By Jumping from (Building),0,0,0,0,0,0,0,0,0,0,0,0,0
PUNJAB,2001,By Jumping from (Other sites),0,0,0,0,0,0,0,0,0,0,0,0,0
PUNJAB,2001,By Jumping off Moving Vehicles/Trains,0,0,0,0,0,0,0,0,0,0,0,0,0
PUNJAB,2001,By Machine,0,3,0,0,0,3,0,0,0,0,1,1,4
PUNJAB,2001,By Overdose of sleeping pills,0,0,0,0,0,0,0,0,0,0,0,0,0
PUNJAB,2001,By touching electric wires,0,31,14,61,51,157,0,5,9,13,9,36,193
PUNJAB,2001,By coming under running vehicles/trains,0,2,0,0,0,2,0,0,1,0,0,1,3
PUNJAB,2001,By Other means (please specify),0,17,13,38,0,68,0,67,24,5,6,102,170
PUNJAB,2001,Total,1,129,64,135,67,396,0,149,66,19,18,252,648
PUNJAB,2001,Total (Poison),1,52,15,18,12,98,0,47,14,1,1,63,161
PUNJAB,2001,Total (Jumping),0,0,0,0,0,0,0,0,0,0,0,0,0
PUNJAB,2002,By Over Alcoholism,0,0,1,2,0,3,0,0,0,0,0,0,3
PUNJAB,2002,By Drowning,0,6,7,0,2,15,1,0,2,1,1,5,20
PUNJAB,2002,By Fire/Self Immolation,0,5,4,0,0,9,0,12,4,1,0,17,26
PUNJAB,2002,By Fire-Arms,0,4,1,1,0,6,0,0,0,0,0,0,6
PUNJAB,2002,By Hanging,1,37,21,8,5,72,0,16,6,0,0,22,94
PUNJAB,2002,By Consuming Insecticides,0,26,19,5,2,52,0,24,4,0,0,28,80
PUNJAB,2002,By Consuming Other Poison,0,9,11,3,0,23,0,6,3,0,0,9,32
PUNJAB,2002,By Self Infliction of injury,0,0,3,1,0,4,0,4,3,0,0,7,11
PUNJAB,2002,By Jumping from (Building),0,1,0,1,0,2,0,0,2,1,0,3,5
PUNJAB,2002,By Jumping from (Other sites),0,0,0,0,0,0,0,0,0,0,0,0,0
PUNJAB,2002,By Jumping off Moving Vehicles/Trains,0,0,0,0,0,0,0,0,0,0,0,0,0
PUNJAB,2002,By Machine,0,0,0,0,0,0,0,0,0,0,0,0,0
PUNJAB,2002,By Overdose of sleeping pills,0,2,0,0,1,3,0,0,0,0,0,0,3
PUNJAB,2002,By touching electric wires,0,0,2,2,0,4,0,0,0,0,0,0,4
PUNJAB,2002,By coming under running vehicles/trains,0,52,46,48,17,163,1,2,8,2,0,13,176
PUNJAB,2002,By Other means,16,8,14,1,2,41,0,0,3,1,2,6,47
PUNJAB,2002,Total,17,150,129,72,29,397,2,64,35,6,3,110,507
PUNJAB,2002,Total (Poison),0,35,33,9,2,79,0,34,10,0,0,44,123
PUNJAB,2002,Total (Jumping),0,1,0,1,0,2,0,0,2,1,0,3,5
PUNJAB,2003,By Over Alcoholism,0,0,0,0,0,0,0,0,0,0,0,0,0
PUNJAB,2003,By Drowning,0,5,4,3,2,14,2,2,0,0,0,4,18
PUNJAB,2003,By Fire/Self Immolation,0,0,2,2,0,4,0,7,4,0,0,11,15
PUNJAB,2003,By Fire-Arms,0,3,4,5,0,12,0,2,1,0,0,3,15
PUNJAB,2003,By Hanging,1,40,37,11,14,103,0,9,11,0,1,21,124
PUNJAB,2003,By Consuming Insecticides,0,8,18,7,3,36,0,5,7,1,0,13,49
PUNJAB,2003,By Consuming Other Poison,0,12,6,6,2,26,0,7,5,1,0,13,39
PUNJAB,2003,By Self Infliction of injury,0,8,2,0,1,11,0,4,4,1,0,9,20
PUNJAB,2003,By Jumping from (Building),0,14,9,4,1,28,1,3,3,2,0,9,37
PUNJAB,2003,By Jumping from (Other sites),0,1,1,0,0,2,0,1,0,0,0,1,3
PUNJAB,2003,By Jumping off Moving Vehicles/Trains,0,0,0,0,0,0,0,0,0,0,0,0,0
PUNJAB,2003,By Machine,0,0,0,0,0,0,0,0,0,0,0,0,0
PUNJAB,2003,By Overdose of sleeping pills,0,0,0,0,0,0,0,0,0,0,0,0,0
PUNJAB,2003,By touching electric wires,0,0,0,0,0,0,0,0,0,0,0,0,0
PUNJAB,2003,By coming under running vehicles/trains,0,0,0,0,0,0,0,0,0,0,0,0,0
PUNJAB,2003,By Other means (please specify),2,123,73,54,18,270,2,16,15,5,3,41,311
PUNJAB,2003,Total,3,214,156,92,41,506,5,56,50,10,4,125,631
PUNJAB,2003,Total (Poison),0,28,26,13,6,73,0,16,16,3,0,35,108
PUNJAB,2003,Total (Jumping),0,15,10,4,1,30,1,4,3,2,0,10,40
PUNJAB,2004,By Over Alcoholism,0,0,1,1,0,2,0,0,0,0,0,0,2
PUNJAB,2004,By Drowning,0,4,2,0,3,9,0,2,4,0,0,6,15
PUNJAB,2004,By Fire/Self Immolation,0,0,1,0,0,1,0,4,5,0,0,9,10
PUNJAB,2004,By Fire-Arms,0,5,3,2,2,12,0,2,1,0,0,3,15
PUNJAB,2004,By Hanging,2,46,44,16,5,113,0,14,10,0,0,24,137
PUNJAB,2004,By Consuming Insecticides,0,11,12,3,1,27,0,4,6,0,0,10,37
PUNJAB,2004,By Consuming Other Poison,2,28,19,10,4,63,0,24,7,5,2,38,101
PUNJAB,2004,By Self Infliction of injury,0,0,0,0,0,0,0,0,0,0,0,0,0
PUNJAB,2004,By Jumping from (Building),0,0,0,0,0,0,0,0,0,0,0,0,0
PUNJAB,2004,By Jumping from (Other sites),0,0,0,0,0,0,4,0,0,0,1,5,5
PUNJAB,2004,By Jumping off Moving Vehicles/Trains,0,0,0,0,0,0,0,0,0,0,0,0,0
PUNJAB,2004,By Machine,0,0,0,0,0,0,0,0,0,0,0,0,0
PUNJAB,2004,By Overdose of sleeping pills,0,0,0,0,0,0,0,0,0,0,0,0,0
PUNJAB,2004,By touching electric wires,0,0,0,0,0,0,0,0,0,0,0,0,0
PUNJAB,2004,By coming under running vehicles/trains,0,4,3,2,0,9,0,2,0,0,0,2,11
PUNJAB,2004,By Other means (please specify),0,88,98,70,24,280,10,6,6,8,2,32,312
PUNJAB,2004,Total,4,186,183,104,39,516,14,58,39,13,5,129,645
PUNJAB,2004,Total (Poison),2,39,31,13,5,90,0,28,13,5,2,48,138
PUNJAB,2004,Total (Jumping),0,0,0,0,0,0,4,0,0,0,1,5,5
PUNJAB,2005,By Over Alcoholism,0,0,1,0,0,1,0,0,0,1,0,1,2
PUNJAB,2005,By Drowning,0,2,2,4,5,13,0,3,6,2,0,11,24
PUNJAB,2005,By Fire/Self Immolation,0,2,1,0,0,3,0,3,1,1,1,6,9
PUNJAB,2005,By Fire-Arms,0,6,2,1,1,10,0,2,0,0,0,2,12
PUNJAB,2005,By Hanging,0,0,47,17,0,64,1,12,6,9,1,29,93
PUNJAB,2005,By Consuming Insecticides,0,13,15,10,2,40,0,12,0,1,0,13,53
PUNJAB,2005,By Consuming Other Poison,0,21,16,9,4,50,0,8,10,1,0,19,69
PUNJAB,2005,By Self Infliction of injury,0,0,0,0,0,0,0,0,0,0,0,0,0
PUNJAB,2005,By Jumping from (Building),0,1,1,0,0,2,0,0,0,0,0,0,2
PUNJAB,2005,By Jumping from (Other sites),0,2,8,5,4,19,0,0,0,0,0,0,19
PUNJAB,2005,By Jumping off Moving Vehicles/Trains,0,0,3,1,0,4,0,0,0,0,0,0,4
PUNJAB,2005,By Machine,0,0,0,0,0,0,0,0,0,0,0,0,0
PUNJAB,2005,By Overdose of sleeping pills,0,1,0,0,0,1,0,0,0,0,0,0,1
PUNJAB,2005,By touching electric wires,0,0,0,0,0,0,0,0,0,1,0,1,1
PUNJAB,2005,By coming under running vehicles/trains,0,91,51,0,0,142,0,0,0,0,0,0,142
PUNJAB,2005,By Other means (please specify),0,25,20,65,23,133,1,2,17,4,0,24,157
PUNJAB,2005,Total,0,164,167,112,39,482,2,42,40,20,2,106,588
PUNJAB,2005,Total (Poison),0,34,31,19,6,90,0,20,10,2,0,32,122
PUNJAB,2005,Total (Jumping),0,3,9,5,4,21,0,0,0,0,0,0,21
PUNJAB,2006,By Over Alcoholism,0,0,0,0,0,0,0,0,0,0,0,0,0
PUNJAB,2006,By Drowning,0,3,0,4,3,10,0,3,0,1,0,4,14
PUNJAB,2006,By Fire/Self Immolation,0,2,3,3,1,9,0,3,6,2,0,11,20
PUNJAB,2006,By Fire-Arms,0,4,1,3,0,8,0,1,0,0,0,1,9
PUNJAB,2006,By Hanging,0,61,65,30,8,164,1,16,9,1,0,27,191
PUNJAB,2006,By Consuming Insecticides,1,12,15,7,0,35,0,10,6,3,0,19,54
PUNJAB,2006,By Consuming Other Poison,0,11,5,5,3,24,1,2,5,1,1,10,34
PUNJAB,2006,By Self Infliction of injury,0,7,5,3,1,16,1,9,7,1,0,18,34
PUNJAB,2006,By Jumping from (Building),0,0,0,0,0,0,0,1,0,0,0,1,1
PUNJAB,2006,By Jumping from (Other sites),0,2,4,0,0,6,0,3,1,0,0,4,10
PUNJAB,2006,By Jumping off Moving Vehicles/Trains,0,0,0,0,1,1,0,1,0,0,0,1,2
PUNJAB,2006,By Machine,0,0,0,0,0,0,0,0,0,0,0,0,0
PUNJAB,2006,By Overdose of sleeping pills,0,0,5,2,1,8,0,2,0,0,0,2,10
PUNJAB,2006,By touching electric wires,0,2,1,0,0,3,1,0,0,0,0,1,4
PUNJAB,2006,By coming under running vehicles/trains,10,110,104,67,29,320,10,22,15,7,1,55,375
PUNJAB,2006,By Other means (please specify),0,2,3,0,1,6,2,6,0,0,0,8,14
PUNJAB,2006,Total,11,216,211,124,48,610,16,79,49,16,2,162,772
PUNJAB,2006,Total (Poison),1,30,25,15,4,75,2,21,18,5,1,47,122
PUNJAB,2006,Total (Jumping),0,2,4,0,0,6,0,4,1,0,0,5,11
PUNJAB,2007,By Over Alcoholism,0,0,0,0,0,0,0,0,0,0,0,0,0
PUNJAB,2007,By Drowning,0,2,3,2,0,7,0,3,3,0,0,6,13
PUNJAB,2007,By Fire/Self Immolation,0,4,4,4,0,12,0,5,7,1,0,13,25
PUNJAB,2007,By Fire-Arms,0,0,4,0,3,7,0,0,1,0,0,1,8
PUNJAB,2007,By Hanging,0,51,56,24,6,137,0,21,14,3,0,38,175
PUNJAB,2007,By Consuming Insecticides,0,10,16,8,1,35,0,9,4,2,0,15,50
PUNJAB,2007,By Consuming Other Poison,2,23,20,14,4,63,4,22,10,3,0,39,102
PUNJAB,2007,By Self Infliction of injury,0,5,2,0,0,7,1,0,0,1,0,2,9
PUNJAB,2007,By Jumping from (Building),0,0,1,0,0,1,0,0,0,0,0,0,1
PUNJAB,2007,By Jumping from (Other sites),0,0,0,0,0,0,0,0,0,0,0,0,0
PUNJAB,2007,By Jumping off Moving Vehicles/Trains,0,0,1,0,0,1,1,0,1,0,0,2,3
PUNJAB,2007,By Machine,0,0,0,0,0,0,0,0,0,0,0,0,0
PUNJAB,2007,By Overdose of sleeping pills,0,1,0,0,0,1,0,0,0,0,0,0,1
PUNJAB,2007,By touching electric wires,0,0,0,0,0,0,0,0,0,1,0,1,1
PUNJAB,2007,By coming under running vehicles/trains,3,138,103,62,41,347,7,47,26,4,4,88,435
PUNJAB,2007,By Other means (please specify),0,2,6,3,3,14,0,5,3,2,0,10,24
PUNJAB,2007,Total,5,236,216,117,58,632,13,112,69,17,4,215,847
PUNJAB,2007,Total (Poison),2,38,38,22,5,105,5,31,14,6,0,56,161
PUNJAB,2007,Total (Jumping),0,0,1,0,0,1,0,0,0,0,0,0,1
PUNJAB,2008,By Over Alcoholism,0,1,0,0,0,1,0,0,0,0,0,0,1
PUNJAB,2008,By Drowning,1,10,1,5,4,21,0,7,1,2,0,10,31
PUNJAB,2008,By Fire/Self Immolation,0,1,6,2,1,10,2,5,6,1,1,15,25
PUNJAB,2008,By Fire-Arms,0,4,6,3,1,14,0,1,1,0,0,2,16
PUNJAB,2008,By Hanging,1,77,79,25,6,188,1,34,22,3,0,60,248
PUNJAB,2008,By Consuming Insecticides,2,18,16,13,1,50,0,12,5,3,0,20,70
PUNJAB,2008,By Consuming Other Poison,1,5,6,4,0,16,1,14,14,0,0,29,45
PUNJAB,2008,By Self Infliction of injury,0,0,1,0,1,2,0,2,1,0,0,3,5
PUNJAB,2008,By Jumping from (Building),0,0,0,0,0,0,0,0,0,0,0,0,0
PUNJAB,2008,By Jumping from (Other sites),0,0,0,0,0,0,0,0,0,0,0,0,0
PUNJAB,2008,By Jumping off Moving Vehicles/Trains,0,0,2,0,0,2,0,0,0,0,0,0,2
PUNJAB,2008,By Machine,0,0,0,0,0,0,0,0,0,0,0,0,0
PUNJAB,2008,By Overdose of sleeping pills,0,1,0,2,0,3,0,1,0,0,0,1,4
PUNJAB,2008,By touching electric wires,0,0,0,0,0,0,0,0,0,0,0,0,0
PUNJAB,2008,By coming under running vehicles/trains,3,87,128,73,36,327,5,28,31,6,7,77,404
PUNJAB,2008,By Other means (please specify),0,0,4,3,2,9,1,2,2,3,1,9,18
PUNJAB,2008,Total,8,204,249,130,52,643,10,106,83,18,9,226,869
PUNJAB,2008,Total (Poison),3,23,23,17,2,68,1,28,20,3,0,52,120
PUNJAB,2008,Total (Jumping),0,0,0,0,0,0,0,0,0,0,0,0,0
PUNJAB,2009,By Over Alcoholism,0,0,2,1,0,3,0,0,0,0,0,0,3
PUNJAB,2009,By Drowning,1,4,3,1,0,9,1,8,2,0,0,11,20
PUNJAB,2009,By Fire/Self Immolation,0,5,4,3,2,14,0,10,5,2,0,17,31
PUNJAB,2009,By Fire-Arms,0,4,4,2,1,11,0,1,0,0,0,1,12
PUNJAB,2009,By Hanging,1,56,54,23,4,138,0,39,13,4,4,60,198
PUNJAB,2009,By Consuming Insecticides,0,31,13,10,4,58,2,12,4,6,3,27,85
PUNJAB,2009,By Consuming Other Poison,4,11,17,6,0,38,0,14,13,1,1,29,67
PUNJAB,2009,By Self Infliction of injury,0,0,2,0,0,2,0,1,0,0,0,1,3
PUNJAB,2009,By Jumping from (Building),0,3,3,2,0,8,0,1,2,1,2,6,14
PUNJAB,2009,By Jumping from (Other sites),0,5,6,1,0,12,0,0,0,0,0,0,12
PUNJAB,2009,By Jumping off Moving Vehicles/Trains,0,0,0,0,0,0,0,0,0,0,0,0,0
PUNJAB,2009,By Machine,0,0,3,0,0,3,0,0,0,0,0,0,3
PUNJAB,2009,By Overdose of sleeping pills,0,0,4,0,0,4,0,0,0,0,0,0,4
PUNJAB,2009,By touching electric wires,1,0,2,0,0,3,0,0,0,4,0,4,7
PUNJAB,2009,By coming under running vehicles/trains,4,109,96,71,41,321,2,21,22,6,5,56,377
PUNJAB,2009,By Other means (please specify),0,2,7,2,0,11,0,0,0,0,0,0,11
PUNJAB,2009,Total,11,230,220,122,52,635,5,107,61,24,15,212,847
PUNJAB,2009,Total (Poison),4,42,32,16,4,98,2,27,17,7,4,57,155
PUNJAB,2009,Total (Jumping),0,8,9,3,0,20,0,1,2,1,2,6,26
PUNJAB,2010,By Over Alcoholism,0,0,5,2,1,8,0,0,0,0,0,0,8
PUNJAB,2010,By Drowning,2,8,7,2,2,21,1,6,1,1,2,11,32
PUNJAB,2010,By Fire/Self Immolation,0,6,6,1,2,15,0,21,4,0,0,25,40
PUNJAB,2010,By Fire-Arms,0,2,1,1,0,4,0,0,0,1,0,1,5
PUNJAB,2010,By Hanging,3,69,72,26,6,176,1,29,21,7,0,58,234
PUNJAB,2010,By Consuming Insecticides,0,18,24,6,3,51,0,14,8,2,4,28,79
PUNJAB,2010,By Consuming Other Poison,1,29,15,1,4,50,1,14,8,2,1,26,76
PUNJAB,2010,By Self Infliction of injury,0,0,0,1,0,1,0,0,0,0,0,0,1
PUNJAB,2010,By Jumping from (Building),2,5,5,2,0,14,0,1,1,0,0,2,16
PUNJAB,2010,By Jumping from (Other sites),0,0,0,0,0,0,0,0,0,0,0,0,0
PUNJAB,2010,By Jumping off Moving Vehicles/Trains,1,1,0,0,1,3,0,0,1,0,0,1,4
PUNJAB,2010,By Machine,0,0,1,0,0,1,0,1,0,0,0,1,2
PUNJAB,2010,By Overdose of sleeping pills,1,1,4,0,0,6,0,0,0,0,0,0,6
PUNJAB,2010,By touching electric wires,0,0,0,1,0,1,0,0,0,0,0,0,1
PUNJAB,2010,By coming under running vehicles/trains,0,120,117,80,45,362,0,16,17,8,5,46,408
PUNJAB,2010,By Other means (please specify),0,0,2,4,0,6,0,2,0,0,0,2,8
PUNJAB,2010,Total,10,259,259,127,64,719,3,104,61,21,12,201,920
PUNJAB,2010,Total (Poison),1,47,39,8,7,102,1,28,16,4,5,54,156
PUNJAB,2010,Total (Jumping),2,5,5,2,0,14,0,1,1,0,0,2,16
PUNJAB,2011,By Over Alcoholism,0,5,2,0,0,7,0,0,0,0,0,0,7
PUNJAB,2011,By Drowning,0,5,4,0,1,10,0,2,1,0,0,3,13
PUNJAB,2011,By Fire/Self Immolation,0,2,4,0,1,7,0,11,9,0,0,20,27
PUNJAB,2011,By Fire-Arms,0,2,3,1,2,8,0,1,0,0,0,1,9
PUNJAB,2011,By Hanging,0,69,75,25,4,173,0,37,14,4,0,55,228
PUNJAB,2011,By Consuming Insecticides,0,36,46,16,7,105,0,21,23,4,0,48,153
PUNJAB,2011,By Consuming Other Poison,0,16,19,8,1,44,0,19,11,1,0,31,75
PUNJAB,2011,By Self Infliction of injury,0,4,3,2,1,10,0,1,0,0,0,1,11
PUNJAB,2011,By Jumping from (Building),0,0,0,0,0,0,0,0,1,0,0,1,1
PUNJAB,2011,By Jumping from (Other sites),0,2,0,0,0,2,0,0,0,0,0,0,2
PUNJAB,2011,By Jumping off Moving Vehicles/Trains,0,0,0,0,0,0,0,0,0,0,0,0,0
PUNJAB,2011,By Machine,0,1,4,1,0,6,0,0,0,0,0,0,6
PUNJAB,2011,By Overdose of sleeping pills,0,3,2,1,0,6,0,0,0,0,0,0,6
PUNJAB,2011,By touching electric wires,0,0,0,0,0,0,0,0,1,0,0,1,1
PUNJAB,2011,By coming under running vehicles/trains,0,128,127,71,48,374,0,23,15,6,5,49,423
PUNJAB,2011,By Other means (please specify),0,1,2,0,0,3,0,1,0,0,0,1,4
PUNJAB,2011,Total,0,274,291,125,65,755,0,116,75,15,5,211,966
PUNJAB,2011,Total (Poison),0,56,68,26,9,159,0,41,34,5,0,80,239
PUNJAB,2011,Total (Jumping),0,2,0,0,0,2,0,0,1,0,0,1,3
PUNJAB,2012,By Over Alcoholism,0,3,0,1,1,5,0,0,0,0,0,0,5
PUNJAB,2012,By Drowning,2,12,8,3,1,26,0,4,4,0,0,8,34
PUNJAB,2012,By Fire/Self Immolation,1,4,3,1,1,10,1,15,8,1,0,25,35
PUNJAB,2012,By Fire-Arms,0,6,4,2,0,12,0,0,0,0,0,0,12
PUNJAB,2012,By Hanging,3,85,98,28,7,221,1,47,39,3,0,90,311
PUNJAB,2012,By Consuming Insecticides,0,30,29,10,4,73,0,16,15,2,0,33,106
PUNJAB,2012,By Consuming Other Poison,0,14,22,3,4,43,0,10,10,2,0,22,65
PUNJAB,2012,By Self Infliction of injury,0,3,2,0,0,5,0,0,1,1,0,2,7
PUNJAB,2012,By Jumping from (Building),0,0,0,0,1,1,0,0,1,0,0,1,2
PUNJAB,2012,By Jumping from (Other sites),0,1,2,1,0,4,0,5,2,0,0,7,11
PUNJAB,2012,By Jumping off Moving Vehicles/Trains,1,0,0,0,0,1,0,0,0,0,0,0,1
PUNJAB,2012,By Machine,0,0,0,0,0,0,0,0,0,0,0,0,0
PUNJAB,2012,By Overdose of sleeping pills,0,2,2,0,0,4,0,0,0,0,0,0,4
PUNJAB,2012,By touching electric wires,0,0,0,0,0,0,0,0,0,0,0,0,0
PUNJAB,2012,By coming under running vehicles/trains,0,138,124,76,35,373,0,20,20,12,2,54,427
PUNJAB,2012,By Other means (please specify),0,1,5,0,0,6,0,4,0,0,0,4,10
PUNJAB,2012,Total,7,299,299,125,54,784,2,121,100,21,2,246,1030
PUNJAB,2012,Total (Poison),0,47,53,13,8,121,0,26,26,5,0,57,178
PUNJAB,2012,Total (Jumping),0,1,2,1,1,5,0,5,3,0,0,8,13
RAJASTHAN,2001,By Over Alcoholism,0,10,22,18,2,52,0,0,0,0,0,0,52
RAJASTHAN,2001,By Drowning,19,63,77,15,15,189,10,75,37,21,7,150,339
RAJASTHAN,2001,By Fire/Self Immolation,8,31,29,11,7,86,4,77,48,16,2,147,233
RAJASTHAN,2001,By Fire-Arms,0,3,4,4,0,11,0,0,0,0,0,0,11
RAJASTHAN,2001,By Hanging,4,206,239,107,20,576,5,154,84,15,5,263,839
RAJASTHAN,2001,By Consuming Insecticides,16,160,129,58,15,378,19,145,108,25,9,306,684
RAJASTHAN,2001,By Consuming Other Poison,3,92,100,43,25,263,9,99,55,9,6,178,441
RAJASTHAN,2001,By Self Infliction of injury,0,0,1,0,0,1,0,0,0,0,0,0,1
RAJASTHAN,2001,By Jumping from (Building),3,1,4,1,0,9,0,0,0,0,0,0,9
RAJASTHAN,2001,By Jumping from (Other sites),0,2,2,1,0,5,1,9,4,0,0,14,19
RAJASTHAN,2001,By Jumping off Moving Vehicles/Trains,1,11,19,8,3,42,0,3,5,0,0,8,50
RAJASTHAN,2001,By Machine,2,6,7,1,0,16,2,1,0,1,0,4,20
RAJASTHAN,2001,By Overdose of sleeping pills,0,11,14,18,7,50,0,12,4,7,1,24,74
RAJASTHAN,2001,By touching electric wires,3,11,8,2,1,25,0,2,0,1,0,3,28
RAJASTHAN,2001,By coming under running vehicles/trains,0,29,38,18,3,88,0,8,5,1,0,14,102
RAJASTHAN,2001,By Other means (please specify),27,41,20,58,22,168,11,39,37,26,12,125,293
RAJASTHAN,2001,Total,86,677,713,363,120,1959,61,624,387,122,42,1236,3195
RAJASTHAN,2001,Total (Poison),19,252,230,101,40,642,28,244,163,34,15,484,1126
RAJASTHAN,2001,Total (Jumping),3,3,6,2,0,14,1,9,4,0,0,14,28
RAJASTHAN,2002,By Over Alcoholism,0,14,24,14,2,54,0,0,0,0,0,0,54
RAJASTHAN,2002,By Drowning,7,65,60,30,6,168,2,51,36,34,3,126,294
RAJASTHAN,2002,By Fire/Self Immolation,7,41,37,19,6,110,4,92,54,13,3,166,276
RAJASTHAN,2002,By Fire-Arms,0,4,5,3,3,15,0,0,0,0,0,0,15
RAJASTHAN,2002,By Hanging,4,202,240,161,21,628,3,156,112,52,4,327,955
RAJASTHAN,2002,By Consuming Insecticides,13,140,134,72,22,381,8,126,82,30,10,256,637
RAJASTHAN,2002,By Consuming Other Poison,4,78,66,35,6,189,1,53,30,13,0,97,286
RAJASTHAN,2002,By Self Infliction of injury,0,0,0,0,0,0,0,0,0,0,0,0,0
RAJASTHAN,2002,By Jumping from (Building),1,2,4,7,0,14,0,0,8,2,0,10,24
RAJASTHAN,2002,By Jumping from (Other sites),4,5,8,1,0,18,1,7,2,1,0,11,29
RAJASTHAN,2002,By Jumping off Moving Vehicles/Trains,0,10,19,0,1,30,0,1,3,1,0,5,35
RAJASTHAN,2002,By Machine,2,4,4,2,0,12,1,1,0,0,0,2,14
RAJASTHAN,2002,By Overdose of sleeping pills,0,5,11,6,0,22,0,2,7,0,0,9,31
RAJASTHAN,2002,By touching electric wires,2,5,5,1,0,13,0,1,0,0,0,1,14
RAJASTHAN,2002,By coming under running vehicles/trains,0,24,24,12,11,71,0,4,6,1,1,12,83
RAJASTHAN,2002,By Other means,21,118,122,79,27,367,10,86,33,0,5,134,501
RAJASTHAN,2002,Total,65,717,763,442,105,2092,30,580,373,147,26,1156,3248
RAJASTHAN,2002,Total (Poison),17,218,200,107,28,570,9,179,112,43,10,353,923
RAJASTHAN,2002,Total (Jumping),5,7,12,8,0,32,1,7,10,3,0,21,53
RAJASTHAN,2003,By Over Alcoholism,0,19,24,26,9,78,0,0,0,0,0,0,78
RAJASTHAN,2003,By Drowning,11,72,100,23,9,215,6,85,42,19,7,159,374
RAJASTHAN,2003,By Fire/Self Immolation,3,42,39,17,10,111,2,97,66,12,7,184,295
RAJASTHAN,2003,By Fire-Arms,1,2,4,4,0,11,1,1,2,0,0,4,15
RAJASTHAN,2003,By Hanging,9,174,237,141,23,584,7,145,100,43,5,300,884
RAJASTHAN,2003,By Consuming Insecticides,7,194,171,100,27,499,7,118,95,36,9,265,764
RAJASTHAN,2003,By Consuming Other Poison,4,79,84,27,10,204,4,47,38,23,5,117,321
RAJASTHAN,2003,By Self Infliction of injury,0,0,0,0,0,0,0,0,0,0,0,0,0
RAJASTHAN,2003,By Jumping from (Building),0,2,3,1,1,7,0,1,3,0,1,5,12
RAJASTHAN,2003,By Jumping from (Other sites),1,9,22,12,0,44,0,15,11,4,1,31,75
RAJASTHAN,2003,By Jumping off Moving Vehicles/Trains,1,27,19,8,7,62,1,6,10,2,2,21,83
RAJASTHAN,2003,By Machine,1,10,18,3,1,33,0,2,0,0,0,2,35
RAJASTHAN,2003,By Overdose of sleeping pills,0,13,13,4,2,32,0,5,3,5,0,13,45
RAJASTHAN,2003,By touching electric wires,4,12,17,18,16,67,0,3,1,5,4,13,80
RAJASTHAN,2003,By coming under running vehicles/trains,0,29,36,15,6,86,0,8,10,1,1,20,106
RAJASTHAN,2003,By Other means (please specify),24,140,92,51,49,356,8,68,29,18,15,138,494
RAJASTHAN,2003,Total,66,824,879,450,170,2389,36,601,410,168,57,1272,3661
RAJASTHAN,2003,Total (Poison),11,273,255,127,37,703,11,165,133,59,14,382,1085
RAJASTHAN,2003,Total (Jumping),1,11,25,13,1,51,0,16,14,4,2,36,87
RAJASTHAN,2004,By Over Alcoholism,0,21,30,18,3,72,0,0,0,0,0,0,72
RAJASTHAN,2004,By Drowning,11,57,94,50,14,226,7,57,48,19,9,140,366
RAJASTHAN,2004,By Fire/Self Immolation,7,24,42,13,5,91,9,71,52,33,5,170,261
RAJASTHAN,2004,By Fire-Arms,0,3,4,0,0,7,0,0,0,0,0,0,7
RAJASTHAN,2004,By Hanging,7,223,258,113,21,622,4,126,96,35,4,265,887
RAJASTHAN,2004,By Consuming Insecticides,18,216,142,65,16,457,6,132,99,33,7,277,734
RAJASTHAN,2004,By Consuming Other Poison,4,76,89,29,1,199,2,68,32,12,1,115,314
RAJASTHAN,2004,By Self Infliction of injury,0,0,0,0,0,0,0,0,0,0,0,0,0
RAJASTHAN,2004,By Jumping from (Building),0,1,2,3,0,6,1,1,0,0,0,2,8
RAJASTHAN,2004,By Jumping from (Other sites),2,10,11,14,3,40,0,11,3,1,0,15,55
RAJASTHAN,2004,By Jumping off Moving Vehicles/Trains,0,26,34,18,2,80,0,4,4,1,0,9,89
RAJASTHAN,2004,By Machine,1,6,12,2,0,21,0,2,0,0,0,2,23
RAJASTHAN,2004,By Overdose of sleeping pills,0,4,13,4,2,23,0,3,4,3,0,10,33
RAJASTHAN,2004,By touching electric wires,2,25,17,10,5,59,0,6,7,2,0,15,74
RAJASTHAN,2004,By coming under running vehicles/trains,0,36,47,30,5,118,0,10,11,3,1,25,143
RAJASTHAN,2004,By Other means (please specify),14,123,136,130,62,465,14,51,71,33,25,194,659
RAJASTHAN,2004,Total,66,851,931,499,139,2486,43,542,427,175,52,1239,3725
RAJASTHAN,2004,Total (Poison),22,292,231,94,17,656,8,200,131,45,8,392,1048
RAJASTHAN,2004,Total (Jumping),2,11,13,17,3,46,1,12,3,1,0,17,63
RAJASTHAN,2005,By Over Alcoholism,0,14,25,18,1,58,0,0,0,0,0,0,58
RAJASTHAN,2005,By Drowning,20,83,109,52,12,276,14,72,66,33,4,189,465
RAJASTHAN,2005,By Fire/Self Immolation,6,29,41,20,5,101,4,57,68,23,4,156,257
RAJASTHAN,2005,By Fire-Arms,0,4,3,1,1,9,0,0,0,0,0,0,9
RAJASTHAN,2005,By Hanging,12,219,318,137,26,712,4,114,81,27,3,229,941
RAJASTHAN,2005,By Consuming Insecticides,28,224,133,66,9,460,7,130,88,50,4,279,739
RAJASTHAN,2005,By Consuming Other Poison,0,99,150,59,21,329,6,67,58,15,1,147,476
RAJASTHAN,2005,By Self Infliction of injury,0,0,2,0,0,2,0,0,0,0,0,0,2
RAJASTHAN,2005,By Jumping from (Building),1,0,3,1,0,5,2,0,0,0,0,2,7
RAJASTHAN,2005,By Jumping from (Other sites),0,8,6,2,1,17,0,11,5,1,1,18,35
RAJASTHAN,2005,By Jumping off Moving Vehicles/Trains,0,14,6,4,0,24,0,2,1,3,0,6,30
RAJASTHAN,2005,By Machine,0,0,6,3,0,9,1,1,0,0,0,2,11
RAJASTHAN,2005,By Overdose of sleeping pills,0,8,14,7,4,33,0,5,4,2,0,11,44
RAJASTHAN,2005,By touching electric wires,2,18,32,26,0,78,0,1,3,5,0,9,87
RAJASTHAN,2005,By coming under running vehicles/trains,0,46,62,24,10,142,1,15,10,6,0,32,174
RAJASTHAN,2005,By Other means (please specify),19,166,215,156,47,603,11,99,79,47,4,240,843
RAJASTHAN,2005,Total,88,932,1125,576,137,2858,50,574,463,212,21,1320,4178
RAJASTHAN,2005,Total (Poison),28,323,285,125,30,791,13,197,146,65,5,426,1217
RAJASTHAN,2005,Total (Jumping),1,8,9,3,1,22,2,11,5,1,1,20,42
RAJASTHAN,2006,By Over Alcoholism,0,14,29,18,8,69,0,0,0,0,0,0,69
RAJASTHAN,2006,By Drowning,13,64,98,50,18,243,5,63,60,19,7,154,397
RAJASTHAN,2006,By Fire/Self Immolation,0,16,32,15,2,65,2,72,62,8,5,149,214
RAJASTHAN,2006,By Fire-Arms,0,3,5,1,0,9,0,0,0,0,0,0,9
RAJASTHAN,2006,By Hanging,8,272,316,128,15,739,10,163,110,35,5,323,1062
RAJASTHAN,2006,By Consuming Insecticides,12,202,247,106,15,582,6,114,85,32,4,241,823
RAJASTHAN,2006,By Consuming Other Poison,2,62,64,33,3,164,2,49,22,2,1,76,240
RAJASTHAN,2006,By Self Infliction of injury,0,0,1,0,2,3,0,0,0,0,0,0,3
RAJASTHAN,2006,By Jumping from (Building),2,2,0,0,0,4,1,0,0,0,0,1,5
RAJASTHAN,2006,By Jumping from (Other sites),4,6,4,7,5,26,2,13,2,2,3,22,48
RAJASTHAN,2006,By Jumping off Moving Vehicles/Trains,1,12,13,9,2,37,2,5,4,1,0,12,49
RAJASTHAN,2006,By Machine,1,1,4,2,0,8,0,1,2,1,0,4,12
RAJASTHAN,2006,By Overdose of sleeping pills,0,7,11,4,0,22,0,1,2,0,0,3,25
RAJASTHAN,2006,By touching electric wires,1,13,22,7,4,47,0,4,6,1,0,11,58
RAJASTHAN,2006,By coming under running vehicles/trains,4,40,58,31,8,141,0,21,13,11,3,48,189
RAJASTHAN,2006,By Other means (please specify),11,202,268,218,52,751,16,103,101,74,15,309,1060
RAJASTHAN,2006,Total,59,916,1172,629,134,2910,46,609,469,186,43,1353,4263
RAJASTHAN,2006,Total (Poison),14,264,312,139,20,749,8,163,107,34,5,317,1066
RAJASTHAN,2006,Total (Jumping),6,8,4,7,5,30,3,13,2,2,3,23,53
RAJASTHAN,2007,By Over Alcoholism,0,11,34,19,2,66,0,0,1,0,0,1,67
RAJASTHAN,2007,By Drowning,18,54,94,45,11,222,8,70,50,58,7,193,415
RAJASTHAN,2007,By Fire/Self Immolation,4,30,46,29,2,111,1,82,62,16,2,163,274
RAJASTHAN,2007,By Fire-Arms,0,1,6,0,1,8,0,5,5,1,0,11,19
RAJASTHAN,2007,By Hanging,2,324,306,120,21,773,5,134,109,31,1,280,1053
RAJASTHAN,2007,By Consuming Insecticides,9,187,251,172,17,636,3,91,71,24,5,194,830
RAJASTHAN,2007,By Consuming Other Poison,2,85,106,54,7,254,5,55,59,13,5,137,391
RAJASTHAN,2007,By Self Infliction of injury,0,1,1,0,0,2,0,1,2,0,0,3,5
RAJASTHAN,2007,By Jumping from (Building),2,2,7,6,0,17,0,1,0,0,0,1,18
RAJASTHAN,2007,By Jumping from (Other sites),0,5,5,4,2,16,1,3,3,1,0,8,24
RAJASTHAN,2007,By Jumping off Moving Vehicles/Trains,0,13,7,0,0,20,0,0,2,0,0,2,22
RAJASTHAN,2007,By Machine,0,4,0,2,0,6,0,0,0,0,0,0,6
RAJASTHAN,2007,By Overdose of sleeping pills,0,7,19,9,1,36,0,5,4,3,0,12,48
RAJASTHAN,2007,By touching electric wires,5,13,30,14,1,63,0,4,7,3,0,14,77
RAJASTHAN,2007,By coming under running vehicles/trains,0,51,37,30,2,120,1,15,20,3,1,40,160
RAJASTHAN,2007,By Other means (please specify),36,275,232,201,60,804,12,78,71,49,14,224,1028
RAJASTHAN,2007,Total,78,1063,1181,705,127,3154,36,544,466,202,35,1283,4437
RAJASTHAN,2007,Total (Poison),11,273,358,226,24,892,8,147,132,37,10,334,1226
RAJASTHAN,2007,Total (Jumping),2,7,12,10,2,33,1,4,3,1,0,9,42
RAJASTHAN,2008,By Over Alcoholism,0,13,22,18,7,60,0,2,2,2,0,6,66
RAJASTHAN,2008,By Drowning,34,103,101,61,17,316,11,64,54,26,12,167,483
RAJASTHAN,2008,By Fire/Self Immolation,5,41,48,18,4,116,3,101,64,20,7,195,311
RAJASTHAN,2008,By Fire-Arms,1,2,5,3,1,12,0,0,0,0,0,0,12
RAJASTHAN,2008,By Hanging,11,294,337,128,17,787,2,150,127,43,7,329,1116
RAJASTHAN,2008,By Consuming Insecticides,8,170,161,94,11,444,3,84,66,20,8,181,625
RAJASTHAN,2008,By Consuming Other Poison,5,100,120,51,14,290,6,68,67,14,2,157,447
RAJASTHAN,2008,By Self Infliction of injury,0,1,1,3,1,6,0,0,0,0,0,0,6
RAJASTHAN,2008,By Jumping from (Building),2,14,58,9,9,92,0,5,5,3,1,14,106
RAJASTHAN,2008,By Jumping from (Other sites),0,15,17,13,2,47,0,2,3,1,1,7,54
RAJASTHAN,2008,By Jumping off Moving Vehicles/Trains,0,16,20,7,3,46,0,2,2,0,0,4,50
RAJASTHAN,2008,By Machine,0,3,2,2,0,7,0,0,1,0,0,1,8
RAJASTHAN,2008,By Overdose of sleeping pills,0,8,8,3,8,27,0,2,2,2,0,6,33
RAJASTHAN,2008,By touching electric wires,6,45,45,28,3,127,0,5,5,4,0,14,141
RAJASTHAN,2008,By coming under running vehicles/trains,2,42,47,20,6,117,2,24,12,5,1,44,161
RAJASTHAN,2008,By Other means (please specify),44,295,423,290,56,1108,41,149,139,90,20,439,1547
RAJASTHAN,2008,Total,118,1162,1415,748,159,3602,68,658,549,230,59,1564,5166
RAJASTHAN,2008,Total (Poison),13,271,282,148,26,740,9,152,133,34,10,338,1078
RAJASTHAN,2008,Total (Jumping),2,29,75,22,11,139,0,7,8,4,2,21,160
RAJASTHAN,2009,By Over Alcoholism,1,8,31,15,4,59,0,1,0,0,0,1,60
RAJASTHAN,2009,By Drowning,38,105,91,32,8,274,18,71,42,12,6,149,423
RAJASTHAN,2009,By Fire/Self Immolation,3,45,53,20,14,135,9,96,67,14,2,188,323
RAJASTHAN,2009,By Fire-Arms,0,1,1,2,0,4,0,1,0,0,0,1,5
RAJASTHAN,2009,By Hanging,11,348,315,144,19,837,14,192,132,33,8,379,1216
RAJASTHAN,2009,By Consuming Insecticides,8,196,206,71,17,498,4,109,71,55,2,241,739
RAJASTHAN,2009,By Consuming Other Poison,2,107,88,46,6,249,4,62,47,17,3,133,382
RAJASTHAN,2009,By Self Infliction of injury,0,5,12,6,3,26,0,3,4,0,0,7,33
RAJASTHAN,2009,By Jumping from (Building),3,19,60,14,7,103,2,13,11,4,0,30,133
RAJASTHAN,2009,By Jumping from (Other sites),1,9,3,4,1,18,0,8,7,2,1,18,36
RAJASTHAN,2009,By Jumping off Moving Vehicles/Trains,2,24,27,8,0,61,1,5,4,1,1,12,73
RAJASTHAN,2009,By Machine,0,4,6,1,0,11,0,0,0,0,0,0,11
RAJASTHAN,2009,By Overdose of sleeping pills,0,11,12,3,3,29,0,4,1,2,0,7,36
RAJASTHAN,2009,By touching electric wires,10,45,40,17,4,116,2,6,2,2,1,13,129
RAJASTHAN,2009,By coming under running vehicles/trains,3,38,40,25,8,114,2,16,11,3,1,33,147
RAJASTHAN,2009,By Other means (please specify),17,195,357,317,91,977,6,123,149,48,16,342,1319
RAJASTHAN,2009,Total,99,1160,1342,725,185,3511,62,710,548,193,41,1554,5065
RAJASTHAN,2009,Total (Poison),10,308,306,123,26,773,8,174,122,72,5,381,1154
RAJASTHAN,2009,Total (Jumping),4,28,63,18,8,121,2,21,18,6,1,48,169
RAJASTHAN,2010,By Over Alcoholism,0,18,36,27,1,82,0,1,1,0,0,2,84
RAJASTHAN,2010,By Drowning,18,107,64,34,4,227,5,64,40,9,5,123,350
RAJASTHAN,2010,By Fire/Self Immolation,3,39,59,33,14,148,7,84,56,13,7,167,315
RAJASTHAN,2010,By Fire-Arms,0,4,1,0,0,5,0,2,0,0,0,2,7
RAJASTHAN,2010,By Hanging,5,372,330,124,38,869,2,198,109,30,3,342,1211
RAJASTHAN,2010,By Consuming Insecticides,4,172,161,84,16,437,6,142,77,38,4,267,704
RAJASTHAN,2010,By Consuming Other Poison,3,98,91,30,12,234,0,69,63,20,1,153,387
RAJASTHAN,2010,By Self Infliction of injury,0,0,1,1,0,2,0,0,0,0,0,0,2
RAJASTHAN,2010,By Jumping from (Building),1,10,7,4,1,23,0,3,1,1,0,5,28
RAJASTHAN,2010,By Jumping from (Other sites),1,24,22,9,1,57,3,8,8,2,0,21,78
RAJASTHAN,2010,By Jumping off Moving Vehicles/Trains,4,18,24,7,4,57,3,8,4,0,2,17,74
RAJASTHAN,2010,By Machine,0,4,6,0,0,10,1,0,0,0,0,1,11
RAJASTHAN,2010,By Overdose of sleeping pills,0,9,3,4,3,19,0,7,8,5,0,20,39
RAJASTHAN,2010,By touching electric wires,3,23,40,18,2,86,4,15,13,4,1,37,123
RAJASTHAN,2010,By coming under running vehicles/trains,1,54,37,17,7,116,0,12,5,2,2,21,137
RAJASTHAN,2010,By Other means (please specify),47,141,406,346,53,993,36,88,145,97,11,377,1370
RAJASTHAN,2010,Total,90,1093,1288,738,156,3365,67,701,530,221,36,1555,4920
RAJASTHAN,2010,Total (Poison),7,270,253,115,28,673,6,211,140,58,5,420,1093
RAJASTHAN,2010,Total (Jumping),2,34,29,13,2,80,3,11,9,3,0,26,106
RAJASTHAN,2011,By Over Alcoholism,0,13,24,14,1,52,0,0,1,0,1,2,54
RAJASTHAN,2011,By Drowning,16,83,72,27,8,206,11,65,33,11,7,127,333
RAJASTHAN,2011,By Fire/Self Immolation,2,39,55,20,7,123,3,72,61,28,5,169,292
RAJASTHAN,2011,By Fire-Arms,0,1,2,1,1,5,0,0,1,0,0,1,6
RAJASTHAN,2011,By Hanging,4,381,337,188,23,933,3,216,118,26,7,370,1303
RAJASTHAN,2011,By Consuming Insecticides,5,130,114,61,8,318,2,91,50,23,3,169,487
RAJASTHAN,2011,By Consuming Other Poison,6,132,111,53,12,314,1,72,48,24,7,152,466
RAJASTHAN,2011,By Self Infliction of injury,0,0,1,4,3,8,0,0,0,1,0,1,9
RAJASTHAN,2011,By Jumping from (Building),1,6,7,5,2,21,0,3,3,1,0,7,28
RAJASTHAN,2011,By Jumping from (Other sites),1,33,27,19,4,84,1,25,15,4,2,47,131
RAJASTHAN,2011,By Jumping off Moving Vehicles/Trains,3,24,18,11,2,58,1,9,7,5,0,22,80
RAJASTHAN,2011,By Machine,0,7,8,2,1,18,0,0,0,0,0,0,18
RAJASTHAN,2011,By Overdose of sleeping pills,0,9,3,4,2,18,0,3,2,1,0,6,24
RAJASTHAN,2011,By touching electric wires,6,14,32,11,3,66,0,4,8,2,0,14,80
RAJASTHAN,2011,By coming under running vehicles/trains,2,40,34,19,5,100,0,8,8,0,0,16,116
RAJASTHAN,2011,By Other means (please specify),17,237,211,200,27,692,5,69,108,34,13,229,921
RAJASTHAN,2011,Total,63,1149,1056,639,109,3016,27,637,463,160,45,1332,4348
RAJASTHAN,2011,Total (Poison),11,262,226,118,23,640,3,163,98,48,10,322,962
RAJASTHAN,2011,Total (Jumping),2,39,34,24,6,105,1,28,18,5,2,54,159
RAJASTHAN,2012,By Over Alcoholism,0,21,38,40,4,103,0,0,0,0,0,0,103
RAJASTHAN,2012,By Drowning,19,85,66,20,8,198,7,61,32,9,6,115,313
RAJASTHAN,2012,By Fire/Self Immolation,1,32,57,24,7,121,3,56,62,19,6,146,267
RAJASTHAN,2012,By Fire-Arms,0,10,11,8,2,31,0,6,2,2,0,10,41
RAJASTHAN,2012,By Hanging,15,410,355,181,34,995,8,251,125,43,7,434,1429
RAJASTHAN,2012,By Consuming Insecticides,8,102,123,98,10,341,6,98,55,34,8,201,542
RAJASTHAN,2012,By Consuming Other Poison,4,80,66,39,6,195,4,65,43,15,5,132,327
RAJASTHAN,2012,By Self Infliction of injury,0,1,2,0,0,3,0,0,0,0,0,0,3
RAJASTHAN,2012,By Jumping from (Building),1,10,8,5,1,25,0,1,1,0,0,2,27
RAJASTHAN,2012,By Jumping from (Other sites),1,26,31,12,5,75,1,11,16,7,3,38,113
RAJASTHAN,2012,By Jumping off Moving Vehicles/Trains,2,24,19,7,5,57,2,10,12,2,1,27,84
RAJASTHAN,2012,By Machine,0,2,6,0,0,8,0,0,0,0,0,0,8
RAJASTHAN,2012,By Overdose of sleeping pills,0,11,9,5,1,26,0,5,4,0,0,9,35
RAJASTHAN,2012,By touching electric wires,2,24,38,19,2,85,0,5,4,2,1,12,97
RAJASTHAN,2012,By coming under running vehicles/trains,0,40,45,24,5,114,3,15,7,1,2,28,142
RAJASTHAN,2012,By Other means (please specify),15,208,286,277,64,850,6,157,199,57,21,440,1290
RAJASTHAN,2012,Total,68,1086,1160,759,154,3227,40,741,562,191,60,1594,4821
RAJASTHAN,2012,Total (Poison),12,183,191,137,16,539,10,163,98,49,13,333,872
RAJASTHAN,2012,Total (Jumping),2,36,39,17,6,100,1,12,17,7,3,40,140
SIKKIM,2001,By Over Alcoholism,0,0,0,0,0,0,0,0,0,0,0,0,0
SIKKIM,2001,By Drowning,0,3,2,0,0,5,0,1,1,0,0,2,7
SIKKIM,2001,By Fire/Self Immolation,0,0,0,0,0,0,0,0,0,0,0,0,0
SIKKIM,2001,By Fire-Arms,0,0,0,0,0,0,0,1,0,0,0,1,1
SIKKIM,2001,By Hanging,0,11,12,3,3,29,2,10,10,0,0,22,51
SIKKIM,2001,By Consuming Insecticides,0,0,2,1,0,3,0,1,1,0,0,2,5
SIKKIM,2001,By Consuming Other Poison,0,1,1,0,0,2,0,0,1,0,0,1,3
SIKKIM,2001,By Self Infliction of injury,0,0,0,0,0,0,0,0,0,0,0,0,0
SIKKIM,2001,By Jumping from (Building),0,0,0,0,0,0,0,0,0,0,0,0,0
SIKKIM,2001,By Jumping from (Other sites),0,0,0,0,0,0,0,0,0,0,0,0,0
SIKKIM,2001,By Jumping off Moving Vehicles/Trains,0,0,0,0,0,0,0,0,0,0,0,0,0
SIKKIM,2001,By Machine,0,0,0,0,0,0,0,0,0,0,0,0,0
SIKKIM,2001,By Overdose of sleeping pills,0,1,0,0,0,1,0,0,0,0,0,0,1
SIKKIM,2001,By touching electric wires,0,0,0,0,0,0,0,0,0,0,0,0,0
SIKKIM,2001,By coming under running vehicles/trains,0,0,0,0,0,0,0,0,0,0,0,0,0
SIKKIM,2001,By Other means (please specify),0,11,10,1,0,22,0,1,3,0,0,4,26
SIKKIM,2001,Total,0,27,27,5,3,62,2,14,16,0,0,32,94
SIKKIM,2001,Total (Poison),0,1,3,1,0,5,0,1,2,0,0,3,8
SIKKIM,2001,Total (Jumping),0,0,0,0,0,0,0,0,0,0,0,0,0
SIKKIM,2002,By Over Alcoholism,0,2,5,4,0,11,0,0,0,0,0,0,11
SIKKIM,2002,By Drowning,0,0,0,0,0,0,0,0,0,0,0,0,0
SIKKIM,2002,By Fire/Self Immolation,0,0,0,0,0,0,0,0,0,0,0,0,0
SIKKIM,2002,By Fire-Arms,0,0,0,0,0,0,0,0,0,0,0,0,0
SIKKIM,2002,By Hanging,0,6,2,4,5,17,1,5,3,2,0,11,28
SIKKIM,2002,By Consuming Insecticides,0,0,0,0,0,0,0,0,0,0,0,0,0
SIKKIM,2002,By Consuming Other Poison,0,0,0,0,0,0,0,0,0,0,0,0,0
SIKKIM,2002,By Self Infliction of injury,0,0,0,0,0,0,0,0,0,0,0,0,0
SIKKIM,2002,By Jumping from (Building),0,0,0,0,0,0,0,0,0,0,0,0,0
SIKKIM,2002,By Jumping from (Other sites),0,0,7,3,0,10,0,4,1,1,0,6,16
SIKKIM,2002,By Jumping off Moving Vehicles/Trains,0,0,0,0,0,0,0,0,0,0,0,0,0
SIKKIM,2002,By Machine,0,0,0,0,0,0,0,0,0,0,0,0,0
SIKKIM,2002,By Overdose of sleeping pills,0,0,0,0,0,0,0,0,0,0,0,0,0
SIKKIM,2002,By touching electric wires,0,0,0,0,0,0,0,0,0,0,0,0,0
SIKKIM,2002,By coming under running vehicles/trains,0,0,0,0,0,0,0,0,0,0,0,0,0
SIKKIM,2002,By Other means,3,7,5,0,1,16,0,2,1,2,2,7,23
SIKKIM,2002,Total,3,15,19,11,6,54,1,11,5,5,2,24,78
SIKKIM,2002,Total (Poison),0,0,0,0,0,0,0,0,0,0,0,0,0
SIKKIM,2002,Total (Jumping),0,0,7,3,0,10,0,4,1,1,0,6,16
SIKKIM,2003,By Over Alcoholism,0,5,3,6,8,22,0,0,0,0,0,0,22
SIKKIM,2003,By Drowning,0,7,0,2,0,9,0,3,2,1,0,6,15
SIKKIM,2003,By Fire/Self Immolation,0,0,0,0,0,0,0,2,1,2,0,5,5
SIKKIM,2003,By Fire-Arms,0,0,1,0,0,1,0,0,0,0,0,0,1
SIKKIM,2003,By Hanging,1,10,8,6,4,29,0,4,5,8,9,26,55
SIKKIM,2003,By Consuming Insecticides,0,0,0,0,0,0,0,0,0,0,0,0,0
SIKKIM,2003,By Consuming Other Poison,0,0,0,0,0,0,0,0,0,0,0,0,0
SIKKIM,2003,By Self Infliction of injury,0,0,0,0,0,0,0,0,0,0,0,0,0
SIKKIM,2003,By Jumping from (Building),0,0,0,0,0,0,0,0,0,0,0,0,0
SIKKIM,2003,By Jumping from (Other sites),0,3,4,0,0,7,0,0,0,0,0,0,7
SIKKIM,2003,By Jumping off Moving Vehicles/Trains,0,0,0,0,0,0,0,0,0,0,0,0,0
SIKKIM,2003,By Machine,0,0,0,0,0,0,0,0,0,0,0,0,0
SIKKIM,2003,By Overdose of sleeping pills,0,0,0,0,0,0,0,0,0,0,0,0,0
SIKKIM,2003,By touching electric wires,0,0,0,0,0,0,0,0,0,0,0,0,0
SIKKIM,2003,By coming under running vehicles/trains,0,0,0,0,0,0,0,0,0,0,0,0,0
SIKKIM,2003,By Other means (please specify),0,0,0,0,0,0,0,0,0,0,0,0,0
SIKKIM,2003,Total,1,25,16,14,12,68,0,9,8,11,9,37,105
SIKKIM,2003,Total (Poison),0,0,0,0,0,0,0,0,0,0,0,0,0
SIKKIM,2003,Total (Jumping),0,3,4,0,0,7,0,0,0,0,0,0,7
SIKKIM,2004,By Over Alcoholism,0,0,0,0,0,0,0,0,0,0,0,0,0
SIKKIM,2004,By Drowning,0,0,2,0,0,2,0,0,0,0,0,0,2
SIKKIM,2004,By Fire/Self Immolation,0,0,0,0,0,0,0,0,0,0,0,0,0
SIKKIM,2004,By Fire-Arms,0,0,0,0,0,0,0,0,0,0,0,0,0
SIKKIM,2004,By Hanging,0,0,10,9,20,39,0,0,7,10,15,32,71
SIKKIM,2004,By Consuming Insecticides,0,0,2,4,0,6,0,0,1,0,0,1,7
SIKKIM,2004,By Consuming Other Poison,0,0,0,0,0,0,0,0,0,0,0,0,0
SIKKIM,2004,By Self Infliction of injury,0,0,0,0,1,1,0,0,0,0,0,0,1
SIKKIM,2004,By Jumping from (Building),0,0,0,0,0,0,0,0,0,0,0,0,0
SIKKIM,2004,By Jumping from (Other sites),0,0,0,0,0,0,0,0,0,1,0,1,1
SIKKIM,2004,By Jumping off Moving Vehicles/Trains,0,0,0,0,0,0,0,0,0,0,0,0,0
SIKKIM,2004,By Machine,0,0,0,0,0,0,0,0,0,0,0,0,0
SIKKIM,2004,By Overdose of sleeping pills,0,0,0,0,0,0,0,0,0,0,0,0,0
SIKKIM,2004,By touching electric wires,0,0,0,0,0,0,0,0,0,0,0,0,0
SIKKIM,2004,By coming under running vehicles/trains,0,0,0,0,0,0,0,0,0,0,0,0,0
SIKKIM,2004,By Other means (please specify),0,0,3,0,5,8,0,0,1,4,3,8,16
SIKKIM,2004,Total,0,0,17,13,26,56,0,0,9,15,18,42,98
SIKKIM,2004,Total (Poison),0,0,2,4,1,7,0,0,1,0,0,1,8
SIKKIM,2004,Total (Jumping),0,0,0,0,0,0,0,0,0,1,0,1,1
SIKKIM,2005,By Over Alcoholism,0,0,0,0,0,0,0,0,0,0,0,0,0
SIKKIM,2005,By Drowning,0,0,0,0,0,0,0,0,0,0,0,0,0
SIKKIM,2005,By Fire/Self Immolation,0,0,0,0,0,0,0,0,0,0,0,0,0
SIKKIM,2005,By Fire-Arms,0,0,0,0,0,0,0,0,0,0,0,0,0
SIKKIM,2005,By Hanging,2,21,16,13,3,55,1,14,16,6,4,41,96
SIKKIM,2005,By Consuming Insecticides,0,0,0,0,1,1,0,0,0,0,0,0,1
SIKKIM,2005,By Consuming Other Poison,0,0,0,0,0,0,0,0,0,0,0,0,0
SIKKIM,2005,By Self Infliction of injury,0,0,0,0,0,0,0,0,0,0,0,0,0
SIKKIM,2005,By Jumping from (Building),0,0,0,0,0,0,0,0,0,0,0,0,0
SIKKIM,2005,By Jumping from (Other sites),0,0,0,0,0,0,0,0,0,0,0,0,0
SIKKIM,2005,By Jumping off Moving Vehicles/Trains,0,0,0,0,0,0,0,0,0,0,0,0,0
SIKKIM,2005,By Machine,0,0,0,0,0,0,0,0,0,0,0,0,0
SIKKIM,2005,By Overdose of sleeping pills,0,0,0,0,0,0,0,0,0,0,0,0,0
SIKKIM,2005,By touching electric wires,0,0,0,0,0,0,0,0,0,0,0,0,0
SIKKIM,2005,By coming under running vehicles/trains,0,0,0,0,0,0,0,0,0,0,0,0,0
SIKKIM,2005,By Other means (please specify),0,5,1,0,0,6,1,0,3,1,1,6,12
SIKKIM,2005,Total,2,26,17,13,4,62,2,14,19,7,5,47,109
SIKKIM,2005,Total (Poison),0,0,0,0,1,1,0,0,0,0,0,0,1
SIKKIM,2005,Total (Jumping),0,0,0,0,0,0,0,0,0,0,0,0,0
SIKKIM,2006,By Over Alcoholism,0,1,2,0,0,3,0,0,0,0,1,1,4
SIKKIM,2006,By Drowning,1,10,4,2,0,17,1,2,0,0,0,3,20
SIKKIM,2006,By Fire/Self Immolation,0,0,0,0,0,0,0,0,0,0,0,0,0
SIKKIM,2006,By Fire-Arms,0,1,0,0,0,1,0,0,0,0,0,0,1
SIKKIM,2006,By Hanging,3,34,22,12,0,71,2,22,13,1,3,41,112
SIKKIM,2006,By Consuming Insecticides,0,0,0,0,0,0,0,0,0,0,0,0,0
SIKKIM,2006,By Consuming Other Poison,0,2,3,0,0,5,0,2,0,0,0,2,7
SIKKIM,2006,By Self Infliction of injury,0,1,0,0,0,1,0,0,0,0,0,0,1
SIKKIM,2006,By Jumping from (Building),0,0,0,0,0,0,0,0,0,0,0,0,0
SIKKIM,2006,By Jumping from (Other sites),0,0,0,0,0,0,0,0,0,0,0,0,0
SIKKIM,2006,By Jumping off Moving Vehicles/Trains,0,0,0,0,0,0,0,0,0,0,0,0,0
SIKKIM,2006,By Machine,0,0,0,0,0,0,0,0,0,0,0,0,0
SIKKIM,2006,By Overdose of sleeping pills,0,0,0,0,0,0,0,0,0,0,0,0,0
SIKKIM,2006,By touching electric wires,0,0,0,0,0,0,0,0,0,0,0,0,0
SIKKIM,2006,By coming under running vehicles/trains,0,0,0,0,0,0,0,0,0,0,0,0,0
SIKKIM,2006,By Other means (please specify),0,0,0,0,0,0,0,0,0,0,0,0,0
SIKKIM,2006,Total,4,49,31,14,0,98,3,26,13,1,4,47,145
SIKKIM,2006,Total (Poison),0,3,3,0,0,6,0,2,0,0,0,2,8
SIKKIM,2006,Total (Jumping),0,0,0,0,0,0,0,0,0,0,0,0,0
SIKKIM,2007,By Over Alcoholism,0,0,0,0,0,0,0,0,0,0,0,0,0
SIKKIM,2007,By Drowning,0,0,0,0,0,0,0,0,0,0,0,0,0
SIKKIM,2007,By Fire/Self Immolation,0,0,0,0,0,0,0,0,0,0,0,0,0
SIKKIM,2007,By Fire-Arms,0,0,0,0,0,0,0,0,0,0,0,0,0
SIKKIM,2007,By Hanging,5,30,14,8,2,59,6,16,8,4,0,34,93
SIKKIM,2007,By Consuming Insecticides,0,0,0,0,0,0,0,0,0,0,0,0,0
SIKKIM,2007,By Consuming Other Poison,0,0,0,0,0,0,0,0,0,0,0,0,0
SIKKIM,2007,By Self Infliction of injury,0,0,0,0,0,0,0,0,0,0,0,0,0
SIKKIM,2007,By Jumping from (Building),0,0,0,0,0,0,0,0,0,0,0,0,0
SIKKIM,2007,By Jumping from (Other sites),0,0,0,0,0,0,0,0,0,0,0,0,0
SIKKIM,2007,By Jumping off Moving Vehicles/Trains,0,0,0,0,0,0,0,0,0,0,0,0,0
SIKKIM,2007,By Machine,0,0,0,0,0,0,0,0,0,0,0,0,0
SIKKIM,2007,By Overdose of sleeping pills,0,0,0,0,0,0,0,0,0,0,0,0,0
SIKKIM,2007,By touching electric wires,0,0,0,0,0,0,0,0,0,0,0,0,0
SIKKIM,2007,By coming under running vehicles/trains,0,0,0,0,0,0,0,0,0,0,0,0,0
SIKKIM,2007,By Other means (please specify),0,11,10,4,0,25,1,3,0,0,0,4,29
SIKKIM,2007,Total,5,41,24,12,2,84,7,19,8,4,0,38,122
SIKKIM,2007,Total (Poison),0,0,0,0,0,0,0,0,0,0,0,0,0
SIKKIM,2007,Total (Jumping),0,0,0,0,0,0,0,0,0,0,0,0,0
SIKKIM,2008,By Over Alcoholism,0,0,1,1,1,3,0,0,0,0,0,0,3
SIKKIM,2008,By Drowning,0,0,0,0,0,0,0,0,0,0,0,0,0
SIKKIM,2008,By Fire/Self Immolation,0,2,0,0,0,2,0,2,0,0,0,2,4
SIKKIM,2008,By Fire-Arms,0,0,0,0,0,0,0,0,0,0,0,0,0
SIKKIM,2008,By Hanging,2,20,26,24,8,80,0,18,20,8,3,49,129
SIKKIM,2008,By Consuming Insecticides,0,1,2,0,0,3,0,2,1,0,0,3,6
SIKKIM,2008,By Consuming Other Poison,0,0,0,0,0,0,0,0,0,0,0,0,0
SIKKIM,2008,By Self Infliction of injury,0,0,0,0,0,0,0,0,0,0,0,0,0
SIKKIM,2008,By Jumping from (Building),0,0,0,0,0,0,0,0,0,0,0,0,0
SIKKIM,2008,By Jumping from (Other sites),0,0,0,0,0,0,0,0,0,0,0,0,0
SIKKIM,2008,By Jumping off Moving Vehicles/Trains,0,0,0,0,0,0,0,0,0,0,0,0,0
SIKKIM,2008,By Machine,0,0,0,0,0,0,0,0,0,0,0,0,0
SIKKIM,2008,By Overdose of sleeping pills,0,0,0,0,0,0,0,0,0,0,0,0,0
SIKKIM,2008,By touching electric wires,0,2,0,0,0,2,0,0,0,0,0,0,2
SIKKIM,2008,By coming under running vehicles/trains,0,0,0,0,0,0,0,0,0,0,0,0,0
SIKKIM,2008,By Other means (please specify),0,45,40,40,1,126,0,4,5,5,3,17,143
SIKKIM,2008,Total,2,70,69,65,10,216,0,26,26,13,6,71,287
SIKKIM,2008,Total (Poison),0,1,2,0,0,3,0,2,1,0,0,3,6
SIKKIM,2008,Total (Jumping),0,0,0,0,0,0,0,0,0,0,0,0,0
SIKKIM,2009,By Over Alcoholism,1,1,0,0,0,2,0,0,0,0,1,1,3
SIKKIM,2009,By Drowning,0,0,0,0,0,0,0,0,0,0,0,0,0
SIKKIM,2009,By Fire/Self Immolation,0,0,0,0,0,0,0,0,0,0,0,0,0
SIKKIM,2009,By Fire-Arms,0,0,0,0,0,0,0,0,0,0,0,0,0
SIKKIM,2009,By Hanging,1,38,18,19,6,82,1,38,11,10,6,66,148
SIKKIM,2009,By Consuming Insecticides,0,0,0,0,0,0,0,0,0,0,0,0,0
SIKKIM,2009,By Consuming Other Poison,0,0,0,0,0,0,0,0,0,0,0,0,0
SIKKIM,2009,By Self Infliction of injury,0,0,0,0,0,0,0,0,0,0,0,0,0
SIKKIM,2009,By Jumping from (Building),0,0,0,0,0,0,0,0,0,0,0,0,0
SIKKIM,2009,By Jumping from (Other sites),1,3,0,1,0,5,0,1,0,0,0,1,6
SIKKIM,2009,By Jumping off Moving Vehicles/Trains,0,0,0,0,0,0,0,0,0,0,0,0,0
SIKKIM,2009,By Machine,0,0,0,0,0,0,0,0,0,0,0,0,0
SIKKIM,2009,By Overdose of sleeping pills,0,0,0,0,0,0,0,0,3,3,0,6,6
SIKKIM,2009,By touching electric wires,0,0,0,0,0,0,0,0,5,2,0,7,7
SIKKIM,2009,By coming under running vehicles/trains,0,0,0,0,0,0,0,0,0,0,0,0,0
SIKKIM,2009,By Other means (please specify),0,23,5,3,2,33,2,18,10,8,0,38,71
SIKKIM,2009,Total,3,65,23,23,8,122,3,57,29,23,7,119,241
SIKKIM,2009,Total (Poison),0,0,0,0,0,0,0,0,0,0,0,0,0
SIKKIM,2009,Total (Jumping),1,3,0,1,0,5,0,1,0,0,0,1,6
SIKKIM,2010,By Over Alcoholism,0,0,2,0,0,2,0,0,0,0,0,0,2
SIKKIM,2010,By Drowning,2,3,0,0,0,5,0,1,0,0,0,1,6
SIKKIM,2010,By Fire/Self Immolation,0,0,0,0,0,0,0,0,0,0,0,0,0
SIKKIM,2010,By Fire-Arms,0,0,0,0,0,0,0,0,0,0,0,0,0
SIKKIM,2010,By Hanging,0,61,45,11,2,119,0,11,18,9,2,40,159
SIKKIM,2010,By Consuming Insecticides,0,0,3,2,0,5,0,1,0,1,0,2,7
SIKKIM,2010,By Consuming Other Poison,0,5,0,1,2,8,0,0,1,0,1,2,10
SIKKIM,2010,By Self Infliction of injury,0,0,0,0,2,2,0,0,0,0,0,0,2
SIKKIM,2010,By Jumping from (Building),0,0,2,0,1,3,0,0,0,0,0,0,3
SIKKIM,2010,By Jumping from (Other sites),3,0,0,0,0,3,0,0,0,0,0,0,3
SIKKIM,2010,By Jumping off Moving Vehicles/Trains,0,0,0,0,0,0,0,0,0,0,0,0,0
SIKKIM,2010,By Machine,0,0,0,0,0,0,0,0,0,0,0,0,0
SIKKIM,2010,By Overdose of sleeping pills,0,0,0,0,0,0,0,0,0,0,0,0,0
SIKKIM,2010,By touching electric wires,0,0,0,0,0,0,0,0,0,0,0,0,0
SIKKIM,2010,By coming under running vehicles/trains,0,0,0,0,0,0,0,0,0,0,0,0,0
SIKKIM,2010,By Other means (please specify),16,29,19,16,8,88,0,0,0,0,0,0,88
SIKKIM,2010,Total,21,98,71,30,15,235,0,13,19,10,3,45,280
SIKKIM,2010,Total (Poison),0,5,3,3,4,15,0,1,1,1,1,4,19
SIKKIM,2010,Total (Jumping),3,0,2,0,1,6,0,0,0,0,0,0,6
SIKKIM,2011,By Over Alcoholism,0,2,2,0,0,4,0,0,0,0,0,0,4
SIKKIM,2011,By Drowning,0,10,8,0,0,18,0,3,0,3,0,6,24
SIKKIM,2011,By Fire/Self Immolation,0,0,0,0,0,0,0,0,0,0,0,0,0
SIKKIM,2011,By Fire-Arms,0,0,0,0,0,0,0,0,0,0,0,0,0
SIKKIM,2011,By Hanging,4,28,26,25,2,85,2,22,18,14,3,59,144
SIKKIM,2011,By Consuming Insecticides,0,0,0,0,0,0,0,0,0,0,0,0,0
SIKKIM,2011,By Consuming Other Poison,0,0,0,0,0,0,0,5,4,1,0,10,10
SIKKIM,2011,By Self Infliction of injury,0,0,0,0,0,0,0,0,0,0,0,0,0
SIKKIM,2011,By Jumping from (Building),0,0,0,0,0,0,0,0,0,0,0,0,0
SIKKIM,2011,By Jumping from (Other sites),0,0,0,0,0,0,0,2,0,0,0,2,2
SIKKIM,2011,By Jumping off Moving Vehicles/Trains,0,0,0,0,0,0,0,0,0,0,0,0,0
SIKKIM,2011,By Machine,0,0,0,0,0,0,0,0,0,0,0,0,0
SIKKIM,2011,By Overdose of sleeping pills,0,0,0,0,0,0,0,0,0,0,0,0,0
SIKKIM,2011,By touching electric wires,0,0,0,0,0,0,0,0,0,0,0,0,0
SIKKIM,2011,By coming under running vehicles/trains,0,0,0,0,0,0,0,0,0,0,0,0,0
SIKKIM,2011,By Other means (please specify),0,0,0,0,0,0,0,0,0,0,0,0,0
SIKKIM,2011,Total,4,40,36,25,2,107,2,32,22,18,3,77,184
SIKKIM,2011,Total (Poison),0,0,0,0,0,0,0,5,4,1,0,10,10
SIKKIM,2011,Total (Jumping),0,0,0,0,0,0,0,2,0,0,0,2,2
SIKKIM,2012,By Over Alcoholism,0,7,6,5,0,18,0,7,7,0,1,15,33
SIKKIM,2012,By Drowning,3,2,0,3,0,8,3,3,0,1,0,7,15
SIKKIM,2012,By Fire/Self Immolation,0,0,0,0,0,0,0,0,0,0,0,0,0
SIKKIM,2012,By Fire-Arms,0,0,0,0,0,0,0,0,0,0,0,0,0
SIKKIM,2012,By Hanging,2,26,20,12,10,70,3,20,19,8,0,50,120
SIKKIM,2012,By Consuming Insecticides,0,0,0,0,0,0,0,1,0,0,0,1,1
SIKKIM,2012,By Consuming Other Poison,0,0,0,0,0,0,0,0,0,0,0,0,0
SIKKIM,2012,By Self Infliction of injury,0,0,0,0,0,0,0,0,0,0,0,0,0
SIKKIM,2012,By Jumping from (Building),0,0,0,0,0,0,0,0,0,0,0,0,0
SIKKIM,2012,By Jumping from (Other sites),0,0,0,0,0,0,0,0,0,0,0,0,0
SIKKIM,2012,By Jumping off Moving Vehicles/Trains,0,0,0,0,0,0,0,0,0,0,0,0,0
SIKKIM,2012,By Machine,0,0,0,0,0,0,0,0,0,0,0,0,0
SIKKIM,2012,By Overdose of sleeping pills,0,0,0,0,0,0,0,2,0,0,0,2,2
SIKKIM,2012,By touching electric wires,0,0,0,0,0,0,0,0,0,0,0,0,0
SIKKIM,2012,By coming under running vehicles/trains,0,0,0,0,0,0,0,0,0,0,0,0,0
SIKKIM,2012,By Other means (please specify),0,0,0,0,0,0,0,2,4,0,4,10,10
SIKKIM,2012,Total,5,35,26,20,10,96,6,35,30,9,5,85,181
SIKKIM,2012,Total (Poison),0,0,0,0,0,0,0,1,0,0,0,1,1
SIKKIM,2012,Total (Jumping),0,0,0,0,0,0,0,0,0,0,0,0,0
TAMIL NADU,2001,By Over Alcoholism,0,4,50,39,15,108,0,0,0,0,0,0,108
TAMIL NADU,2001,By Drowning,17,128,152,141,46,484,7,90,71,31,19,218,702
TAMIL NADU,2001,By Fire/Self Immolation,17,187,226,117,33,580,25,457,343,143,36,1004,1584
TAMIL NADU,2001,By Fire-Arms,0,3,2,0,0,5,0,0,0,0,0,0,5
TAMIL NADU,2001,By Hanging,31,380,453,292,97,1253,36,343,270,156,32,837,2090
TAMIL NADU,2001,By Consuming Insecticides,17,395,400,225,87,1124,13,174,183,74,22,466,1590
TAMIL NADU,2001,By Consuming Other Poison,18,630,951,601,144,2344,27,445,398,161,43,1074,3418
TAMIL NADU,2001,By Self Infliction of injury,0,0,41,17,0,58,0,3,0,0,0,3,61
TAMIL NADU,2001,By Jumping from (Building),6,24,21,14,6,71,0,1,3,2,0,6,77
TAMIL NADU,2001,By Jumping from (Other sites),7,25,49,15,6,102,6,5,11,9,2,33,135
TAMIL NADU,2001,By Jumping off Moving Vehicles/Trains,2,8,5,3,0,18,0,5,17,1,0,23,41
TAMIL NADU,2001,By Machine,0,19,23,9,0,51,0,1,2,0,0,3,54
TAMIL NADU,2001,By Overdose of sleeping pills,0,50,33,27,16,126,1,26,11,23,23,84,210
TAMIL NADU,2001,By touching electric wires,1,51,25,12,1,90,1,4,6,0,0,11,101
TAMIL NADU,2001,By coming under running vehicles/trains,3,34,24,32,7,100,0,15,10,4,0,29,129
TAMIL NADU,2001,By Other means (please specify),27,177,227,129,54,614,29,133,119,54,36,371,985
TAMIL NADU,2001,Total,146,2115,2682,1673,512,7128,145,1702,1444,658,213,4162,11290
TAMIL NADU,2001,Total (Poison),35,1025,1392,843,231,3526,40,622,581,235,65,1543,5069
TAMIL NADU,2001,Total (Jumping),13,49,70,29,12,173,6,6,14,11,2,39,212
TAMIL NADU,2002,By Over Alcoholism,0,23,42,29,4,98,0,0,0,0,0,0,98
TAMIL NADU,2002,By Drowning,21,170,143,136,40,510,12,107,100,46,12,277,787
TAMIL NADU,2002,By Fire/Self Immolation,8,221,234,123,37,623,29,535,320,142,36,1062,1685
TAMIL NADU,2002,By Fire-Arms,1,0,1,2,0,4,0,2,2,1,0,5,9
TAMIL NADU,2002,By Hanging,3,365,500,392,105,1365,10,409,247,95,43,804,2169
TAMIL NADU,2002,By Consuming Insecticides,8,284,283,169,56,800,17,164,122,89,32,424,1224
TAMIL NADU,2002,By Consuming Other Poison,17,584,865,673,159,2298,24,503,358,214,65,1164,3462
TAMIL NADU,2002,By Self Infliction of injury,0,3,4,2,0,9,0,6,5,2,1,14,23
TAMIL NADU,2002,By Jumping from (Building),0,25,30,16,13,84,4,5,13,8,0,30,114
TAMIL NADU,2002,By Jumping from (Other sites),7,39,61,35,6,148,3,9,20,9,2,43,191
TAMIL NADU,2002,By Jumping off Moving Vehicles/Trains,0,0,6,0,0,6,0,3,0,0,0,3,9
TAMIL NADU,2002,By Machine,0,18,5,0,0,23,0,4,1,0,0,5,28
TAMIL NADU,2002,By Overdose of sleeping pills,1,27,37,8,2,75,0,22,23,10,14,69,144
TAMIL NADU,2002,By touching electric wires,1,24,21,6,1,53,0,2,3,1,0,6,59
TAMIL NADU,2002,By coming under running vehicles/trains,1,49,79,27,22,178,1,8,23,12,6,50,228
TAMIL NADU,2002,By Other means,31,161,241,178,98,709,45,80,81,78,21,305,1014
TAMIL NADU,2002,Total,99,1993,2552,1796,543,6983,145,1859,1318,707,232,4261,11244
TAMIL NADU,2002,Total (Poison),25,871,1152,844,215,3107,41,673,485,305,98,1602,4709
TAMIL NADU,2002,Total (Jumping),7,64,91,51,19,232,7,14,33,17,2,73,305
TAMIL NADU,2003,By Over Alcoholism,0,8,27,46,8,89,0,0,1,0,0,1,90
TAMIL NADU,2003,By Drowning,21,180,189,113,33,536,20,122,102,39,18,301,837
TAMIL NADU,2003,By Fire/Self Immolation,18,178,203,89,22,510,28,418,315,137,36,934,1444
TAMIL NADU,2003,By Fire-Arms,0,3,0,0,0,3,0,0,0,1,1,2,5
TAMIL NADU,2003,By Hanging,19,409,581,372,119,1500,30,460,336,196,38,1060,2560
TAMIL NADU,2003,By Consuming Insecticides,13,335,396,215,128,1087,18,185,129,159,57,548,1635
TAMIL NADU,2003,By Consuming Other Poison,18,582,726,646,249,2221,25,401,450,238,83,1197,3418
TAMIL NADU,2003,By Self Infliction of injury,0,1,0,2,0,3,0,1,2,4,3,10,13
TAMIL NADU,2003,By Jumping from (Building),3,11,7,5,7,33,1,4,4,0,2,11,44
TAMIL NADU,2003,By Jumping from (Other sites),0,13,12,7,1,33,0,11,10,3,0,24,57
TAMIL NADU,2003,By Jumping off Moving Vehicles/Trains,0,0,0,0,1,1,0,3,0,0,0,3,4
TAMIL NADU,2003,By Machine,0,8,3,2,0,13,0,0,0,0,0,0,13
TAMIL NADU,2003,By Overdose of sleeping pills,1,20,21,21,9,72,6,34,42,25,2,109,181
TAMIL NADU,2003,By touching electric wires,0,25,38,15,3,81,1,11,8,4,0,24,105
TAMIL NADU,2003,By coming under running vehicles/trains,9,24,33,28,5,99,4,10,10,13,8,45,144
TAMIL NADU,2003,By Other means (please specify),35,168,282,280,108,873,33,84,168,107,57,449,1322
TAMIL NADU,2003,Total,137,1965,2518,1841,693,7154,166,1744,1577,926,305,4718,11872
TAMIL NADU,2003,Total (Poison),31,918,1122,863,377,3311,43,587,581,401,143,1755,5066
TAMIL NADU,2003,Total (Jumping),3,24,19,12,8,66,1,15,14,3,2,35,101
TAMIL NADU,2004,By Over Alcoholism,0,17,42,26,4,89,1,0,0,0,0,1,90
TAMIL NADU,2004,By Drowning,18,143,162,115,42,480,15,82,78,39,11,225,705
TAMIL NADU,2004,By Fire/Self Immolation,12,138,159,96,24,429,34,423,287,170,46,960,1389
TAMIL NADU,2004,By Fire-Arms,0,0,0,0,0,0,0,3,3,1,0,7,7
TAMIL NADU,2004,By Hanging,25,476,661,427,159,1748,36,475,400,196,56,1163,2911
TAMIL NADU,2004,By Consuming Insecticides,13,350,438,376,68,1245,22,262,228,118,38,668,1913
TAMIL NADU,2004,By Consuming Other Poison,31,456,737,643,262,2129,27,350,373,272,76,1098,3227
TAMIL NADU,2004,By Self Infliction of injury,0,1,5,2,0,8,0,0,1,0,0,1,9
TAMIL NADU,2004,By Jumping from (Building),0,20,32,17,4,73,1,4,10,3,0,18,91
TAMIL NADU,2004,By Jumping from (Other sites),4,41,48,16,15,124,1,11,12,9,2,35,159
TAMIL NADU,2004,By Jumping off Moving Vehicles/Trains,0,2,6,3,0,11,0,0,3,2,0,5,16
TAMIL NADU,2004,By Machine,0,9,5,2,0,16,0,0,0,0,0,0,16
TAMIL NADU,2004,By Overdose of sleeping pills,1,17,25,33,11,87,0,33,13,22,5,73,160
TAMIL NADU,2004,By touching electric wires,1,31,37,24,6,99,2,10,20,3,1,36,135
TAMIL NADU,2004,By coming under running vehicles/trains,0,35,16,11,6,68,0,5,4,2,1,12,80
TAMIL NADU,2004,By Other means (please specify),85,284,380,379,212,1340,37,156,123,184,91,591,1931
TAMIL NADU,2004,Total,190,2020,2753,2170,813,7946,176,1814,1555,1021,327,4893,12839
TAMIL NADU,2004,Total (Poison),44,807,1180,1021,330,3382,49,612,602,390,114,1767,5149
TAMIL NADU,2004,Total (Jumping),4,61,80,33,19,197,2,15,22,12,2,53,250
TAMIL NADU,2005,By Over Alcoholism,0,10,37,21,2,70,1,0,0,0,0,1,71
TAMIL NADU,2005,By Drowning,17,123,152,105,38,435,14,72,58,29,14,187,622
TAMIL NADU,2005,By Fire/Self Immolation,11,118,149,86,20,384,31,403,227,160,54,875,1259
TAMIL NADU,2005,By Fire-Arms,0,0,0,0,0,0,0,3,1,1,0,5,5
TAMIL NADU,2005,By Hanging,20,446,652,401,148,1667,32,455,365,186,66,1104,2771
TAMIL NADU,2005,By Consuming Insecticides,10,340,418,306,58,1132,20,252,208,108,45,633,1765
TAMIL NADU,2005,By Consuming Other Poison,30,426,727,585,241,2009,25,340,339,252,87,1043,3052
TAMIL NADU,2005,By Self Infliction of injury,0,1,5,2,0,8,0,0,1,0,0,1,9
TAMIL NADU,2005,By Jumping from (Building),0,14,29,14,3,60,1,4,8,2,0,15,75
TAMIL NADU,2005,By Jumping from (Other sites),4,38,44,13,11,110,0,8,11,7,2,28,138
TAMIL NADU,2005,By Jumping off Moving Vehicles/Trains,0,2,6,3,0,11,0,0,2,1,0,3,14
TAMIL NADU,2005,By Machine,0,8,5,2,0,15,0,0,0,0,0,0,15
TAMIL NADU,2005,By Overdose of sleeping pills,1,16,21,29,8,75,0,29,9,11,7,56,131
TAMIL NADU,2005,By touching electric wires,1,28,29,21,4,83,1,10,20,3,2,36,119
TAMIL NADU,2005,By coming under running vehicles/trains,0,25,11,10,5,51,0,4,3,2,3,12,63
TAMIL NADU,2005,By Other means (please specify),53,371,422,369,182,1397,47,155,113,161,94,570,1967
TAMIL NADU,2005,Total,147,1966,2707,1967,720,7507,172,1735,1365,923,374,4569,12076
TAMIL NADU,2005,Total (Poison),40,767,1150,893,299,3149,45,592,548,360,132,1677,4826
TAMIL NADU,2005,Total (Jumping),4,52,73,27,14,170,1,12,19,9,2,43,213
TAMIL NADU,2006,By Over Alcoholism,0,26,71,33,9,139,0,0,0,0,2,2,141
TAMIL NADU,2006,By Drowning,6,183,272,198,91,750,51,70,51,27,21,220,970
TAMIL NADU,2006,By Fire/Self Immolation,10,184,271,191,50,706,8,720,434,164,54,1380,2086
TAMIL NADU,2006,By Fire-Arms,0,0,6,2,1,9,0,2,3,1,0,6,15
TAMIL NADU,2006,By Hanging,0,581,759,426,150,1916,0,490,429,226,52,1197,3113
TAMIL NADU,2006,By Consuming Insecticides,10,272,369,203,106,960,21,183,138,98,68,508,1468
TAMIL NADU,2006,By Consuming Other Poison,0,512,604,427,134,1677,0,380,357,181,49,967,2644
TAMIL NADU,2006,By Self Infliction of injury,0,0,3,1,0,4,0,0,0,0,0,0,4
TAMIL NADU,2006,By Jumping from (Building),0,17,38,21,1,77,0,10,7,2,0,19,96
TAMIL NADU,2006,By Jumping from (Other sites),0,18,9,12,6,45,0,5,10,7,1,23,68
TAMIL NADU,2006,By Jumping off Moving Vehicles/Trains,0,0,0,0,0,0,0,0,0,0,0,0,0
TAMIL NADU,2006,By Machine,0,6,1,3,0,10,0,0,1,0,0,1,11
TAMIL NADU,2006,By Overdose of sleeping pills,0,5,10,5,3,23,0,11,6,7,3,27,50
TAMIL NADU,2006,By touching electric wires,0,20,31,11,2,64,0,3,10,1,2,16,80
TAMIL NADU,2006,By coming under running vehicles/trains,0,44,31,36,12,123,0,8,10,3,1,22,145
TAMIL NADU,2006,By Other means (please specify),0,128,322,366,190,1006,0,113,165,153,53,484,1490
TAMIL NADU,2006,Total,26,1996,2797,1935,755,7509,80,1995,1621,870,306,4872,12381
TAMIL NADU,2006,Total (Poison),10,784,976,631,240,2641,21,563,495,279,117,1475,4116
TAMIL NADU,2006,Total (Jumping),0,35,47,33,7,122,0,15,17,9,1,42,164
TAMIL NADU,2007,By Over Alcoholism,0,30,82,38,10,160,0,0,0,0,2,2,162
TAMIL NADU,2007,By Drowning,7,212,315,229,105,868,54,73,54,28,22,231,1099
TAMIL NADU,2007,By Fire/Self Immolation,12,211,314,221,58,816,8,758,456,172,57,1451,2267
TAMIL NADU,2007,By Fire-Arms,0,0,7,2,1,10,0,2,3,1,0,6,16
TAMIL NADU,2007,By Hanging,0,672,878,493,174,2217,0,515,451,238,55,1259,3476
TAMIL NADU,2007,By Consuming Insecticides,11,315,427,235,123,1111,21,193,144,108,68,534,1645
TAMIL NADU,2007,By Consuming Other Poison,0,592,699,494,155,1940,0,400,375,190,52,1017,2957
TAMIL NADU,2007,By Self Infliction of injury,0,0,4,1,0,5,0,0,0,0,0,0,5
TAMIL NADU,2007,By Jumping from (Building),0,20,44,24,1,89,0,11,7,2,0,20,109
TAMIL NADU,2007,By Jumping from (Other sites),0,21,10,14,7,52,0,6,10,7,1,24,76
TAMIL NADU,2007,By Jumping off Moving Vehicles/Trains,0,0,0,0,0,0,0,0,0,0,0,0,0
TAMIL NADU,2007,By Machine,0,7,2,3,0,12,0,0,1,0,0,1,13
TAMIL NADU,2007,By Overdose of sleeping pills,0,5,12,6,4,27,0,12,6,7,3,28,55
TAMIL NADU,2007,By touching electric wires,0,23,36,13,2,74,0,3,11,1,2,17,91
TAMIL NADU,2007,By coming under running vehicles/trains,0,50,36,42,14,142,0,10,10,3,1,24,166
TAMIL NADU,2007,By Other means (please specify),0,153,371,422,218,1164,0,119,174,161,56,510,1674
TAMIL NADU,2007,Total,30,2311,3237,2237,872,8687,83,2102,1702,918,319,5124,13811
TAMIL NADU,2007,Total (Poison),11,907,1130,730,278,3056,21,593,519,298,120,1551,4607
TAMIL NADU,2007,Total (Jumping),0,41,54,38,8,141,0,17,17,9,1,44,185
TAMIL NADU,2008,By Over Alcoholism,0,33,115,43,7,198,0,0,0,0,0,0,198
TAMIL NADU,2008,By Drowning,3,249,316,235,54,857,31,85,89,42,22,269,1126
TAMIL NADU,2008,By Fire/Self Immolation,5,185,319,225,57,791,17,838,392,135,36,1418,2209
TAMIL NADU,2008,By Fire-Arms,0,0,9,3,0,12,0,0,0,0,10,10,22
TAMIL NADU,2008,By Hanging,0,785,886,525,175,2371,0,535,497,247,41,1320,3691
TAMIL NADU,2008,By Consuming Insecticides,7,335,435,327,123,1227,0,175,179,135,91,580,1807
TAMIL NADU,2008,By Consuming Other Poison,5,685,673,478,155,1996,10,405,395,197,52,1059,3055
TAMIL NADU,2008,By Self Infliction of injury,0,0,4,1,0,5,0,0,0,7,10,17,22
TAMIL NADU,2008,By Jumping from (Building),0,27,43,24,1,95,0,15,17,12,10,54,149
TAMIL NADU,2008,By Jumping from (Other sites),0,30,10,14,7,61,10,6,10,7,1,34,95
TAMIL NADU,2008,By Jumping off Moving Vehicles/Trains,0,0,0,0,0,0,0,0,0,0,0,0,0
TAMIL NADU,2008,By Machine,0,7,2,3,0,12,0,0,1,10,0,11,23
TAMIL NADU,2008,By Overdose of sleeping pills,5,5,12,6,4,32,0,12,6,7,7,32,64
TAMIL NADU,2008,By touching electric wires,0,23,36,13,2,74,0,3,11,1,2,17,91
TAMIL NADU,2008,By coming under running vehicles/trains,0,50,36,42,14,142,0,32,10,3,1,46,188
TAMIL NADU,2008,By Other means (please specify),5,149,369,375,272,1170,15,109,174,161,56,515,1685
TAMIL NADU,2008,Total,30,2563,3265,2314,871,9043,83,2215,1781,964,339,5382,14425
TAMIL NADU,2008,Total (Poison),12,1020,1112,806,278,3228,10,580,574,339,153,1656,4884
TAMIL NADU,2008,Total (Jumping),0,57,53,38,8,156,10,21,27,19,11,88,244
TAMIL NADU,2009,By Over Alcoholism,2,18,82,67,11,180,0,0,19,4,0,23,203
TAMIL NADU,2009,By Drowning,58,197,183,127,72,637,27,60,69,45,17,218,855
TAMIL NADU,2009,By Fire/Self Immolation,2,199,323,115,46,685,16,607,481,224,51,1379,2064
TAMIL NADU,2009,By Fire-Arms,0,0,0,1,0,1,0,4,0,0,0,4,5
TAMIL NADU,2009,By Hanging,4,694,802,493,170,2163,22,553,388,191,91,1245,3408
TAMIL NADU,2009,By Consuming Insecticides,17,753,1027,787,357,2941,24,545,492,317,164,1542,4483
TAMIL NADU,2009,By Consuming Other Poison,0,0,0,0,0,0,0,0,0,0,0,0,0
TAMIL NADU,2009,By Self Infliction of injury,0,8,7,4,9,28,0,6,3,2,1,12,40
TAMIL NADU,2009,By Jumping from (Building),3,16,18,11,11,59,3,4,9,3,1,20,79
TAMIL NADU,2009,By Jumping from (Other sites),3,32,23,18,17,93,1,5,13,11,1,31,124
TAMIL NADU,2009,By Jumping off Moving Vehicles/Trains,11,46,184,76,9,326,4,16,27,9,4,60,386
TAMIL NADU,2009,By Machine,0,0,9,27,0,36,0,0,1,1,0,2,38
TAMIL NADU,2009,By Overdose of sleeping pills,1,14,7,17,24,63,2,3,14,3,7,29,92
TAMIL NADU,2009,By touching electric wires,0,44,63,29,4,140,0,6,5,8,0,19,159
TAMIL NADU,2009,By coming under running vehicles/trains,6,49,67,38,26,186,6,83,37,29,24,179,365
TAMIL NADU,2009,By Other means (please specify),29,291,379,439,274,1412,39,185,211,172,104,711,2123
TAMIL NADU,2009,Total,136,2361,3174,2249,1030,8950,144,2077,1769,1019,465,5474,14424
TAMIL NADU,2009,Total (Poison),17,761,1034,791,366,2969,24,551,495,319,165,1554,4523
TAMIL NADU,2009,Total (Jumping),6,48,41,29,28,152,4,9,22,14,2,51,203
TAMIL NADU,2010,By Over Alcoholism,0,58,114,102,14,288,0,16,1,4,0,21,309
TAMIL NADU,2010,By Drowning,73,223,200,151,70,717,35,138,112,95,42,422,1139
TAMIL NADU,2010,By Fire/Self Immolation,23,275,360,154,51,863,42,721,562,199,101,1625,2488
TAMIL NADU,2010,By Fire-Arms,0,1,1,1,0,3,0,23,7,4,0,34,37
TAMIL NADU,2010,By Hanging,33,831,1146,645,228,2883,16,673,437,259,85,1470,4353
TAMIL NADU,2010,By Consuming Insecticides,26,386,575,582,146,1715,33,352,213,110,65,773,2488
TAMIL NADU,2010,By Consuming Other Poison,17,601,762,612,313,2305,6,414,392,212,85,1109,3414
TAMIL NADU,2010,By Self Infliction of injury,0,42,33,39,17,131,0,13,7,6,6,32,163
TAMIL NADU,2010,By Jumping from (Building),5,10,16,8,14,53,1,4,9,4,1,19,72
TAMIL NADU,2010,By Jumping from (Other sites),5,29,18,5,5,62,2,15,6,7,4,34,96
TAMIL NADU,2010,By Jumping off Moving Vehicles/Trains,2,9,12,47,34,104,2,19,19,8,7,55,159
TAMIL NADU,2010,By Machine,0,4,13,4,2,23,2,9,3,1,2,17,40
TAMIL NADU,2010,By Overdose of sleeping pills,0,4,6,6,1,17,0,3,2,3,0,8,25
TAMIL NADU,2010,By touching electric wires,6,40,52,24,7,129,2,21,8,27,5,63,192
TAMIL NADU,2010,By coming under running vehicles/trains,2,51,38,25,20,136,0,10,16,6,7,39,175
TAMIL NADU,2010,By Other means (please specify),7,402,166,174,374,1123,44,73,0,84,87,288,1411
TAMIL NADU,2010,Total,199,2966,3512,2579,1296,10552,185,2504,1794,1029,497,6009,16561
TAMIL NADU,2010,Total (Poison),43,1029,1370,1233,476,4151,39,779,612,328,156,1914,6065
TAMIL NADU,2010,Total (Jumping),10,39,34,13,19,115,3,19,15,11,5,53,168
TAMIL NADU,2011,By Over Alcoholism,0,46,118,72,11,247,0,1,1,0,1,3,250
TAMIL NADU,2011,By Drowning,56,220,208,107,70,661,38,115,63,46,14,276,937
TAMIL NADU,2011,By Fire/Self Immolation,21,293,348,136,70,868,49,670,433,150,95,1397,2265
TAMIL NADU,2011,By Fire-Arms,0,1,0,0,1,2,0,1,0,0,0,1,3
TAMIL NADU,2011,By Hanging,14,723,1036,584,126,2483,33,707,457,188,77,1462,3945
TAMIL NADU,2011,By Consuming Insecticides,16,282,325,242,152,1017,11,167,152,69,40,439,1456
TAMIL NADU,2011,By Consuming Other Poison,28,614,726,613,395,2376,31,460,352,134,72,1049,3425
TAMIL NADU,2011,By Self Infliction of injury,0,0,1,2,0,3,0,11,9,8,6,34,37
TAMIL NADU,2011,By Jumping from (Building),1,3,9,1,2,16,0,1,4,1,0,6,22
TAMIL NADU,2011,By Jumping from (Other sites),1,10,11,3,2,27,1,3,1,0,0,5,32
TAMIL NADU,2011,By Jumping off Moving Vehicles/Trains,3,8,11,36,48,106,1,14,21,6,9,51,157
TAMIL NADU,2011,By Machine,0,1,1,2,0,4,1,8,4,3,2,18,22
TAMIL NADU,2011,By Overdose of sleeping pills,0,9,16,3,1,29,0,9,14,7,0,30,59
TAMIL NADU,2011,By touching electric wires,2,28,18,14,8,70,1,3,5,2,2,13,83
TAMIL NADU,2011,By coming under running vehicles/trains,0,142,414,100,24,680,0,39,49,10,4,102,782
TAMIL NADU,2011,By Other means (please specify),17,356,735,490,95,1693,30,210,261,202,92,795,2488
TAMIL NADU,2011,Total,159,2736,3977,2405,1005,10282,196,2419,1826,826,414,5681,15963
TAMIL NADU,2011,Total (Poison),44,896,1052,857,547,3396,42,638,513,211,118,1522,4918
TAMIL NADU,2011,Total (Jumping),2,13,20,4,4,43,1,4,5,1,0,11,54
TAMIL NADU,2012,By Over Alcoholism,0,17,59,45,12,133,0,0,0,1,0,1,134
TAMIL NADU,2012,By Drowning,53,149,163,129,61,555,20,91,90,64,39,304,859
TAMIL NADU,2012,By Fire/Self Immolation,12,257,339,180,80,868,39,655,445,206,136,1481,2349
TAMIL NADU,2012,By Fire-Arms,0,1,1,0,0,2,0,11,2,0,0,13,15
TAMIL NADU,2012,By Hanging,36,1179,1238,763,314,3530,50,969,469,276,99,1863,5393
TAMIL NADU,2012,By Consuming Insecticides,9,295,423,360,191,1278,15,234,184,105,45,583,1861
TAMIL NADU,2012,By Consuming Other Poison,21,597,707,699,308,2332,17,471,351,198,90,1127,3459
TAMIL NADU,2012,By Self Infliction of injury,0,0,1,2,0,3,0,2,0,0,0,2,5
TAMIL NADU,2012,By Jumping from (Building),3,10,10,8,1,32,0,4,0,0,2,6,38
TAMIL NADU,2012,By Jumping from (Other sites),3,17,23,18,7,68,1,12,14,3,4,34,102
TAMIL NADU,2012,By Jumping off Moving Vehicles/Trains,0,0,0,2,0,2,0,0,0,1,0,1,3
TAMIL NADU,2012,By Machine,0,4,8,2,0,14,0,0,0,0,0,0,14
TAMIL NADU,2012,By Overdose of sleeping pills,1,4,7,3,2,17,0,3,5,1,1,10,27
TAMIL NADU,2012,By touching electric wires,6,33,40,28,7,114,0,3,5,2,2,12,126
TAMIL NADU,2012,By coming under running vehicles/trains,3,87,75,55,28,248,1,12,20,6,7,46,294
TAMIL NADU,2012,By Other means (please specify),2,113,802,357,278,1552,39,80,192,251,134,696,2248
TAMIL NADU,2012,Total,149,2763,3896,2651,1289,10748,182,2547,1777,1114,559,6179,16927
TAMIL NADU,2012,Total (Poison),30,892,1131,1061,499,3613,32,707,535,303,135,1712,5325
TAMIL NADU,2012,Total (Jumping),6,27,33,26,8,100,1,16,14,3,6,40,140
TRIPURA,2001,By Over Alcoholism,0,0,0,0,0,0,0,0,0,0,0,0,0
TRIPURA,2001,By Drowning,4,2,3,0,0,9,1,2,2,0,1,6,15
TRIPURA,2001,By Fire/Self Immolation,0,0,0,0,0,0,0,0,0,0,0,0,0
TRIPURA,2001,By Fire-Arms,0,0,0,0,0,0,0,0,0,0,0,0,0
TRIPURA,2001,By Hanging,3,57,77,29,12,178,1,50,84,28,10,173,351
TRIPURA,2001,By Consuming Insecticides,4,18,32,19,8,81,2,19,9,3,6,39,120
TRIPURA,2001,By Consuming Other Poison,5,43,69,31,7,155,7,30,85,29,4,155,310
TRIPURA,2001,By Self Infliction of injury,0,0,0,0,0,0,0,0,0,0,0,0,0
TRIPURA,2001,By Jumping from (Building),0,0,0,0,0,0,0,0,0,0,0,0,0
TRIPURA,2001,By Jumping from (Other sites),0,0,0,0,0,0,0,0,0,0,0,0,0
TRIPURA,2001,By Jumping off Moving Vehicles/Trains,0,0,0,0,0,0,0,0,1,0,0,1,1
TRIPURA,2001,By Machine,1,0,0,0,0,1,0,0,0,0,0,0,1
TRIPURA,2001,By Overdose of sleeping pills,0,0,8,0,0,8,0,2,0,0,0,2,10
TRIPURA,2001,By touching electric wires,0,1,0,0,0,1,0,0,0,0,0,0,1
TRIPURA,2001,By coming under running vehicles/trains,0,0,0,0,0,0,0,0,1,0,0,1,1
TRIPURA,2001,By Other means (please specify),1,10,5,8,6,30,1,5,5,2,1,14,44
TRIPURA,2001,Total,18,131,194,87,33,463,12,108,187,62,22,391,854
TRIPURA,2001,Total (Poison),9,61,101,50,15,236,9,49,94,32,10,194,430
TRIPURA,2001,Total (Jumping),0,0,0,0,0,0,0,0,0,0,0,0,0
TRIPURA,2002,By Over Alcoholism,0,0,0,2,0,2,0,0,0,0,0,0,2
TRIPURA,2002,By Drowning,2,4,1,0,0,7,1,2,0,0,0,3,10
TRIPURA,2002,By Fire/Self Immolation,0,0,0,0,0,0,0,0,0,0,0,0,0
TRIPURA,2002,By Fire-Arms,0,0,0,0,0,0,0,0,0,0,0,0,0
TRIPURA,2002,By Hanging,2,86,72,25,10,195,1,45,28,12,4,90,285
TRIPURA,2002,By Consuming Insecticides,4,45,55,21,9,134,8,32,23,13,8,84,218
TRIPURA,2002,By Consuming Other Poison,2,16,22,18,1,59,0,35,10,1,1,47,106
TRIPURA,2002,By Self Infliction of injury,1,0,0,0,0,1,0,0,0,0,0,0,1
TRIPURA,2002,By Jumping from (Building),0,0,0,0,0,0,0,0,0,0,0,0,0
TRIPURA,2002,By Jumping from (Other sites),0,0,0,0,0,0,0,0,0,0,0,0,0
TRIPURA,2002,By Jumping off Moving Vehicles/Trains,0,0,0,0,0,0,0,0,0,0,0,0,0
TRIPURA,2002,By Machine,0,1,0,0,0,1,0,0,0,0,0,0,1
TRIPURA,2002,By Overdose of sleeping pills,0,0,0,0,0,0,0,0,0,0,0,0,0
TRIPURA,2002,By touching electric wires,0,2,0,0,0,2,0,0,0,0,0,0,2
TRIPURA,2002,By coming under running vehicles/trains,0,0,0,0,0,0,0,0,0,0,0,0,0
TRIPURA,2002,By Other means,2,19,29,36,6,92,4,13,31,12,2,62,154
TRIPURA,2002,Total,13,173,179,102,26,493,14,127,92,38,15,286,779
TRIPURA,2002,Total (Poison),7,61,77,39,10,194,8,67,33,14,9,131,325
TRIPURA,2002,Total (Jumping),0,0,0,0,0,0,0,0,0,0,0,0,0
TRIPURA,2003,By Over Alcoholism,0,0,0,0,0,0,0,0,0,0,0,0,0
TRIPURA,2003,By Drowning,0,5,7,5,0,17,0,3,3,0,0,6,23
TRIPURA,2003,By Fire/Self Immolation,0,0,1,0,0,1,0,0,0,0,0,0,1
TRIPURA,2003,By Fire-Arms,0,0,0,0,0,0,0,0,0,0,0,0,0
TRIPURA,2003,By Hanging,0,55,72,25,0,152,0,49,61,21,0,131,283
TRIPURA,2003,By Consuming Insecticides,2,25,29,23,0,79,3,23,25,10,2,63,142
TRIPURA,2003,By Consuming Other Poison,4,81,50,23,2,160,4,37,35,20,1,97,257
TRIPURA,2003,By Self Infliction of injury,0,0,0,0,0,0,0,0,0,0,0,0,0
TRIPURA,2003,By Jumping from (Building),0,0,0,0,0,0,0,0,0,0,0,0,0
TRIPURA,2003,By Jumping from (Other sites),0,0,0,0,0,0,0,0,0,0,0,0,0
TRIPURA,2003,By Jumping off Moving Vehicles/Trains,0,1,0,0,0,1,0,0,0,0,0,0,1
TRIPURA,2003,By Machine,0,0,0,0,0,0,0,0,0,1,0,1,1
TRIPURA,2003,By Overdose of sleeping pills,0,0,0,0,0,0,0,0,0,0,0,0,0
TRIPURA,2003,By touching electric wires,0,0,0,0,0,0,0,0,0,0,0,0,0
TRIPURA,2003,By coming under running vehicles/trains,0,0,0,0,0,0,0,0,0,0,0,0,0
TRIPURA,2003,By Other means (please specify),1,31,29,15,2,78,1,28,18,10,1,58,136
TRIPURA,2003,Total,7,198,188,91,4,488,8,140,142,62,4,356,844
TRIPURA,2003,Total (Poison),6,106,79,46,2,239,7,60,60,30,3,160,399
TRIPURA,2003,Total (Jumping),0,0,0,0,0,0,0,0,0,0,0,0,0
TRIPURA,2004,By Over Alcoholism,0,0,1,0,0,1,0,0,0,0,0,0,1
TRIPURA,2004,By Drowning,0,15,15,4,0,34,3,11,11,3,0,28,62
TRIPURA,2004,By Fire/Self Immolation,0,0,0,0,0,0,0,12,0,0,0,12,12
TRIPURA,2004,By Fire-Arms,0,0,1,0,0,1,0,0,0,0,0,0,1
TRIPURA,2004,By Hanging,2,74,65,32,3,176,6,49,32,5,4,96,272
TRIPURA,2004,By Consuming Insecticides,0,31,21,22,2,76,2,25,22,0,0,49,125
TRIPURA,2004,By Consuming Other Poison,3,29,18,10,3,63,5,53,23,6,2,89,152
TRIPURA,2004,By Self Infliction of injury,0,0,0,0,0,0,0,0,0,0,0,0,0
TRIPURA,2004,By Jumping from (Building),0,0,0,0,0,0,0,0,0,0,0,0,0
TRIPURA,2004,By Jumping from (Other sites),0,1,1,1,0,3,0,0,0,0,0,0,3
TRIPURA,2004,By Jumping off Moving Vehicles/Trains,0,0,0,0,0,0,0,0,0,0,0,0,0
TRIPURA,2004,By Machine,0,0,0,0,0,0,0,0,0,0,0,0,0
TRIPURA,2004,By Overdose of sleeping pills,0,0,0,0,0,0,0,0,0,0,0,0,0
TRIPURA,2004,By touching electric wires,0,10,3,3,0,16,1,2,1,0,0,4,20
TRIPURA,2004,By coming under running vehicles/trains,0,0,0,0,0,0,0,0,0,0,0,0,0
TRIPURA,2004,By Other means (please specify),0,44,9,5,5,63,5,31,16,6,1,59,122
TRIPURA,2004,Total,5,204,134,77,13,433,22,183,105,20,7,337,770
TRIPURA,2004,Total (Poison),3,60,39,32,5,139,7,78,45,6,2,138,277
TRIPURA,2004,Total (Jumping),0,1,1,1,0,3,0,0,0,0,0,0,3
TRIPURA,2005,By Over Alcoholism,0,0,0,0,1,1,0,0,0,0,0,0,1
TRIPURA,2005,By Drowning,0,0,0,0,0,0,0,0,0,0,0,0,0
TRIPURA,2005,By Fire/Self Immolation,0,1,0,2,0,3,0,15,12,3,2,32,35
TRIPURA,2005,By Fire-Arms,0,0,3,0,0,3,0,0,0,0,0,0,3
TRIPURA,2005,By Hanging,5,85,78,49,17,234,4,73,31,10,3,121,355
TRIPURA,2005,By Consuming Insecticides,0,1,0,1,0,2,0,0,0,0,0,0,2
TRIPURA,2005,By Consuming Other Poison,5,50,43,22,13,133,12,85,32,25,0,154,287
TRIPURA,2005,By Self Infliction of injury,0,0,0,0,0,0,0,0,0,0,0,0,0
TRIPURA,2005,By Jumping from (Building),0,0,0,0,0,0,0,0,0,0,0,0,0
TRIPURA,2005,By Jumping from (Other sites),0,0,0,1,0,1,0,0,0,0,0,0,1
TRIPURA,2005,By Jumping off Moving Vehicles/Trains,0,0,0,0,0,0,0,0,0,0,0,0,0
TRIPURA,2005,By Machine,0,0,0,0,0,0,0,0,0,0,0,0,0
TRIPURA,2005,By Overdose of sleeping pills,0,0,0,0,0,0,0,0,0,0,0,0,0
TRIPURA,2005,By touching electric wires,0,0,0,0,0,0,0,0,0,0,0,0,0
TRIPURA,2005,By coming under running vehicles/trains,0,0,0,0,0,0,0,0,0,0,0,0,0
TRIPURA,2005,By Other means (please specify),0,12,3,8,1,24,0,1,3,0,3,7,31
TRIPURA,2005,Total,10,149,127,83,32,401,16,174,78,38,8,314,715
TRIPURA,2005,Total (Poison),5,51,43,23,13,135,12,85,32,25,0,154,289
TRIPURA,2005,Total (Jumping),0,0,0,1,0,1,0,0,0,0,0,0,1
TRIPURA,2006,By Over Alcoholism,0,2,4,0,0,6,0,0,0,0,0,0,6
TRIPURA,2006,By Drowning,3,6,5,2,0,16,3,2,0,1,1,7,23
TRIPURA,2006,By Fire/Self Immolation,0,0,0,0,0,0,0,0,0,0,0,0,0
TRIPURA,2006,By Fire-Arms,0,2,1,0,0,3,0,0,0,0,0,0,3
TRIPURA,2006,By Hanging,6,64,77,45,26,218,6,62,60,13,4,145,363
TRIPURA,2006,By Consuming Insecticides,1,4,2,1,0,8,2,2,0,0,0,4,12
TRIPURA,2006,By Consuming Other Poison,1,59,71,26,0,157,0,37,58,16,0,111,268
TRIPURA,2006,By Self Infliction of injury,0,0,0,0,0,0,0,0,0,0,0,0,0
TRIPURA,2006,By Jumping from (Building),0,0,0,0,0,0,0,0,0,0,0,0,0
TRIPURA,2006,By Jumping from (Other sites),0,0,0,0,0,0,0,0,0,0,0,0,0
TRIPURA,2006,By Jumping off Moving Vehicles/Trains,0,0,0,0,0,0,0,0,0,0,0,0,0
TRIPURA,2006,By Machine,0,0,0,0,0,0,0,0,0,0,0,0,0
TRIPURA,2006,By Overdose of sleeping pills,0,0,0,0,0,0,0,0,0,0,0,0,0
TRIPURA,2006,By touching electric wires,0,1,0,0,0,1,0,0,0,0,0,0,1
TRIPURA,2006,By coming under running vehicles/trains,0,0,0,0,0,0,0,0,0,0,0,0,0
TRIPURA,2006,By Other means (please specify),0,7,7,4,1,19,0,65,0,4,1,70,89
TRIPURA,2006,Total,11,145,167,78,27,428,11,168,118,34,6,337,765
TRIPURA,2006,Total (Poison),2,63,73,27,0,165,2,39,58,16,0,115,280
TRIPURA,2006,Total (Jumping),0,0,0,0,0,0,0,0,0,0,0,0,0
TRIPURA,2007,By Over Alcoholism,0,0,0,0,0,0,0,0,0,0,0,0,0
TRIPURA,2007,By Drowning,0,0,0,0,0,0,0,0,0,0,0,0,0
TRIPURA,2007,By Fire/Self Immolation,0,0,5,0,0,5,3,18,15,5,0,41,46
TRIPURA,2007,By Fire-Arms,0,0,7,0,0,7,0,0,0,0,0,0,7
TRIPURA,2007,By Hanging,11,88,83,60,6,248,9,49,48,25,4,135,383
TRIPURA,2007,By Consuming Insecticides,4,9,6,10,1,30,2,4,5,2,0,13,43
TRIPURA,2007,By Consuming Other Poison,11,50,39,24,3,127,8,40,22,7,3,80,207
TRIPURA,2007,By Self Infliction of injury,0,0,0,0,0,0,0,0,0,0,0,0,0
TRIPURA,2007,By Jumping from (Building),0,0,0,0,0,0,0,0,0,0,0,0,0
TRIPURA,2007,By Jumping from (Other sites),0,0,0,0,0,0,0,0,0,0,0,0,0
TRIPURA,2007,By Jumping off Moving Vehicles/Trains,0,0,0,0,0,0,0,0,0,0,0,0,0
TRIPURA,2007,By Machine,0,0,0,0,0,0,0,0,0,0,0,0,0
TRIPURA,2007,By Overdose of sleeping pills,0,0,0,0,0,0,0,0,0,0,0,0,0
TRIPURA,2007,By touching electric wires,0,0,0,0,0,0,0,0,0,0,0,0,0
TRIPURA,2007,By coming under running vehicles/trains,0,0,0,0,0,0,0,0,0,0,0,0,0
TRIPURA,2007,By Other means (please specify),0,1,1,0,0,2,0,5,10,2,0,17,19
TRIPURA,2007,Total,26,148,141,94,10,419,22,116,100,41,7,286,705
TRIPURA,2007,Total (Poison),15,59,45,34,4,157,10,44,27,9,3,93,250
TRIPURA,2007,Total (Jumping),0,0,0,0,0,0,0,0,0,0,0,0,0
TRIPURA,2008,By Over Alcoholism,0,0,0,0,0,0,0,0,0,0,0,0,0
TRIPURA,2008,By Drowning,0,0,0,0,0,0,0,0,0,0,0,0,0
TRIPURA,2008,By Fire/Self Immolation,0,6,7,8,2,23,0,17,12,3,1,33,56
TRIPURA,2008,By Fire-Arms,0,0,1,1,0,2,0,0,0,0,0,0,2
TRIPURA,2008,By Hanging,4,82,77,33,17,213,6,70,46,26,3,151,364
TRIPURA,2008,By Consuming Insecticides,5,43,39,24,3,114,2,32,18,8,1,61,175
TRIPURA,2008,By Consuming Other Poison,0,20,41,23,3,87,6,14,15,14,1,50,137
TRIPURA,2008,By Self Infliction of injury,0,0,0,0,0,0,0,0,0,0,0,0,0
TRIPURA,2008,By Jumping from (Building),0,0,0,0,0,0,0,0,0,0,0,0,0
TRIPURA,2008,By Jumping from (Other sites),0,0,0,0,0,0,0,0,0,0,0,0,0
TRIPURA,2008,By Jumping off Moving Vehicles/Trains,0,0,0,0,0,0,0,0,0,0,0,0,0
TRIPURA,2008,By Machine,0,0,0,0,0,0,0,0,0,0,0,0,0
TRIPURA,2008,By Overdose of sleeping pills,0,0,0,0,0,0,0,0,0,0,0,0,0
TRIPURA,2008,By touching electric wires,0,0,0,0,0,0,0,0,0,0,0,0,0
TRIPURA,2008,By coming under running vehicles/trains,0,1,1,0,0,2,0,0,0,0,0,0,2
TRIPURA,2008,By Other means (please specify),0,0,1,0,0,1,0,10,5,0,0,15,16
TRIPURA,2008,Total,9,152,167,89,25,442,14,143,96,51,6,310,752
TRIPURA,2008,Total (Poison),5,63,80,47,6,201,8,46,33,22,2,111,312
TRIPURA,2008,Total (Jumping),0,0,0,0,0,0,0,0,0,0,0,0,0
TRIPURA,2009,By Over Alcoholism,0,0,0,0,0,0,0,0,0,0,0,0,0
TRIPURA,2009,By Drowning,0,4,2,2,0,8,0,0,0,0,0,0,8
TRIPURA,2009,By Fire/Self Immolation,0,2,3,0,0,5,2,21,4,1,0,28,33
TRIPURA,2009,By Fire-Arms,0,1,1,1,0,3,0,0,0,0,0,0,3
TRIPURA,2009,By Hanging,6,110,84,51,15,266,5,60,24,17,7,113,379
TRIPURA,2009,By Consuming Insecticides,0,7,5,4,1,17,0,11,0,0,0,11,28
TRIPURA,2009,By Consuming Other Poison,3,62,57,36,5,163,3,62,33,13,2,113,276
TRIPURA,2009,By Self Infliction of injury,0,0,0,0,0,0,0,0,0,0,0,0,0
TRIPURA,2009,By Jumping from (Building),0,0,2,0,0,2,0,0,0,0,0,0,2
TRIPURA,2009,By Jumping from (Other sites),0,0,0,0,0,0,0,0,0,0,0,0,0
TRIPURA,2009,By Jumping off Moving Vehicles/Trains,0,0,0,0,0,0,0,0,0,0,0,0,0
TRIPURA,2009,By Machine,0,0,0,0,0,0,0,0,0,0,0,0,0
TRIPURA,2009,By Overdose of sleeping pills,0,0,0,0,0,0,0,0,0,0,0,0,0
TRIPURA,2009,By touching electric wires,0,0,0,0,0,0,0,0,0,0,0,0,0
TRIPURA,2009,By coming under running vehicles/trains,0,0,0,1,0,1,0,0,1,0,0,1,2
TRIPURA,2009,By Other means (please specify),0,1,0,0,1,2,0,4,0,0,1,5,7
TRIPURA,2009,Total,9,187,154,95,22,467,10,158,62,31,10,271,738
TRIPURA,2009,Total (Poison),3,69,62,40,6,180,3,73,33,13,2,124,304
TRIPURA,2009,Total (Jumping),0,0,2,0,0,2,0,0,0,0,0,0,2
TRIPURA,2010,By Over Alcoholism,0,0,0,0,0,0,0,0,0,0,0,0,0
TRIPURA,2010,By Drowning,3,1,0,0,0,4,1,0,0,0,2,3,7
TRIPURA,2010,By Fire/Self Immolation,0,2,4,2,0,8,1,12,22,11,0,46,54
TRIPURA,2010,By Fire-Arms,0,0,1,0,0,1,0,0,0,0,0,0,1
TRIPURA,2010,By Hanging,8,64,88,56,41,257,7,37,23,24,13,104,361
TRIPURA,2010,By Consuming Insecticides,1,10,3,2,2,18,4,7,3,0,5,19,37
TRIPURA,2010,By Consuming Other Poison,3,49,45,27,22,146,5,49,27,13,8,102,248
TRIPURA,2010,By Self Infliction of injury,0,0,0,0,0,0,0,0,0,0,0,0,0
TRIPURA,2010,By Jumping from (Building),0,0,0,4,0,4,0,0,0,0,0,0,4
TRIPURA,2010,By Jumping from (Other sites),0,0,0,0,0,0,0,0,0,0,0,0,0
TRIPURA,2010,By Jumping off Moving Vehicles/Trains,0,0,0,0,0,0,0,0,0,0,0,0,0
TRIPURA,2010,By Machine,0,0,0,0,0,0,0,0,0,0,0,0,0
TRIPURA,2010,By Overdose of sleeping pills,0,1,0,0,0,1,0,0,0,0,0,0,1
TRIPURA,2010,By touching electric wires,0,0,0,0,0,0,0,0,0,0,0,0,0
TRIPURA,2010,By coming under running vehicles/trains,0,0,0,0,0,0,0,0,0,0,0,0,0
TRIPURA,2010,By Other means (please specify),1,0,1,0,0,2,0,3,5,1,1,10,12
TRIPURA,2010,Total,16,127,142,91,65,441,18,108,80,49,29,284,725
TRIPURA,2010,Total (Poison),4,59,48,29,24,164,9,56,30,13,13,121,285
TRIPURA,2010,Total (Jumping),0,0,0,4,0,4,0,0,0,0,0,0,4
TRIPURA,2011,By Over Alcoholism,0,0,0,2,0,2,0,0,0,0,0,0,2
TRIPURA,2011,By Drowning,0,3,0,2,4,9,0,2,0,0,0,2,11
TRIPURA,2011,By Fire/Self Immolation,0,0,0,1,1,2,0,3,1,0,1,5,7
TRIPURA,2011,By Fire-Arms,0,0,0,0,0,0,0,0,0,0,0,0,0
TRIPURA,2011,By Hanging,2,88,79,37,21,227,1,65,33,30,19,148,375
TRIPURA,2011,By Consuming Insecticides,2,35,22,13,5,77,2,29,10,1,1,43,120
TRIPURA,2011,By Consuming Other Poison,1,43,22,10,3,79,2,29,6,6,3,46,125
TRIPURA,2011,By Self Infliction of injury,0,0,0,0,0,0,0,0,0,0,0,0,0
TRIPURA,2011,By Jumping from (Building),0,0,0,0,0,0,0,0,0,0,0,0,0
TRIPURA,2011,By Jumping from (Other sites),0,0,0,0,0,0,0,0,0,0,0,0,0
TRIPURA,2011,By Jumping off Moving Vehicles/Trains,0,0,0,0,0,0,0,0,0,0,0,0,0
TRIPURA,2011,By Machine,0,0,0,0,0,0,0,0,0,0,0,0,0
TRIPURA,2011,By Overdose of sleeping pills,0,0,0,0,0,0,0,0,0,0,0,0,0
TRIPURA,2011,By touching electric wires,0,0,0,0,0,0,0,0,0,0,0,0,0
TRIPURA,2011,By coming under running vehicles/trains,0,0,0,0,0,0,0,0,0,0,0,0,0
TRIPURA,2011,By Other means (please specify),0,33,10,3,5,51,0,5,3,1,3,12,63
TRIPURA,2011,Total,5,202,133,68,39,447,5,133,53,38,27,256,703
TRIPURA,2011,Total (Poison),3,78,44,23,8,156,4,58,16,7,4,89,245
TRIPURA,2011,Total (Jumping),0,0,0,0,0,0,0,0,0,0,0,0,0
TRIPURA,2012,By Over Alcoholism,0,2,2,1,0,5,0,0,0,0,0,0,5
TRIPURA,2012,By Drowning,1,8,13,3,2,27,1,10,5,3,1,20,47
TRIPURA,2012,By Fire/Self Immolation,0,0,2,1,0,3,0,2,1,0,0,3,6
TRIPURA,2012,By Fire-Arms,0,1,0,0,0,1,0,0,0,0,0,0,1
TRIPURA,2012,By Hanging,9,96,92,59,20,276,10,56,34,16,9,125,401
TRIPURA,2012,By Consuming Insecticides,4,22,10,19,2,57,0,31,5,2,1,39,96
TRIPURA,2012,By Consuming Other Poison,0,2,3,8,1,14,0,4,5,0,1,10,24
TRIPURA,2012,By Self Infliction of injury,0,4,1,0,0,5,0,1,0,0,0,1,6
TRIPURA,2012,By Jumping from (Building),0,0,0,0,0,0,0,0,0,0,0,0,0
TRIPURA,2012,By Jumping from (Other sites),0,0,0,0,0,0,0,0,0,0,0,0,0
TRIPURA,2012,By Jumping off Moving Vehicles/Trains,0,0,0,0,0,0,0,0,0,0,0,0,0
TRIPURA,2012,By Machine,0,0,0,0,0,0,0,0,0,0,0,0,0
TRIPURA,2012,By Overdose of sleeping pills,0,0,0,0,0,0,0,0,0,0,0,0,0
TRIPURA,2012,By touching electric wires,1,3,1,0,0,5,0,0,0,0,0,0,5
TRIPURA,2012,By coming under running vehicles/trains,0,0,0,0,0,0,0,0,0,0,0,0,0
TRIPURA,2012,By Other means (please specify),1,32,87,21,26,167,4,12,35,16,19,86,253
TRIPURA,2012,Total,16,170,211,112,51,560,15,116,85,37,31,284,844
TRIPURA,2012,Total (Poison),4,28,14,27,3,76,0,36,10,2,2,50,126
TRIPURA,2012,Total (Jumping),0,0,0,0,0,0,0,0,0,0,0,0,0
UTTAR PRADESH,2001,By Over Alcoholism,0,8,14,11,21,54,0,1,1,2,1,5,59
UTTAR PRADESH,2001,By Drowning,17,25,30,12,7,91,13,35,13,6,3,70,161
UTTAR PRADESH,2001,By Fire/Self Immolation,5,27,36,14,4,86,8,274,103,23,6,414,500
UTTAR PRADESH,2001,By Fire-Arms,3,47,22,11,4,87,1,6,3,0,1,11,98
UTTAR PRADESH,2001,By Hanging,5,261,191,82,21,560,10,240,237,85,15,587,1147
UTTAR PRADESH,2001,By Consuming Insecticides,19,146,65,76,33,339,11,164,80,20,15,290,629
UTTAR PRADESH,2001,By Consuming Other Poison,6,89,89,78,28,290,6,69,58,21,9,163,453
UTTAR PRADESH,2001,By Self Infliction of injury,1,0,7,7,0,15,0,12,0,0,1,13,28
UTTAR PRADESH,2001,By Jumping from (Building),2,8,14,1,0,25,0,6,4,0,1,11,36
UTTAR PRADESH,2001,By Jumping from (Other sites),0,22,24,2,3,51,0,6,10,6,0,22,73
UTTAR PRADESH,2001,By Jumping off Moving Vehicles/Trains,0,0,0,0,0,0,0,0,0,0,0,0,0
UTTAR PRADESH,2001,By Machine,0,5,3,0,0,8,0,0,0,0,0,0,8
UTTAR PRADESH,2001,By Overdose of sleeping pills,4,8,6,3,1,22,1,14,7,5,2,29,51
UTTAR PRADESH,2001,By touching electric wires,4,28,10,2,4,48,4,13,2,0,1,20,68
UTTAR PRADESH,2001,By coming under running vehicles/trains,2,15,16,12,6,51,1,2,3,4,2,12,63
UTTAR PRADESH,2001,By Other means (please specify),5,27,18,19,5,74,8,28,16,3,13,68,142
UTTAR PRADESH,2001,Total,73,716,545,330,137,1801,63,870,537,175,70,1715,3516
UTTAR PRADESH,2001,Total (Poison),26,235,161,161,61,644,17,245,138,41,25,466,1110
UTTAR PRADESH,2001,Total (Jumping),2,30,38,3,3,76,0,12,14,6,1,33,109
UTTAR PRADESH,2002,By Over Alcoholism,0,21,33,22,5,81,0,0,1,0,0,1,82
UTTAR PRADESH,2002,By Drowning,3,56,36,19,10,124,6,42,26,10,17,101,225
UTTAR PRADESH,2002,By Fire/Self Immolation,2,61,89,34,8,194,25,206,143,55,2,431,625
UTTAR PRADESH,2002,By Fire-Arms,4,43,29,29,5,110,0,11,8,0,0,19,129
UTTAR PRADESH,2002,By Hanging,14,287,225,133,34,693,20,287,150,76,33,566,1259
UTTAR PRADESH,2002,By Consuming Insecticides,9,117,116,76,37,355,5,136,67,31,13,252,607
UTTAR PRADESH,2002,By Consuming Other Poison,5,117,70,57,10,259,22,98,54,20,11,205,464
UTTAR PRADESH,2002,By Self Infliction of injury,0,9,1,0,4,14,0,2,3,0,0,5,19
UTTAR PRADESH,2002,By Jumping from (Building),1,3,6,2,3,15,1,0,1,0,0,2,17
UTTAR PRADESH,2002,By Jumping from (Other sites),0,6,9,2,1,18,0,2,2,0,2,6,24
UTTAR PRADESH,2002,By Jumping off Moving Vehicles/Trains,3,8,28,14,15,68,3,5,3,0,1,12,80
UTTAR PRADESH,2002,By Machine,0,3,3,3,1,10,1,1,0,0,0,2,12
UTTAR PRADESH,2002,By Overdose of sleeping pills,2,20,9,11,8,50,2,12,3,6,4,27,77
UTTAR PRADESH,2002,By touching electric wires,5,14,20,8,6,53,2,8,4,3,0,17,70
UTTAR PRADESH,2002,By coming under running vehicles/trains,3,28,41,17,7,96,1,14,12,5,3,35,131
UTTAR PRADESH,2002,By Other means,4,60,51,35,36,186,120,35,44,34,10,243,429
UTTAR PRADESH,2002,Total,55,853,766,462,190,2326,208,859,521,240,96,1924,4250
UTTAR PRADESH,2002,Total (Poison),14,243,187,133,51,628,27,236,124,51,24,462,1090
UTTAR PRADESH,2002,Total (Jumping),1,9,15,4,4,33,1,2,3,0,2,8,41
UTTAR PRADESH,2003,By Over Alcoholism,0,18,26,15,2,61,0,0,0,0,0,0,61
UTTAR PRADESH,2003,By Drowning,15,47,32,15,10,119,9,28,11,7,7,62,181
UTTAR PRADESH,2003,By Fire/Self Immolation,12,80,44,15,11,162,12,233,100,32,7,384,546
UTTAR PRADESH,2003,By Fire-Arms,3,48,34,20,3,108,1,15,5,1,0,22,130
UTTAR PRADESH,2003,By Hanging,15,267,242,75,29,628,10,208,127,62,11,418,1046
UTTAR PRADESH,2003,By Consuming Insecticides,5,121,91,76,20,313,7,107,60,42,25,241,554
UTTAR PRADESH,2003,By Consuming Other Poison,4,104,78,47,26,259,9,106,63,47,23,248,507
UTTAR PRADESH,2003,By Self Infliction of injury,0,9,7,6,1,23,0,6,6,4,2,18,41
UTTAR PRADESH,2003,By Jumping from (Building),4,14,18,10,6,52,2,3,5,4,3,17,69
UTTAR PRADESH,2003,By Jumping from (Other sites),0,0,0,0,0,0,0,0,0,0,0,0,0
UTTAR PRADESH,2003,By Jumping off Moving Vehicles/Trains,2,11,8,12,3,36,0,8,10,1,4,23,59
UTTAR PRADESH,2003,By Machine,0,4,5,5,1,15,0,0,1,0,0,1,16
UTTAR PRADESH,2003,By Overdose of sleeping pills,0,17,4,4,4,29,1,19,2,2,3,27,56
UTTAR PRADESH,2003,By touching electric wires,5,6,13,8,2,34,1,3,1,1,1,7,41
UTTAR PRADESH,2003,By coming under running vehicles/trains,2,16,19,20,10,67,0,15,6,4,2,27,94
UTTAR PRADESH,2003,By Other means (please specify),15,1,1,35,29,81,22,101,33,16,9,181,262
UTTAR PRADESH,2003,Total,82,763,622,363,157,1987,74,852,430,223,97,1676,3663
UTTAR PRADESH,2003,Total (Poison),9,234,176,129,47,595,16,219,129,93,50,507,1102
UTTAR PRADESH,2003,Total (Jumping),4,14,18,10,6,52,2,3,5,4,3,17,69
UTTAR PRADESH,2004,By Over Alcoholism,1,24,34,37,3,99,0,4,4,0,0,8,107
UTTAR PRADESH,2004,By Drowning,19,52,32,13,7,123,15,25,18,3,3,64,187
UTTAR PRADESH,2004,By Fire/Self Immolation,4,42,39,18,5,108,9,226,88,15,9,347,455
UTTAR PRADESH,2004,By Fire-Arms,3,46,46,19,5,119,1,21,9,1,1,33,152
UTTAR PRADESH,2004,By Hanging,15,220,216,98,27,576,15,306,125,43,11,500,1076
UTTAR PRADESH,2004,By Consuming Insecticides,15,106,106,31,10,268,12,131,96,64,10,313,581
UTTAR PRADESH,2004,By Consuming Other Poison,3,77,34,26,14,154,5,129,59,31,11,235,389
UTTAR PRADESH,2004,By Self Infliction of injury,0,1,3,0,1,5,0,0,0,1,0,1,6
UTTAR PRADESH,2004,By Jumping from (Building),0,0,0,0,0,0,0,0,0,0,0,0,0
UTTAR PRADESH,2004,By Jumping from (Other sites),1,10,5,6,2,24,0,1,1,0,0,2,26
UTTAR PRADESH,2004,By Jumping off Moving Vehicles/Trains,3,22,17,13,3,58,1,6,2,2,1,12,70
UTTAR PRADESH,2004,By Machine,1,2,2,0,0,5,0,0,0,0,0,0,5
UTTAR PRADESH,2004,By Overdose of sleeping pills,0,11,13,15,3,42,0,26,13,10,2,51,93
UTTAR PRADESH,2004,By touching electric wires,1,35,17,9,1,63,0,4,1,0,0,5,68
UTTAR PRADESH,2004,By coming under running vehicles/trains,7,51,59,36,29,182,3,23,14,5,6,51,233
UTTAR PRADESH,2004,By Other means (please specify),12,38,24,34,20,128,6,20,16,9,10,61,189
UTTAR PRADESH,2004,Total,85,737,647,355,130,1954,67,922,446,184,64,1683,3637
UTTAR PRADESH,2004,Total (Poison),18,184,143,57,25,427,17,260,155,96,21,549,976
UTTAR PRADESH,2004,Total (Jumping),1,10,5,6,2,24,0,1,1,0,0,2,26
UTTAR PRADESH,2005,By Over Alcoholism,0,33,39,41,0,113,0,3,4,1,0,8,121
UTTAR PRADESH,2005,By Drowning,9,40,31,18,15,113,6,55,40,11,2,114,227
UTTAR PRADESH,2005,By Fire/Self Immolation,12,41,38,14,3,108,12,185,102,29,23,351,459
UTTAR PRADESH,2005,By Fire-Arms,0,39,48,41,8,136,0,6,13,1,0,20,156
UTTAR PRADESH,2005,By Hanging,11,189,193,111,51,555,11,304,139,44,8,506,1061
UTTAR PRADESH,2005,By Consuming Insecticides,3,61,50,23,17,154,4,117,39,44,7,211,365
UTTAR PRADESH,2005,By Consuming Other Poison,3,46,50,27,12,138,4,88,45,26,3,166,304
UTTAR PRADESH,2005,By Self Infliction of injury,0,1,6,0,1,8,0,3,1,1,0,5,13
UTTAR PRADESH,2005,By Jumping from (Building),2,14,19,10,0,45,1,5,13,1,3,23,68
UTTAR PRADESH,2005,By Jumping from (Other sites),0,0,0,0,0,0,0,0,0,0,0,0,0
UTTAR PRADESH,2005,By Jumping off Moving Vehicles/Trains,0,31,32,17,3,83,0,4,19,5,3,31,114
UTTAR PRADESH,2005,By Machine,0,0,1,0,0,1,1,0,2,0,0,3,4
UTTAR PRADESH,2005,By Overdose of sleeping pills,0,11,15,3,0,29,0,7,11,9,1,28,57
UTTAR PRADESH,2005,By touching electric wires,2,14,8,5,8,37,0,9,9,4,2,24,61
UTTAR PRADESH,2005,By coming under running vehicles/trains,3,38,41,4,16,102,2,29,31,20,11,93,195
UTTAR PRADESH,2005,By Other means (please specify),13,9,42,55,31,150,18,49,5,12,10,94,244
UTTAR PRADESH,2005,Total,58,567,613,369,165,1772,59,864,473,208,73,1677,3449
UTTAR PRADESH,2005,Total (Poison),6,108,106,50,30,300,8,208,85,71,10,382,682
UTTAR PRADESH,2005,Total (Jumping),2,14,19,10,0,45,1,5,13,1,3,23,68
UTTAR PRADESH,2006,By Over Alcoholism,0,13,22,14,7,56,0,6,3,2,0,11,67
UTTAR PRADESH,2006,By Drowning,12,49,31,12,9,113,6,57,24,4,3,94,207
UTTAR PRADESH,2006,By Fire/Self Immolation,1,26,24,9,2,62,4,120,53,13,17,207,269
UTTAR PRADESH,2006,By Fire-Arms,2,33,37,20,6,98,0,3,6,1,0,10,108
UTTAR PRADESH,2006,By Hanging,7,31,201,83,21,343,4,277,145,42,10,478,821
UTTAR PRADESH,2006,By Consuming Insecticides,15,82,84,28,16,225,9,97,56,14,3,179,404
UTTAR PRADESH,2006,By Consuming Other Poison,5,45,59,22,19,150,9,71,30,17,7,134,284
UTTAR PRADESH,2006,By Self Infliction of injury,0,0,0,0,0,0,0,0,0,0,0,0,0
UTTAR PRADESH,2006,By Jumping from (Building),0,6,6,2,2,16,2,19,3,3,1,28,44
UTTAR PRADESH,2006,By Jumping from (Other sites),2,12,14,4,2,34,1,9,6,0,0,16,50
UTTAR PRADESH,2006,By Jumping off Moving Vehicles/Trains,11,29,20,10,5,75,2,5,7,3,1,18,93
UTTAR PRADESH,2006,By Machine,0,0,0,1,0,1,0,0,2,2,0,4,5
UTTAR PRADESH,2006,By Overdose of sleeping pills,2,24,30,7,1,64,7,22,10,3,0,42,106
UTTAR PRADESH,2006,By touching electric wires,3,24,16,13,4,60,0,6,6,4,0,16,76
UTTAR PRADESH,2006,By coming under running vehicles/trains,3,51,23,13,4,94,5,13,6,5,4,33,127
UTTAR PRADESH,2006,By Other means (please specify),2,204,106,38,20,370,5,32,5,7,19,68,438
UTTAR PRADESH,2006,Total,65,629,673,276,118,1761,54,737,362,120,65,1338,3099
UTTAR PRADESH,2006,Total (Poison),20,127,143,50,35,375,18,168,86,31,10,313,688
UTTAR PRADESH,2006,Total (Jumping),2,18,20,6,4,50,3,28,9,3,1,44,94
UTTAR PRADESH,2007,By Over Alcoholism,0,11,21,25,3,60,0,0,4,1,0,5,65
UTTAR PRADESH,2007,By Drowning,8,52,41,23,17,141,7,28,14,7,1,57,198
UTTAR PRADESH,2007,By Fire/Self Immolation,1,25,34,20,6,86,12,269,112,25,27,445,531
UTTAR PRADESH,2007,By Fire-Arms,1,37,38,24,7,107,2,17,10,1,0,30,137
UTTAR PRADESH,2007,By Hanging,12,227,180,189,93,701,7,352,220,29,18,626,1327
UTTAR PRADESH,2007,By Consuming Insecticides,6,83,83,48,16,236,9,135,69,27,13,253,489
UTTAR PRADESH,2007,By Consuming Other Poison,5,96,71,31,16,219,8,72,25,13,6,124,343
UTTAR PRADESH,2007,By Self Infliction of injury,0,3,6,3,3,15,0,1,2,0,0,3,18
UTTAR PRADESH,2007,By Jumping from (Building),3,18,33,20,2,76,0,5,6,0,1,12,88
UTTAR PRADESH,2007,By Jumping from (Other sites),0,0,0,0,0,0,0,0,0,0,0,0,0
UTTAR PRADESH,2007,By Jumping off Moving Vehicles/Trains,1,18,25,17,6,67,1,8,7,3,0,19,86
UTTAR PRADESH,2007,By Machine,0,1,0,0,0,1,0,0,1,0,0,1,2
UTTAR PRADESH,2007,By Overdose of sleeping pills,6,25,36,10,14,91,2,25,16,4,0,47,138
UTTAR PRADESH,2007,By touching electric wires,0,16,12,15,4,47,0,2,5,4,1,12,59
UTTAR PRADESH,2007,By coming under running vehicles/trains,4,76,47,24,15,166,1,27,15,6,4,53,219
UTTAR PRADESH,2007,By Other means (please specify),3,7,1,16,14,41,20,49,51,36,30,186,227
UTTAR PRADESH,2007,Total,50,695,628,465,216,2054,69,990,557,156,101,1873,3927
UTTAR PRADESH,2007,Total (Poison),11,182,160,82,35,470,17,208,96,40,19,380,850
UTTAR PRADESH,2007,Total (Jumping),3,18,33,20,2,76,0,5,6,0,1,12,88
UTTAR PRADESH,2008,By Over Alcoholism,3,8,61,27,5,104,0,6,1,1,0,8,112
UTTAR PRADESH,2008,By Drowning,14,75,62,27,21,199,11,85,36,12,17,161,360
UTTAR PRADESH,2008,By Fire/Self Immolation,2,30,60,33,7,132,7,190,103,19,18,337,469
UTTAR PRADESH,2008,By Fire-Arms,1,36,49,22,8,116,2,26,11,5,2,46,162
UTTAR PRADESH,2008,By Hanging,6,260,150,112,38,566,16,422,149,33,18,638,1204
UTTAR PRADESH,2008,By Consuming Insecticides,13,122,113,59,19,326,7,172,88,30,10,307,633
UTTAR PRADESH,2008,By Consuming Other Poison,14,69,76,37,16,212,8,79,53,22,4,166,378
UTTAR PRADESH,2008,By Self Infliction of injury,0,4,7,2,1,14,0,10,5,0,0,15,29
UTTAR PRADESH,2008,By Jumping from (Building),0,13,19,6,0,38,1,12,10,3,4,30,68
UTTAR PRADESH,2008,By Jumping from (Other sites),0,0,0,0,0,0,0,0,0,0,0,0,0
UTTAR PRADESH,2008,By Jumping off Moving Vehicles/Trains,0,19,30,7,4,60,0,3,2,1,0,6,66
UTTAR PRADESH,2008,By Machine,0,1,1,2,1,5,0,1,5,1,0,7,12
UTTAR PRADESH,2008,By Overdose of sleeping pills,0,20,15,8,1,44,1,19,6,3,1,30,74
UTTAR PRADESH,2008,By touching electric wires,2,33,26,9,8,78,0,15,4,5,1,25,103
UTTAR PRADESH,2008,By coming under running vehicles/trains,0,27,34,23,24,108,5,11,22,4,3,45,153
UTTAR PRADESH,2008,By Other means (please specify),5,51,55,45,21,177,11,32,24,12,9,88,265
UTTAR PRADESH,2008,Total,60,768,758,419,174,2179,69,1083,519,151,87,1909,4088
UTTAR PRADESH,2008,Total (Poison),27,195,196,98,36,552,15,261,146,52,14,488,1040
UTTAR PRADESH,2008,Total (Jumping),0,13,19,6,0,38,1,12,10,3,4,30,68
UTTAR PRADESH,2009,By Over Alcoholism,0,17,33,16,9,75,0,0,0,1,4,5,80
UTTAR PRADESH,2009,By Drowning,0,97,62,40,8,207,17,43,29,13,7,109,316
UTTAR PRADESH,2009,By Fire/Self Immolation,5,34,28,25,13,105,14,245,107,25,29,420,525
UTTAR PRADESH,2009,By Fire-Arms,1,33,49,18,10,111,1,17,8,3,2,31,142
UTTAR PRADESH,2009,By Hanging,12,281,225,132,32,682,14,324,195,24,14,571,1253
UTTAR PRADESH,2009,By Consuming Insecticides,9,111,114,49,16,299,12,195,87,51,16,361,660
UTTAR PRADESH,2009,By Consuming Other Poison,3,77,61,24,9,174,2,69,43,11,7,132,306
UTTAR PRADESH,2009,By Self Infliction of injury,1,8,6,8,5,28,0,1,4,0,2,7,35
UTTAR PRADESH,2009,By Jumping from (Building),0,10,6,2,3,21,1,4,5,1,0,11,32
UTTAR PRADESH,2009,By Jumping from (Other sites),0,27,17,4,1,49,0,22,6,0,0,28,77
UTTAR PRADESH,2009,By Jumping off Moving Vehicles/Trains,0,27,17,4,1,49,0,22,6,0,0,28,77
UTTAR PRADESH,2009,By Machine,1,2,1,1,0,5,0,1,0,0,0,1,6
UTTAR PRADESH,2009,By Overdose of sleeping pills,0,13,8,3,6,30,0,6,6,2,0,14,44
UTTAR PRADESH,2009,By touching electric wires,6,18,18,15,8,65,0,11,3,3,2,19,84
UTTAR PRADESH,2009,By coming under running vehicles/trains,4,33,38,31,16,122,1,21,18,7,7,54,176
UTTAR PRADESH,2009,By Other means (please specify),9,48,82,46,32,217,0,88,14,20,6,128,345
UTTAR PRADESH,2009,Total,51,836,765,418,169,2239,62,1069,531,161,96,1919,4158
UTTAR PRADESH,2009,Total (Poison),13,196,181,81,30,501,14,265,134,62,25,500,1001
UTTAR PRADESH,2009,Total (Jumping),0,37,23,6,4,70,1,26,11,1,0,39,109
UTTAR PRADESH,2010,By Over Alcoholism,0,16,21,16,2,55,0,44,1,1,0,46,101
UTTAR PRADESH,2010,By Drowning,13,56,52,20,15,156,5,31,11,2,5,54,210
UTTAR PRADESH,2010,By Fire/Self Immolation,9,33,35,16,4,97,15,284,101,25,25,450,547
UTTAR PRADESH,2010,By Fire-Arms,1,51,39,19,9,119,1,13,7,4,2,27,146
UTTAR PRADESH,2010,By Hanging,9,227,163,94,40,533,0,355,187,56,2,600,1133
UTTAR PRADESH,2010,By Consuming Insecticides,1,57,52,24,9,143,4,82,74,21,8,189,332
UTTAR PRADESH,2010,By Consuming Other Poison,4,60,64,57,25,210,20,99,61,23,22,225,435
UTTAR PRADESH,2010,By Self Infliction of injury,0,6,3,4,1,14,0,5,0,1,0,6,20
UTTAR PRADESH,2010,By Jumping from (Building),0,11,11,4,2,28,1,5,4,2,2,14,42
UTTAR PRADESH,2010,By Jumping from (Other sites),0,0,0,0,0,0,0,0,0,0,0,0,0
UTTAR PRADESH,2010,By Jumping off Moving Vehicles/Trains,2,17,18,2,2,41,1,6,6,1,1,15,56
UTTAR PRADESH,2010,By Machine,0,11,9,5,0,25,0,1,1,0,0,2,27
UTTAR PRADESH,2010,By Overdose of sleeping pills,0,13,8,5,3,29,1,15,1,5,1,23,52
UTTAR PRADESH,2010,By touching electric wires,2,30,30,12,8,82,2,13,10,6,1,32,114
UTTAR PRADESH,2010,By coming under running vehicles/trains,5,40,44,32,3,124,6,26,17,17,1,67,191
UTTAR PRADESH,2010,By Other means (please specify),0,44,31,37,19,131,2,48,24,8,9,91,222
UTTAR PRADESH,2010,Total,46,672,580,347,142,1787,58,1027,505,172,79,1841,3628
UTTAR PRADESH,2010,Total (Poison),5,123,119,85,35,367,24,186,135,45,30,420,787
UTTAR PRADESH,2010,Total (Jumping),0,11,11,4,2,28,1,5,4,2,2,14,42
UTTAR PRADESH,2011,By Over Alcoholism,1,22,32,27,2,84,1,4,0,0,0,5,89
UTTAR PRADESH,2011,By Drowning,9,68,55,30,18,180,5,46,23,4,3,81,261
UTTAR PRADESH,2011,By Fire/Self Immolation,5,48,68,28,7,156,14,325,132,26,26,523,679
UTTAR PRADESH,2011,By Fire-Arms,0,20,31,10,3,64,1,16,2,1,0,20,84
UTTAR PRADESH,2011,By Hanging,5,399,339,169,39,951,17,415,232,70,15,749,1700
UTTAR PRADESH,2011,By Consuming Insecticides,1,63,62,25,5,156,3,89,47,31,3,173,329
UTTAR PRADESH,2011,By Consuming Other Poison,8,111,130,64,22,335,10,129,73,32,17,261,596
UTTAR PRADESH,2011,By Self Infliction of injury,0,11,14,9,5,39,0,2,3,4,0,9,48
UTTAR PRADESH,2011,By Jumping from (Building),0,7,8,8,3,26,5,8,4,1,0,18,44
UTTAR PRADESH,2011,By Jumping from (Other sites),0,0,0,0,0,0,0,0,0,0,0,0,0
UTTAR PRADESH,2011,By Jumping off Moving Vehicles/Trains,0,25,28,5,0,58,0,11,3,0,0,14,72
UTTAR PRADESH,2011,By Machine,0,3,4,3,2,12,0,1,0,0,0,1,13
UTTAR PRADESH,2011,By Overdose of sleeping pills,0,9,8,8,6,31,1,11,6,5,0,23,54
UTTAR PRADESH,2011,By touching electric wires,5,23,19,11,1,59,1,4,3,0,0,8,67
UTTAR PRADESH,2011,By coming under running vehicles/trains,0,47,65,47,16,175,0,41,22,3,1,67,242
UTTAR PRADESH,2011,By Other means (please specify),11,111,134,74,57,387,1,68,66,24,19,178,565
UTTAR PRADESH,2011,Total,45,967,997,518,186,2713,59,1170,616,201,84,2130,4843
UTTAR PRADESH,2011,Total (Poison),9,185,206,98,32,530,13,220,123,67,20,443,973
UTTAR PRADESH,2011,Total (Jumping),0,7,8,8,3,26,5,8,4,1,0,18,44
UTTAR PRADESH,2012,By Over Alcoholism,1,17,45,28,5,96,0,5,0,0,0,5,101
UTTAR PRADESH,2012,By Drowning,4,51,53,35,14,157,6,53,23,2,7,91,248
UTTAR PRADESH,2012,By Fire/Self Immolation,7,56,66,26,13,168,11,253,150,38,14,466,634
UTTAR PRADESH,2012,By Fire-Arms,0,61,26,19,10,116,1,20,4,2,4,31,147
UTTAR PRADESH,2012,By Hanging,3,295,290,241,66,895,16,319,235,103,13,686,1581
UTTAR PRADESH,2012,By Consuming Insecticides,1,63,44,30,3,141,4,86,42,11,3,146,287
UTTAR PRADESH,2012,By Consuming Other Poison,2,69,75,53,16,215,2,112,40,25,9,188,403
UTTAR PRADESH,2012,By Self Infliction of injury,0,15,19,7,2,43,0,10,8,4,1,23,66
UTTAR PRADESH,2012,By Jumping from (Building),1,9,11,15,6,42,0,5,5,3,0,13,55
UTTAR PRADESH,2012,By Jumping from (Other sites),1,13,28,16,20,78,2,13,8,7,1,31,109
UTTAR PRADESH,2012,By Jumping off Moving Vehicles/Trains,1,13,28,16,20,78,2,13,8,7,1,31,109
UTTAR PRADESH,2012,By Machine,1,0,3,2,0,6,0,2,1,0,0,3,9
UTTAR PRADESH,2012,By Overdose of sleeping pills,3,15,15,9,3,45,8,25,9,4,6,52,97
UTTAR PRADESH,2012,By touching electric wires,0,36,35,16,3,90,0,7,4,0,0,11,101
UTTAR PRADESH,2012,By coming under running vehicles/trains,1,65,67,38,12,183,1,20,22,4,5,52,235
UTTAR PRADESH,2012,By Other means (please specify),5,67,37,23,10,142,1,46,32,8,11,98,240
UTTAR PRADESH,2012,Total,31,845,842,574,203,2495,54,989,591,218,75,1927,4422
UTTAR PRADESH,2012,Total (Poison),3,147,138,90,21,399,6,208,90,40,13,357,756
UTTAR PRADESH,2012,Total (Jumping),2,22,39,31,26,120,2,18,13,10,1,44,164
UTTARAKHAND,2001,By Over Alcoholism,0,0,8,3,0,11,0,0,0,0,0,0,11
UTTARAKHAND,2001,By Drowning,3,4,3,2,1,13,1,14,7,0,0,22,35
UTTARAKHAND,2001,By Fire/Self Immolation,0,1,2,1,0,4,0,7,5,4,0,16,20
UTTARAKHAND,2001,By Fire-Arms,0,0,0,3,0,3,0,0,0,0,0,0,3
UTTARAKHAND,2001,By Hanging,0,8,22,3,0,33,1,18,8,0,0,27,60
UTTARAKHAND,2001,By Consuming Insecticides,0,15,30,18,1,64,2,24,9,0,1,36,100
UTTARAKHAND,2001,By Consuming Other Poison,0,1,10,1,0,12,0,4,7,4,1,16,28
UTTARAKHAND,2001,By Self Infliction of injury,0,0,1,0,0,1,0,1,0,0,0,1,2
UTTARAKHAND,2001,By Jumping from (Building),0,0,1,0,0,1,0,0,0,0,0,0,1
UTTARAKHAND,2001,By Jumping from (Other sites),0,0,0,0,0,0,0,0,0,0,0,0,0
UTTARAKHAND,2001,By Jumping off Moving Vehicles/Trains,0,1,1,0,0,2,0,0,0,1,0,1,3
UTTARAKHAND,2001,By Machine,0,0,0,0,0,0,0,0,0,0,0,0,0
UTTARAKHAND,2001,By Overdose of sleeping pills,0,0,1,0,0,1,0,0,1,0,0,1,2
UTTARAKHAND,2001,By touching electric wires,0,3,0,0,0,3,0,0,2,0,0,2,5
UTTARAKHAND,2001,By coming under running vehicles/trains,0,3,5,2,1,11,0,0,0,0,0,0,11
UTTARAKHAND,2001,By Other means (please specify),0,5,7,9,2,23,0,4,2,1,0,7,30
UTTARAKHAND,2001,Total,3,41,91,42,5,182,4,72,41,10,2,129,311
UTTARAKHAND,2001,Total (Poison),0,16,41,19,1,77,2,29,16,4,2,53,130
UTTARAKHAND,2001,Total (Jumping),0,0,1,0,0,1,0,0,0,0,0,0,1
UTTARAKHAND,2002,By Over Alcoholism,0,0,1,0,0,1,0,0,0,0,0,0,1
UTTARAKHAND,2002,By Drowning,1,6,9,3,2,21,0,5,4,1,0,10,31
UTTARAKHAND,2002,By Fire/Self Immolation,0,5,5,0,0,10,0,15,6,4,0,25,35
UTTARAKHAND,2002,By Fire-Arms,0,0,1,0,0,1,0,0,0,0,0,0,1
UTTARAKHAND,2002,By Hanging,0,16,7,6,3,32,3,18,12,1,0,34,66
UTTARAKHAND,2002,By Consuming Insecticides,7,56,24,11,6,104,3,32,20,7,2,64,168
UTTARAKHAND,2002,By Consuming Other Poison,0,4,2,1,2,9,0,6,7,0,1,14,23
UTTARAKHAND,2002,By Self Infliction of injury,0,0,2,0,0,2,0,0,0,1,0,1,3
UTTARAKHAND,2002,By Jumping from (Building),0,0,0,0,0,0,0,0,0,0,0,0,0
UTTARAKHAND,2002,By Jumping from (Other sites),0,0,0,0,0,0,0,0,0,0,0,0,0
UTTARAKHAND,2002,By Jumping off Moving Vehicles/Trains,0,0,0,0,0,0,0,0,0,0,0,0,0
UTTARAKHAND,2002,By Machine,0,0,0,0,0,0,0,0,0,0,0,0,0
UTTARAKHAND,2002,By Overdose of sleeping pills,0,0,1,2,0,3,0,0,0,0,0,0,3
UTTARAKHAND,2002,By touching electric wires,0,1,1,0,0,2,0,0,0,0,0,0,2
UTTARAKHAND,2002,By coming under running vehicles/trains,0,1,4,7,1,13,2,4,1,1,0,8,21
UTTARAKHAND,2002,By Other means,0,0,3,2,2,7,0,0,0,0,0,0,7
UTTARAKHAND,2002,Total,8,89,60,32,16,205,8,80,50,15,3,156,361
UTTARAKHAND,2002,Total (Poison),7,60,28,12,8,115,3,38,27,8,3,79,194
UTTARAKHAND,2002,Total (Jumping),0,0,0,0,0,0,0,0,0,0,0,0,0
UTTARAKHAND,2003,By Over Alcoholism,0,3,1,0,1,5,0,0,0,0,0,0,5
UTTARAKHAND,2003,By Drowning,0,6,3,4,1,14,0,3,2,1,0,6,20
UTTARAKHAND,2003,By Fire/Self Immolation,0,3,2,0,0,5,0,5,2,0,0,7,12
UTTARAKHAND,2003,By Fire-Arms,0,3,2,2,0,7,0,1,0,0,0,1,8
UTTARAKHAND,2003,By Hanging,0,24,18,11,2,55,1,19,4,1,0,25,80
UTTARAKHAND,2003,By Consuming Insecticides,0,29,28,6,0,63,0,19,13,2,0,34,97
UTTARAKHAND,2003,By Consuming Other Poison,0,14,21,11,1,47,2,18,8,1,2,31,78
UTTARAKHAND,2003,By Self Infliction of injury,0,23,6,19,0,48,0,9,0,7,1,17,65
UTTARAKHAND,2003,By Jumping from (Building),0,0,0,0,0,0,0,0,0,0,0,0,0
UTTARAKHAND,2003,By Jumping from (Other sites),0,3,1,1,0,5,0,0,1,0,0,1,6
UTTARAKHAND,2003,By Jumping off Moving Vehicles/Trains,0,0,0,0,0,0,0,0,0,0,0,0,0
UTTARAKHAND,2003,By Machine,0,0,0,0,0,0,0,0,0,0,0,0,0
UTTARAKHAND,2003,By Overdose of sleeping pills,0,1,3,0,0,4,0,1,0,0,0,1,5
UTTARAKHAND,2003,By touching electric wires,0,1,3,1,0,5,0,0,1,0,0,1,6
UTTARAKHAND,2003,By coming under running vehicles/trains,0,0,1,0,0,1,0,1,1,0,0,2,3
UTTARAKHAND,2003,By Other means (please specify),0,1,2,0,0,3,0,1,0,2,0,3,6
UTTARAKHAND,2003,Total,0,111,91,55,5,262,3,77,32,14,3,129,391
UTTARAKHAND,2003,Total (Poison),0,66,55,36,1,158,2,46,21,10,3,82,240
UTTARAKHAND,2003,Total (Jumping),0,3,1,1,0,5,0,0,1,0,0,1,6
UTTARAKHAND,2004,By Over Alcoholism,0,0,2,1,0,3,0,0,0,0,0,0,3
UTTARAKHAND,2004,By Drowning,2,9,6,5,0,22,0,5,1,1,0,7,29
UTTARAKHAND,2004,By Fire/Self Immolation,2,5,1,2,0,10,0,5,5,1,0,11,21
UTTARAKHAND,2004,By Fire-Arms,0,3,0,0,0,3,0,0,0,0,0,0,3
UTTARAKHAND,2004,By Hanging,0,20,21,1,0,42,0,13,5,1,0,19,61
UTTARAKHAND,2004,By Consuming Insecticides,2,15,10,8,2,37,2,19,6,5,0,32,69
UTTARAKHAND,2004,By Consuming Other Poison,0,6,10,3,3,22,0,8,1,2,0,11,33
UTTARAKHAND,2004,By Self Infliction of injury,0,0,0,0,0,0,0,0,0,0,0,0,0
UTTARAKHAND,2004,By Jumping from (Building),0,0,0,0,0,0,0,0,0,0,0,0,0
UTTARAKHAND,2004,By Jumping from (Other sites),0,0,0,0,0,0,0,0,0,0,0,0,0
UTTARAKHAND,2004,By Jumping off Moving Vehicles/Trains,0,0,0,0,0,0,0,0,0,0,0,0,0
UTTARAKHAND,2004,By Machine,0,0,0,0,0,0,0,0,0,0,0,0,0
UTTARAKHAND,2004,By Overdose of sleeping pills,0,1,3,1,1,6,0,1,1,0,0,2,8
UTTARAKHAND,2004,By touching electric wires,0,0,0,0,0,0,0,0,0,0,0,0,0
UTTARAKHAND,2004,By coming under running vehicles/trains,0,0,0,0,0,0,0,0,0,0,0,0,0
UTTARAKHAND,2004,By Other means (please specify),2,0,0,0,1,3,0,4,3,0,0,7,10
UTTARAKHAND,2004,Total,8,59,53,21,7,148,2,55,22,10,0,89,237
UTTARAKHAND,2004,Total (Poison),2,21,20,11,5,59,2,27,7,7,0,43,102
UTTARAKHAND,2004,Total (Jumping),0,0,0,0,0,0,0,0,0,0,0,0,0
UTTARAKHAND,2005,By Over Alcoholism,0,1,4,1,0,6,0,0,0,0,0,0,6
UTTARAKHAND,2005,By Drowning,0,2,2,0,0,4,0,0,2,1,0,3,7
UTTARAKHAND,2005,By Fire/Self Immolation,0,4,2,2,0,8,0,10,6,0,0,16,24
UTTARAKHAND,2005,By Fire-Arms,0,1,0,0,0,1,0,0,0,0,0,0,1
UTTARAKHAND,2005,By Hanging,0,20,22,6,2,50,0,21,5,1,0,27,77
UTTARAKHAND,2005,By Consuming Insecticides,0,17,12,3,1,33,2,6,4,3,0,15,48
UTTARAKHAND,2005,By Consuming Other Poison,0,23,9,11,4,47,1,11,6,1,0,19,66
UTTARAKHAND,2005,By Self Infliction of injury,0,1,3,0,0,4,1,0,0,0,0,1,5
UTTARAKHAND,2005,By Jumping from (Building),0,0,0,0,0,0,0,0,0,0,0,0,0
UTTARAKHAND,2005,By Jumping from (Other sites),0,1,1,0,0,2,0,0,0,0,0,0,2
UTTARAKHAND,2005,By Jumping off Moving Vehicles/Trains,0,1,0,0,0,1,0,0,0,0,0,0,1
UTTARAKHAND,2005,By Machine,0,0,0,0,0,0,0,0,0,0,0,0,0
UTTARAKHAND,2005,By Overdose of sleeping pills,0,1,1,0,0,2,0,1,2,1,0,4,6
UTTARAKHAND,2005,By touching electric wires,0,1,1,1,0,3,0,0,0,0,0,0,3
UTTARAKHAND,2005,By coming under running vehicles/trains,0,2,5,2,0,9,0,1,0,1,0,2,11
UTTARAKHAND,2005,By Other means (please specify),0,1,4,3,2,10,0,4,1,1,0,6,16
UTTARAKHAND,2005,Total,0,76,66,29,9,180,4,54,26,9,0,93,273
UTTARAKHAND,2005,Total (Poison),0,41,24,14,5,84,4,17,10,4,0,35,119
UTTARAKHAND,2005,Total (Jumping),0,1,1,0,0,2,0,0,0,0,0,0,2
UTTARAKHAND,2006,By Over Alcoholism,0,3,4,5,0,12,0,0,0,0,0,0,12
UTTARAKHAND,2006,By Drowning,0,6,11,5,1,23,1,5,3,1,0,10,33
UTTARAKHAND,2006,By Fire/Self Immolation,0,3,2,0,0,5,1,11,7,2,0,21,26
UTTARAKHAND,2006,By Fire-Arms,0,0,1,0,0,1,0,0,0,0,0,0,1
UTTARAKHAND,2006,By Hanging,0,14,18,10,2,44,2,25,18,6,0,51,95
UTTARAKHAND,2006,By Consuming Insecticides,0,10,20,8,5,43,1,25,15,1,2,44,87
UTTARAKHAND,2006,By Consuming Other Poison,0,9,5,3,1,18,0,7,6,1,0,14,32
UTTARAKHAND,2006,By Self Infliction of injury,0,1,1,2,2,6,0,0,2,0,0,2,8
UTTARAKHAND,2006,By Jumping from (Building),0,0,0,0,0,0,0,0,0,0,0,0,0
UTTARAKHAND,2006,By Jumping from (Other sites),0,1,0,0,0,1,0,0,0,0,0,0,1
UTTARAKHAND,2006,By Jumping off Moving Vehicles/Trains,0,1,0,0,0,1,0,0,0,0,0,0,1
UTTARAKHAND,2006,By Machine,0,0,0,0,0,0,0,0,0,0,0,0,0
UTTARAKHAND,2006,By Overdose of sleeping pills,0,0,5,2,1,8,0,3,3,2,1,9,17
UTTARAKHAND,2006,By touching electric wires,0,1,1,4,1,7,0,0,1,0,0,1,8
UTTARAKHAND,2006,By coming under running vehicles/trains,0,2,2,0,0,4,0,1,0,0,0,1,5
UTTARAKHAND,2006,By Other means (please specify),0,0,0,0,0,0,0,0,0,0,0,0,0
UTTARAKHAND,2006,Total,0,51,70,39,13,173,5,77,55,13,3,153,326
UTTARAKHAND,2006,Total (Poison),0,20,26,13,8,67,1,32,23,2,2,60,127
UTTARAKHAND,2006,Total (Jumping),0,1,0,0,0,1,0,0,0,0,0,0,1
UTTARAKHAND,2007,By Over Alcoholism,0,4,5,1,0,10,0,0,0,0,0,0,10
UTTARAKHAND,2007,By Drowning,1,4,7,2,0,14,0,3,1,0,0,4,18
UTTARAKHAND,2007,By Fire/Self Immolation,0,2,1,0,1,4,0,7,6,2,0,15,19
UTTARAKHAND,2007,By Fire-Arms,0,1,0,0,0,1,0,0,0,0,0,0,1
UTTARAKHAND,2007,By Hanging,0,27,15,3,0,45,0,20,12,2,1,35,80
UTTARAKHAND,2007,By Consuming Insecticides,0,8,11,3,0,22,4,14,7,2,2,29,51
UTTARAKHAND,2007,By Consuming Other Poison,0,3,8,2,0,13,3,13,4,0,1,21,34
UTTARAKHAND,2007,By Self Infliction of injury,0,0,0,0,0,0,0,0,0,0,0,0,0
UTTARAKHAND,2007,By Jumping from (Building),0,0,0,0,0,0,0,0,0,0,0,0,0
UTTARAKHAND,2007,By Jumping from (Other sites),0,0,0,0,0,0,0,1,0,0,0,1,1
UTTARAKHAND,2007,By Jumping off Moving Vehicles/Trains,0,0,0,0,0,0,0,0,0,0,0,0,0
UTTARAKHAND,2007,By Machine,0,0,0,0,0,0,0,0,0,0,0,0,0
UTTARAKHAND,2007,By Overdose of sleeping pills,0,1,4,2,0,7,0,2,2,0,0,4,11
UTTARAKHAND,2007,By touching electric wires,0,0,0,0,0,0,0,0,0,0,0,0,0
UTTARAKHAND,2007,By coming under running vehicles/trains,0,0,0,0,0,0,0,0,0,0,0,0,0
UTTARAKHAND,2007,By Other means (please specify),1,3,9,1,0,14,1,3,3,2,0,9,23
UTTARAKHAND,2007,Total,2,53,60,14,1,130,8,63,35,8,4,118,248
UTTARAKHAND,2007,Total (Poison),0,11,19,5,0,35,7,27,11,2,3,50,85
UTTARAKHAND,2007,Total (Jumping),0,0,0,0,0,0,0,1,0,0,0,1,1
UTTARAKHAND,2008,By Over Alcoholism,0,0,1,2,0,3,0,0,0,0,0,0,3
UTTARAKHAND,2008,By Drowning,1,6,6,1,0,14,1,2,1,0,0,4,18
UTTARAKHAND,2008,By Fire/Self Immolation,0,2,2,0,0,4,0,8,4,0,0,12,16
UTTARAKHAND,2008,By Fire-Arms,0,1,1,1,0,3,0,0,0,0,0,0,3
UTTARAKHAND,2008,By Hanging,2,8,10,2,1,23,1,23,6,2,0,32,55
UTTARAKHAND,2008,By Consuming Insecticides,3,10,6,6,1,26,1,12,3,2,0,18,44
UTTARAKHAND,2008,By Consuming Other Poison,1,2,4,3,1,11,0,11,1,3,0,15,26
UTTARAKHAND,2008,By Self Infliction of injury,0,0,1,0,0,1,0,0,0,0,0,0,1
UTTARAKHAND,2008,By Jumping from (Building),0,0,0,0,0,0,0,0,0,0,0,0,0
UTTARAKHAND,2008,By Jumping from (Other sites),0,1,1,0,0,2,0,1,0,0,0,1,3
UTTARAKHAND,2008,By Jumping off Moving Vehicles/Trains,0,0,0,0,0,0,0,0,0,0,0,0,0
UTTARAKHAND,2008,By Machine,0,0,2,0,0,2,0,0,0,0,0,0,2
UTTARAKHAND,2008,By Overdose of sleeping pills,0,0,0,0,0,0,0,0,0,1,0,1,1
UTTARAKHAND,2008,By touching electric wires,0,1,0,2,0,3,0,1,0,0,0,1,4
UTTARAKHAND,2008,By coming under running vehicles/trains,0,1,1,0,0,2,0,0,0,0,0,0,2
UTTARAKHAND,2008,By Other means (please specify),1,5,0,3,1,10,0,3,0,0,0,3,13
UTTARAKHAND,2008,Total,8,37,35,20,4,104,3,61,15,8,0,87,191
UTTARAKHAND,2008,Total (Poison),4,12,11,9,2,38,1,23,4,5,0,33,71
UTTARAKHAND,2008,Total (Jumping),0,1,1,0,0,2,0,1,0,0,0,1,3
UTTARAKHAND,2009,By Over Alcoholism,0,1,4,6,0,11,0,0,0,0,0,0,11
UTTARAKHAND,2009,By Drowning,0,10,10,5,1,26,1,3,7,2,0,13,39
UTTARAKHAND,2009,By Fire/Self Immolation,0,5,5,0,0,10,0,12,8,4,0,24,34
UTTARAKHAND,2009,By Fire-Arms,0,3,0,0,0,3,0,1,0,0,0,1,4
UTTARAKHAND,2009,By Hanging,0,8,19,16,1,44,1,23,7,1,0,32,76
UTTARAKHAND,2009,By Consuming Insecticides,0,20,10,7,3,40,0,21,9,2,1,33,73
UTTARAKHAND,2009,By Consuming Other Poison,0,4,3,9,2,18,0,7,2,1,0,10,28
UTTARAKHAND,2009,By Self Infliction of injury,0,0,0,0,0,0,0,0,0,0,0,0,0
UTTARAKHAND,2009,By Jumping from (Building),1,0,0,0,1,2,0,0,0,1,0,1,3
UTTARAKHAND,2009,By Jumping from (Other sites),0,0,0,0,0,0,0,0,0,0,0,0,0
UTTARAKHAND,2009,By Jumping off Moving Vehicles/Trains,0,0,0,0,0,0,0,0,0,1,0,1,1
UTTARAKHAND,2009,By Machine,0,0,0,0,0,0,0,0,0,0,0,0,0
UTTARAKHAND,2009,By Overdose of sleeping pills,0,0,0,1,0,1,0,0,0,2,0,2,3
UTTARAKHAND,2009,By touching electric wires,0,0,0,1,0,1,0,0,0,0,0,0,1
UTTARAKHAND,2009,By coming under running vehicles/trains,0,3,3,5,0,11,0,0,0,0,0,0,11
UTTARAKHAND,2009,By Other means (please specify),1,23,1,7,3,35,1,12,9,1,0,23,58
UTTARAKHAND,2009,Total,2,77,55,57,11,202,3,79,42,15,1,140,342
UTTARAKHAND,2009,Total (Poison),0,24,13,16,5,58,0,28,11,3,1,43,101
UTTARAKHAND,2009,Total (Jumping),1,0,0,0,1,2,0,0,0,1,0,1,3
UTTARAKHAND,2010,By Over Alcoholism,0,1,2,0,0,3,0,0,0,0,0,0,3
UTTARAKHAND,2010,By Drowning,0,7,4,0,0,11,0,3,1,0,0,4,15
UTTARAKHAND,2010,By Fire/Self Immolation,0,5,1,2,0,8,1,8,6,0,1,16,24
UTTARAKHAND,2010,By Fire-Arms,0,1,1,0,0,2,0,0,0,0,0,0,2
UTTARAKHAND,2010,By Hanging,0,20,8,8,1,37,0,19,10,1,0,30,67
UTTARAKHAND,2010,By Consuming Insecticides,2,6,15,3,2,28,1,18,9,2,0,30,58
UTTARAKHAND,2010,By Consuming Other Poison,0,12,9,9,7,37,0,10,1,5,0,16,53
UTTARAKHAND,2010,By Self Infliction of injury,0,0,1,0,0,1,0,0,0,0,0,0,1
UTTARAKHAND,2010,By Jumping from (Building),0,1,0,2,0,3,0,0,0,0,0,0,3
UTTARAKHAND,2010,By Jumping from (Other sites),0,0,1,0,0,1,0,0,0,0,0,0,1
UTTARAKHAND,2010,By Jumping off Moving Vehicles/Trains,0,3,0,0,0,3,0,0,0,0,0,0,3
UTTARAKHAND,2010,By Machine,0,1,0,0,0,1,0,0,0,0,0,0,1
UTTARAKHAND,2010,By Overdose of sleeping pills,0,0,0,0,0,0,0,0,0,0,0,0,0
UTTARAKHAND,2010,By touching electric wires,0,0,1,0,0,1,0,1,0,0,0,1,2
UTTARAKHAND,2010,By coming under running vehicles/trains,0,0,1,1,0,2,0,0,0,0,0,0,2
UTTARAKHAND,2010,By Other means (please specify),2,5,13,4,2,26,5,10,3,1,1,20,46
UTTARAKHAND,2010,Total,4,62,57,29,12,164,7,69,30,9,2,117,281
UTTARAKHAND,2010,Total (Poison),2,18,25,12,9,66,1,28,10,7,0,46,112
UTTARAKHAND,2010,Total (Jumping),0,1,1,2,0,4,0,0,0,0,0,0,4
UTTARAKHAND,2011,By Over Alcoholism,0,0,3,1,1,5,0,0,0,0,0,0,5
UTTARAKHAND,2011,By Drowning,2,7,8,6,1,24,1,5,2,3,0,11,35
UTTARAKHAND,2011,By Fire/Self Immolation,0,3,3,0,0,6,0,5,3,0,0,8,14
UTTARAKHAND,2011,By Fire-Arms,0,2,2,1,0,5,0,0,0,0,0,0,5
UTTARAKHAND,2011,By Hanging,1,21,18,9,0,49,0,24,17,2,0,43,92
UTTARAKHAND,2011,By Consuming Insecticides,0,16,12,7,3,38,0,15,15,2,0,32,70
UTTARAKHAND,2011,By Consuming Other Poison,1,5,11,2,4,23,0,6,4,2,0,12,35
UTTARAKHAND,2011,By Self Infliction of injury,0,1,1,2,1,5,0,0,0,0,0,0,5
UTTARAKHAND,2011,By Jumping from (Building),0,1,0,0,0,1,0,0,0,0,0,0,1
UTTARAKHAND,2011,By Jumping from (Other sites),0,0,0,0,0,0,0,0,0,1,0,1,1
UTTARAKHAND,2011,By Jumping off Moving Vehicles/Trains,0,0,0,1,0,1,0,0,0,0,0,0,1
UTTARAKHAND,2011,By Machine,0,0,0,0,0,0,0,0,0,0,0,0,0
UTTARAKHAND,2011,By Overdose of sleeping pills,0,0,0,0,0,0,0,0,0,0,0,0,0
UTTARAKHAND,2011,By touching electric wires,0,1,3,1,0,5,0,1,0,0,0,1,6
UTTARAKHAND,2011,By coming under running vehicles/trains,0,5,5,3,1,14,0,1,0,0,0,1,15
UTTARAKHAND,2011,By Other means (please specify),1,7,7,1,0,16,0,12,3,0,1,16,32
UTTARAKHAND,2011,Total,5,69,73,34,11,192,1,69,44,10,1,125,317
UTTARAKHAND,2011,Total (Poison),1,22,24,11,8,66,0,21,19,4,0,44,110
UTTARAKHAND,2011,Total (Jumping),0,1,0,0,0,1,0,0,0,1,0,1,2
UTTARAKHAND,2012,By Over Alcoholism,0,8,2,2,1,13,0,0,0,0,0,0,13
UTTARAKHAND,2012,By Drowning,1,8,10,2,0,21,2,4,0,0,0,6,27
UTTARAKHAND,2012,By Fire/Self Immolation,0,0,6,1,1,8,0,7,0,0,1,8,16
UTTARAKHAND,2012,By Fire-Arms,0,0,3,0,0,3,0,1,1,0,0,2,5
UTTARAKHAND,2012,By Hanging,3,33,41,6,3,86,2,44,10,1,3,60,146
UTTARAKHAND,2012,By Consuming Insecticides,0,0,0,0,0,0,0,0,0,0,0,0,0
UTTARAKHAND,2012,By Consuming Other Poison,2,7,10,9,3,31,2,13,6,1,0,22,53
UTTARAKHAND,2012,By Self Infliction of injury,0,6,22,5,1,34,0,10,10,0,0,20,54
UTTARAKHAND,2012,By Jumping from (Building),0,0,0,0,0,0,0,0,0,0,0,0,0
UTTARAKHAND,2012,By Jumping from (Other sites),0,0,1,0,0,1,0,0,1,0,0,1,2
UTTARAKHAND,2012,By Jumping off Moving Vehicles/Trains,0,4,1,0,0,5,0,1,0,0,0,1,6
UTTARAKHAND,2012,By Machine,0,0,0,0,0,0,0,0,0,0,0,0,0
UTTARAKHAND,2012,By Overdose of sleeping pills,0,0,0,0,0,0,0,0,0,0,0,0,0
UTTARAKHAND,2012,By touching electric wires,0,2,2,0,0,4,0,0,0,0,0,0,4
UTTARAKHAND,2012,By coming under running vehicles/trains,0,1,0,0,0,1,0,0,0,0,0,0,1
UTTARAKHAND,2012,By Other means (please specify),1,4,8,22,7,42,3,20,19,10,3,55,97
UTTARAKHAND,2012,Total,7,73,106,47,16,249,9,100,47,12,7,175,424
UTTARAKHAND,2012,Total (Poison),2,13,32,14,4,65,2,23,16,1,0,42,107
UTTARAKHAND,2012,Total (Jumping),0,0,1,0,0,1,0,0,1,0,0,1,2
WEST BENGAL,2001,By Over Alcoholism,0,26,36,41,38,141,0,0,2,5,0,7,148
WEST BENGAL,2001,By Drowning,32,130,74,95,32,363,17,141,82,34,17,291,654
WEST BENGAL,2001,By Fire/Self Immolation,16,44,34,34,7,135,10,148,154,55,13,380,515
WEST BENGAL,2001,By Fire-Arms,0,1,0,7,2,10,0,23,3,7,0,33,43
WEST BENGAL,2001,By Hanging,42,638,671,423,88,1862,47,658,558,252,71,1586,3448
WEST BENGAL,2001,By Consuming Insecticides,27,157,202,217,79,682,19,295,252,140,29,735,1417
WEST BENGAL,2001,By Consuming Other Poison,85,501,521,387,118,1612,59,602,446,261,56,1424,3036
WEST BENGAL,2001,By Self Infliction of injury,0,3,17,20,15,55,0,0,10,2,2,14,69
WEST BENGAL,2001,By Jumping from (Building),1,23,48,39,9,120,8,28,18,24,52,130,250
WEST BENGAL,2001,By Jumping from (Other sites),0,14,14,22,11,61,4,9,19,2,12,46,107
WEST BENGAL,2001,By Jumping off Moving Vehicles/Trains,0,21,9,17,13,60,7,5,1,1,1,15,75
WEST BENGAL,2001,By Machine,0,39,20,20,1,80,0,0,0,0,0,0,80
WEST BENGAL,2001,By Overdose of sleeping pills,0,21,101,77,66,265,0,17,36,38,50,141,406
WEST BENGAL,2001,By touching electric wires,1,33,20,51,20,125,8,15,18,17,14,72,197
WEST BENGAL,2001,By coming under running vehicles/trains,4,117,306,177,42,646,1,118,88,48,15,270,916
WEST BENGAL,2001,By Other means (please specify),75,259,353,419,172,1278,103,195,328,284,141,1051,2329
WEST BENGAL,2001,Total,283,2027,2426,2046,713,7495,283,2254,2015,1170,473,6195,13690
WEST BENGAL,2001,Total (Poison),112,661,740,624,212,2349,78,897,708,403,87,2173,4522
WEST BENGAL,2001,Total (Jumping),1,37,62,61,20,181,12,37,37,26,64,176,357
WEST BENGAL,2002,By Over Alcoholism,0,12,34,34,16,96,0,0,1,4,0,5,101
WEST BENGAL,2002,By Drowning,34,143,69,80,13,339,29,153,100,46,15,343,682
WEST BENGAL,2002,By Fire/Self Immolation,11,48,38,50,11,158,13,142,101,59,21,336,494
WEST BENGAL,2002,By Fire-Arms,2,12,13,9,3,39,0,4,6,0,0,10,49
WEST BENGAL,2002,By Hanging,54,731,699,424,138,2046,61,661,554,290,75,1641,3687
WEST BENGAL,2002,By Consuming Insecticides,18,195,234,134,56,637,36,180,176,159,39,590,1227
WEST BENGAL,2002,By Consuming Other Poison,68,441,370,291,87,1257,59,596,383,217,47,1302,2559
WEST BENGAL,2002,By Self Infliction of injury,0,16,17,20,7,60,0,1,12,0,0,13,73
WEST BENGAL,2002,By Jumping from (Building),0,20,27,28,8,83,8,22,14,23,13,80,163
WEST BENGAL,2002,By Jumping from (Other sites),5,24,20,12,9,70,12,19,29,5,12,77,147
WEST BENGAL,2002,By Jumping off Moving Vehicles/Trains,0,11,16,20,8,55,4,5,1,0,0,10,65
WEST BENGAL,2002,By Machine,0,41,29,21,3,94,0,0,0,0,0,0,94
WEST BENGAL,2002,By Overdose of sleeping pills,1,19,35,24,18,97,5,30,47,31,27,140,237
WEST BENGAL,2002,By touching electric wires,2,31,24,30,20,107,5,11,19,14,15,64,171
WEST BENGAL,2002,By coming under running vehicles/trains,6,108,133,66,16,329,5,46,39,36,4,130,459
WEST BENGAL,2002,By Other means,82,363,596,468,148,1657,57,288,506,200,91,1142,2799
WEST BENGAL,2002,Total,283,2215,2354,1711,561,7124,294,2158,1988,1084,359,5883,13007
WEST BENGAL,2002,Total (Poison),86,652,621,445,150,1954,95,777,571,376,86,1905,3859
WEST BENGAL,2002,Total (Jumping),5,44,47,40,17,153,20,41,43,28,25,157,310
WEST BENGAL,2003,By Over Alcoholism,0,23,36,49,2,110,0,2,5,0,0,7,117
WEST BENGAL,2003,By Drowning,0,175,202,23,7,407,0,140,103,12,0,255,662
WEST BENGAL,2003,By Fire/Self Immolation,0,186,207,68,15,476,2,248,202,161,21,634,1110
WEST BENGAL,2003,By Fire-Arms,0,1,12,4,1,18,0,0,0,0,0,0,18
WEST BENGAL,2003,By Hanging,1,793,820,507,144,2265,1,823,565,381,38,1808,4073
WEST BENGAL,2003,By Consuming Insecticides,14,190,310,266,31,811,32,228,226,116,25,627,1438
WEST BENGAL,2003,By Consuming Other Poison,22,633,637,493,212,1997,36,659,540,302,56,1593,3590
WEST BENGAL,2003,By Self Infliction of injury,0,15,12,12,7,46,0,19,16,8,10,53,99
WEST BENGAL,2003,By Jumping from (Building),0,25,32,44,7,108,0,16,44,12,8,80,188
WEST BENGAL,2003,By Jumping from (Other sites),0,26,24,25,7,82,0,7,12,5,4,28,110
WEST BENGAL,2003,By Jumping off Moving Vehicles/Trains,0,4,9,8,4,25,0,7,5,1,0,13,38
WEST BENGAL,2003,By Machine,0,0,6,7,2,15,0,0,0,0,0,0,15
WEST BENGAL,2003,By Overdose of sleeping pills,0,122,97,124,79,422,0,17,71,113,155,356,778
WEST BENGAL,2003,By touching electric wires,0,4,1,1,4,10,0,0,2,3,1,6,16
WEST BENGAL,2003,By coming under running vehicles/trains,8,66,58,21,6,159,4,17,23,11,1,56,215
WEST BENGAL,2003,By Other means (please specify),16,133,155,118,51,473,23,99,81,66,71,340,813
WEST BENGAL,2003,Total,61,2396,2618,1770,579,7424,98,2282,1895,1191,390,5856,13280
WEST BENGAL,2003,Total (Poison),36,838,959,771,250,2854,68,906,782,426,91,2273,5127
WEST BENGAL,2003,Total (Jumping),0,51,56,69,14,190,0,23,56,17,12,108,298
WEST BENGAL,2004,By Over Alcoholism,0,23,52,61,20,156,0,0,3,2,1,6,162
WEST BENGAL,2004,By Drowning,22,50,65,70,10,217,25,80,49,50,9,213,430
WEST BENGAL,2004,By Fire/Self Immolation,2,58,41,51,7,159,6,144,124,31,3,308,467
WEST BENGAL,2004,By Fire-Arms,0,2,10,4,1,17,0,7,2,1,0,10,27
WEST BENGAL,2004,By Hanging,56,781,837,607,159,2440,54,796,713,255,81,1899,4339
WEST BENGAL,2004,By Consuming Insecticides,3,76,103,39,21,242,13,132,85,46,24,300,542
WEST BENGAL,2004,By Consuming Other Poison,97,845,785,433,120,2280,131,848,533,293,62,1867,4147
WEST BENGAL,2004,By Self Infliction of injury,0,0,3,31,1,35,0,0,4,0,0,4,39
WEST BENGAL,2004,By Jumping from (Building),2,10,8,7,1,28,0,4,3,4,1,12,40
WEST BENGAL,2004,By Jumping from (Other sites),3,12,25,20,2,62,0,2,3,0,0,5,67
WEST BENGAL,2004,By Jumping off Moving Vehicles/Trains,0,18,12,1,1,32,0,3,5,0,0,8,40
WEST BENGAL,2004,By Machine,0,3,3,9,0,15,0,0,0,0,0,0,15
WEST BENGAL,2004,By Overdose of sleeping pills,0,34,44,60,49,187,0,36,43,30,8,117,304
WEST BENGAL,2004,By touching electric wires,0,11,8,5,1,25,0,2,2,1,0,5,30
WEST BENGAL,2004,By coming under running vehicles/trains,2,67,60,35,14,178,1,21,14,12,4,52,230
WEST BENGAL,2004,By Other means (please specify),97,365,494,476,156,1588,59,295,353,191,59,957,2545
WEST BENGAL,2004,Total,284,2355,2550,1909,563,7661,289,2370,1936,916,252,5763,13424
WEST BENGAL,2004,Total (Poison),100,921,891,503,142,2557,144,980,622,339,86,2171,4728
WEST BENGAL,2004,Total (Jumping),5,22,33,27,3,90,0,6,6,4,1,17,107
WEST BENGAL,2005,By Over Alcoholism,0,12,24,42,2,80,0,0,6,3,0,9,89
WEST BENGAL,2005,By Drowning,27,105,132,54,15,333,14,65,32,26,4,141,474
WEST BENGAL,2005,By Fire/Self Immolation,1,99,135,39,7,281,4,233,179,87,28,531,812
WEST BENGAL,2005,By Fire-Arms,0,8,4,0,0,12,0,1,1,1,1,4,16
WEST BENGAL,2005,By Hanging,66,1001,1047,644,140,2898,73,1145,738,388,93,2437,5335
WEST BENGAL,2005,By Consuming Insecticides,13,191,213,94,33,544,15,165,119,62,25,386,930
WEST BENGAL,2005,By Consuming Other Poison,58,1023,850,723,185,2839,76,900,632,390,84,2082,4921
WEST BENGAL,2005,By Self Infliction of injury,0,2,2,1,0,5,0,3,0,0,0,3,8
WEST BENGAL,2005,By Jumping from (Building),0,7,20,7,8,42,0,11,23,2,0,36,78
WEST BENGAL,2005,By Jumping from (Other sites),3,8,9,12,2,34,0,2,0,0,0,2,36
WEST BENGAL,2005,By Jumping off Moving Vehicles/Trains,0,9,4,5,4,22,0,8,6,2,0,16,38
WEST BENGAL,2005,By Machine,0,6,8,7,1,22,0,0,0,0,0,0,22
WEST BENGAL,2005,By Overdose of sleeping pills,0,15,56,131,67,269,0,53,42,21,33,149,418
WEST BENGAL,2005,By touching electric wires,0,9,10,11,3,33,0,8,5,6,0,19,52
WEST BENGAL,2005,By coming under running vehicles/trains,2,36,43,39,7,127,5,32,22,19,0,78,205
WEST BENGAL,2005,By Other means (please specify),44,431,344,199,55,1073,18,154,114,171,51,508,1581
WEST BENGAL,2005,Total,214,2962,2901,2008,529,8614,205,2780,1919,1178,319,6401,15015
WEST BENGAL,2005,Total (Poison),71,1216,1065,818,218,3388,91,1068,751,452,109,2471,5859
WEST BENGAL,2005,Total (Jumping),3,15,29,19,10,76,0,13,23,2,0,38,114
WEST BENGAL,2006,By Over Alcoholism,0,22,90,88,21,221,0,0,3,6,2,11,232
WEST BENGAL,2006,By Drowning,23,146,171,92,20,452,27,100,78,50,12,267,719
WEST BENGAL,2006,By Fire/Self Immolation,3,106,157,82,24,372,13,273,164,135,14,599,971
WEST BENGAL,2006,By Fire-Arms,0,7,14,1,0,22,0,0,0,5,0,5,27
WEST BENGAL,2006,By Hanging,19,1058,1399,722,144,3342,32,1440,894,585,103,3054,6396
WEST BENGAL,2006,By Consuming Insecticides,28,412,480,403,81,1404,26,307,234,91,33,691,2095
WEST BENGAL,2006,By Consuming Other Poison,71,1041,869,289,121,2391,86,781,387,256,63,1573,3964
WEST BENGAL,2006,By Self Infliction of injury,0,0,8,7,1,16,0,3,7,1,1,12,28
WEST BENGAL,2006,By Jumping from (Building),0,26,13,2,2,43,0,3,2,4,0,9,52
WEST BENGAL,2006,By Jumping from (Other sites),0,67,96,10,6,179,0,5,52,32,9,98,277
WEST BENGAL,2006,By Jumping off Moving Vehicles/Trains,2,53,41,44,3,143,0,32,30,1,5,68,211
WEST BENGAL,2006,By Machine,0,8,8,9,2,27,0,2,2,1,0,5,32
WEST BENGAL,2006,By Overdose of sleeping pills,0,8,26,71,114,219,0,9,13,30,27,79,298
WEST BENGAL,2006,By touching electric wires,0,2,13,5,1,21,0,3,1,0,0,4,25
WEST BENGAL,2006,By coming under running vehicles/trains,4,81,83,68,25,261,0,39,38,37,7,121,382
WEST BENGAL,2006,By Other means (please specify),0,0,7,0,0,7,0,1,8,0,0,9,16
WEST BENGAL,2006,Total,150,3037,3475,1893,565,9120,184,2998,1913,1234,276,6605,15725
WEST BENGAL,2006,Total (Poison),99,1453,1357,699,203,3811,112,1091,628,348,97,2276,6087
WEST BENGAL,2006,Total (Jumping),0,93,109,12,8,222,0,8,54,36,9,107,329
WEST BENGAL,2007,By Over Alcoholism,0,20,64,100,42,226,0,2,4,5,0,11,237
WEST BENGAL,2007,By Drowning,37,66,56,30,8,197,18,43,30,29,6,126,323
WEST BENGAL,2007,By Fire/Self Immolation,0,35,36,16,5,92,12,153,71,25,4,265,357
WEST BENGAL,2007,By Fire-Arms,0,7,8,8,0,23,0,1,0,0,0,1,24
WEST BENGAL,2007,By Hanging,52,945,1121,649,124,2891,43,1032,843,314,46,2278,5169
WEST BENGAL,2007,By Consuming Insecticides,28,534,587,409,108,1666,38,600,380,169,35,1222,2888
WEST BENGAL,2007,By Consuming Other Poison,30,564,558,325,77,1554,37,524,550,241,32,1384,2938
WEST BENGAL,2007,By Self Infliction of injury,0,1,2,0,2,5,0,2,4,1,0,7,12
WEST BENGAL,2007,By Jumping from (Building),4,2,111,15,1,133,10,2,20,44,0,76,209
WEST BENGAL,2007,By Jumping from (Other sites),0,3,5,2,0,10,2,6,3,0,0,11,21
WEST BENGAL,2007,By Jumping off Moving Vehicles/Trains,0,16,19,7,2,44,1,12,5,0,0,18,62
WEST BENGAL,2007,By Machine,0,5,2,3,4,14,0,0,0,0,0,0,14
WEST BENGAL,2007,By Overdose of sleeping pills,0,17,32,26,14,89,0,28,35,16,12,91,180
WEST BENGAL,2007,By touching electric wires,4,23,18,8,4,57,1,9,6,3,2,21,78
WEST BENGAL,2007,By coming under running vehicles/trains,15,56,262,114,40,487,14,52,66,45,14,191,678
WEST BENGAL,2007,By Other means (please specify),47,352,325,228,65,1017,26,264,161,121,81,653,1670
WEST BENGAL,2007,Total,217,2646,3206,1940,496,8505,202,2730,2178,1013,232,6355,14860
WEST BENGAL,2007,Total (Poison),58,1099,1147,734,187,3225,75,1126,934,411,67,2613,5838
WEST BENGAL,2007,Total (Jumping),4,5,116,17,1,143,12,8,23,44,0,87,230
WEST BENGAL,2008,By Over Alcoholism,0,18,53,38,21,130,0,10,7,0,0,17,147
WEST BENGAL,2008,By Drowning,37,88,89,28,11,253,32,46,37,15,4,134,387
WEST BENGAL,2008,By Fire/Self Immolation,0,22,51,5,1,79,11,120,95,39,1,266,345
WEST BENGAL,2008,By Fire-Arms,0,11,9,4,1,25,0,0,1,2,0,3,28
WEST BENGAL,2008,By Hanging,95,1145,1234,506,92,3072,60,1018,879,288,42,2287,5359
WEST BENGAL,2008,By Consuming Insecticides,46,420,543,255,38,1302,38,435,361,163,17,1014,2316
WEST BENGAL,2008,By Consuming Other Poison,40,642,682,295,57,1716,55,894,559,163,31,1702,3418
WEST BENGAL,2008,By Self Infliction of injury,0,3,1,3,0,7,0,0,0,0,0,0,7
WEST BENGAL,2008,By Jumping from (Building),0,3,35,13,0,51,0,2,0,0,0,2,53
WEST BENGAL,2008,By Jumping from (Other sites),0,3,3,0,0,6,0,0,0,0,0,0,6
WEST BENGAL,2008,By Jumping off Moving Vehicles/Trains,0,21,21,6,0,48,0,9,5,3,3,20,68
WEST BENGAL,2008,By Machine,0,4,17,12,1,34,0,0,0,2,2,4,38
WEST BENGAL,2008,By Overdose of sleeping pills,0,5,20,27,9,61,0,25,25,15,3,68,129
WEST BENGAL,2008,By touching electric wires,4,32,52,46,3,137,2,8,7,16,2,35,172
WEST BENGAL,2008,By coming under running vehicles/trains,16,59,117,97,27,316,4,55,50,24,8,141,457
WEST BENGAL,2008,By Other means (please specify),37,330,400,258,107,1132,39,382,134,172,63,790,1922
WEST BENGAL,2008,Total,275,2806,3327,1593,368,8369,241,3004,2160,902,176,6483,14852
WEST BENGAL,2008,Total (Poison),86,1065,1226,553,95,3025,93,1329,920,326,48,2716,5741
WEST BENGAL,2008,Total (Jumping),0,6,38,13,0,57,0,2,0,0,0,2,59
WEST BENGAL,2009,By Over Alcoholism,0,12,28,19,16,75,0,1,0,0,0,1,76
WEST BENGAL,2009,By Drowning,49,102,103,31,7,292,19,35,37,14,5,110,402
WEST BENGAL,2009,By Fire/Self Immolation,0,25,64,18,0,107,4,119,92,35,4,254,361
WEST BENGAL,2009,By Fire-Arms,0,11,10,3,0,24,0,0,0,1,0,1,25
WEST BENGAL,2009,By Hanging,76,969,1128,717,154,3044,70,952,823,345,49,2239,5283
WEST BENGAL,2009,By Consuming Insecticides,20,205,402,274,27,928,33,283,263,86,9,674,1602
WEST BENGAL,2009,By Consuming Other Poison,43,643,820,388,77,1971,43,811,567,240,36,1697,3668
WEST BENGAL,2009,By Self Infliction of injury,0,8,14,3,4,29,0,6,4,0,0,10,39
WEST BENGAL,2009,By Jumping from (Building),2,8,31,15,2,58,0,2,0,1,0,3,61
WEST BENGAL,2009,By Jumping from (Other sites),3,20,158,44,15,240,3,127,58,32,6,226,466
WEST BENGAL,2009,By Jumping off Moving Vehicles/Trains,3,16,24,10,2,55,1,11,7,2,2,23,78
WEST BENGAL,2009,By Machine,0,6,22,5,1,34,0,0,0,1,0,1,35
WEST BENGAL,2009,By Overdose of sleeping pills,0,14,16,22,8,60,0,28,20,11,4,63,123
WEST BENGAL,2009,By touching electric wires,1,24,12,19,2,58,0,0,8,4,0,12,70
WEST BENGAL,2009,By coming under running vehicles/trains,3,54,180,89,8,334,3,50,53,30,9,145,479
WEST BENGAL,2009,By Other means (please specify),35,290,397,323,140,1185,42,300,199,82,72,695,1880
WEST BENGAL,2009,Total,235,2407,3409,1980,463,8494,218,2725,2131,884,196,6154,14648
WEST BENGAL,2009,Total (Poison),63,856,1236,665,108,2928,76,1100,834,326,45,2381,5309
WEST BENGAL,2009,Total (Jumping),5,28,189,59,17,298,3,129,58,33,6,229,527
WEST BENGAL,2010,By Over Alcoholism,0,3,20,20,9,52,0,0,0,4,1,5,57
WEST BENGAL,2010,By Drowning,32,129,129,52,18,360,12,70,51,36,18,187,547
WEST BENGAL,2010,By Fire/Self Immolation,0,25,84,32,10,151,18,199,146,68,17,448,599
WEST BENGAL,2010,By Fire-Arms,0,8,7,2,0,17,0,0,0,0,0,0,17
WEST BENGAL,2010,By Hanging,64,892,1176,671,182,2985,49,867,731,341,85,2073,5058
WEST BENGAL,2010,By Consuming Insecticides,59,382,476,313,45,1275,31,361,335,120,36,883,2158
WEST BENGAL,2010,By Consuming Other Poison,12,317,531,319,38,1217,17,479,438,187,26,1147,2364
WEST BENGAL,2010,By Self Infliction of injury,0,6,8,7,4,25,0,0,0,2,1,3,28
WEST BENGAL,2010,By Jumping from (Building),1,18,43,31,3,96,0,6,8,3,0,17,113
WEST BENGAL,2010,By Jumping from (Other sites),2,47,43,34,8,134,2,32,43,46,21,144,278
WEST BENGAL,2010,By Jumping off Moving Vehicles/Trains,0,14,28,8,4,54,2,14,4,3,0,23,77
WEST BENGAL,2010,By Machine,0,17,27,9,0,53,0,1,0,2,0,3,56
WEST BENGAL,2010,By Overdose of sleeping pills,0,5,14,21,6,46,0,29,25,8,5,67,113
WEST BENGAL,2010,By touching electric wires,5,40,23,22,9,99,1,6,9,9,6,31,130
WEST BENGAL,2010,By coming under running vehicles/trains,5,81,135,112,17,350,3,69,65,38,4,179,529
WEST BENGAL,2010,By Other means (please specify),88,692,751,651,205,2387,77,493,522,364,70,1526,3913
WEST BENGAL,2010,Total,268,2676,3495,2304,558,9301,212,2626,2377,1231,290,6736,16037
WEST BENGAL,2010,Total (Poison),71,705,1015,639,87,2517,48,840,773,309,63,2033,4550
WEST BENGAL,2010,Total (Jumping),3,65,86,65,11,230,2,38,51,49,21,161,391
WEST BENGAL,2011,By Over Alcoholism,0,9,22,35,15,81,0,0,0,1,0,1,82
WEST BENGAL,2011,By Drowning,30,64,65,46,17,222,22,133,21,21,8,205,427
WEST BENGAL,2011,By Fire/Self Immolation,3,17,39,10,3,72,10,136,84,56,10,296,368
WEST BENGAL,2011,By Fire-Arms,0,12,26,13,2,53,0,1,0,0,0,1,54
WEST BENGAL,2011,By Hanging,45,907,1156,782,216,3106,44,1032,817,353,105,2351,5457
WEST BENGAL,2011,By Consuming Insecticides,22,333,367,192,46,960,40,370,177,68,13,668,1628
WEST BENGAL,2011,By Consuming Other Poison,28,388,819,458,108,1801,47,566,621,245,46,1525,3326
WEST BENGAL,2011,By Self Infliction of injury,0,3,3,2,1,9,1,0,2,1,1,5,14
WEST BENGAL,2011,By Jumping from (Building),1,7,30,21,0,59,1,2,3,3,0,9,68
WEST BENGAL,2011,By Jumping from (Other sites),6,13,13,9,8,49,19,3,19,20,10,71,120
WEST BENGAL,2011,By Jumping off Moving Vehicles/Trains,0,14,10,3,0,27,1,12,5,2,0,20,47
WEST BENGAL,2011,By Machine,0,1,3,5,0,9,0,0,0,0,0,0,9
WEST BENGAL,2011,By Overdose of sleeping pills,0,7,15,18,4,44,0,30,14,7,1,52,96
WEST BENGAL,2011,By touching electric wires,3,36,26,9,2,76,2,18,5,3,1,29,105
WEST BENGAL,2011,By coming under running vehicles/trains,3,74,212,152,14,455,0,82,92,52,3,229,684
WEST BENGAL,2011,By Other means (please specify),143,636,986,541,295,2601,71,328,466,329,212,1406,4007
WEST BENGAL,2011,Total,284,2521,3792,2296,731,9624,258,2713,2326,1161,410,6868,16492
WEST BENGAL,2011,Total (Poison),50,724,1189,652,155,2770,88,936,800,314,60,2198,4968
WEST BENGAL,2011,Total (Jumping),7,20,43,30,8,108,20,5,22,23,10,80,188
WEST BENGAL,2012,By Over Alcoholism,0,10,28,16,15,69,0,0,0,0,1,1,70
WEST BENGAL,2012,By Drowning,37,85,87,84,19,312,20,43,52,34,13,162,474
WEST BENGAL,2012,By Fire/Self Immolation,2,60,85,55,21,223,17,238,220,66,24,565,788
WEST BENGAL,2012,By Fire-Arms,0,5,12,6,0,23,0,2,0,1,2,5,28
WEST BENGAL,2012,By Hanging,58,868,1056,671,180,2833,45,867,881,369,69,2231,5064
WEST BENGAL,2012,By Consuming Insecticides,14,288,278,147,53,780,16,284,194,86,23,603,1383
WEST BENGAL,2012,By Consuming Other Poison,40,454,652,436,99,1681,51,499,417,237,34,1238,2919
WEST BENGAL,2012,By Self Infliction of injury,1,23,22,3,2,51,1,24,23,5,1,54,105
WEST BENGAL,2012,By Jumping from (Building),0,2,11,3,4,20,0,3,4,0,0,7,27
WEST BENGAL,2012,By Jumping from (Other sites),1,10,19,4,0,34,2,17,12,2,2,35,69
WEST BENGAL,2012,By Jumping off Moving Vehicles/Trains,2,40,28,18,7,95,0,38,17,5,0,60,155
WEST BENGAL,2012,By Machine,0,2,1,0,0,3,0,0,0,0,0,0,3
WEST BENGAL,2012,By Overdose of sleeping pills,0,16,40,17,4,77,0,1,13,3,6,23,100
WEST BENGAL,2012,By touching electric wires,0,0,0,0,0,0,0,0,0,0,0,0,0
WEST BENGAL,2012,By coming under running vehicles/trains,1,71,63,64,20,219,3,25,26,23,3,80,299
WEST BENGAL,2012,By Other means (please specify),77,610,836,496,241,2260,36,257,468,244,208,1213,3473
WEST BENGAL,2012,Total,233,2544,3218,2020,665,8680,191,2298,2327,1075,386,6277,14957
WEST BENGAL,2012,Total (Poison),55,765,952,586,154,2512,68,807,634,328,58,1895,4407
WEST BENGAL,2012,Total (Jumping),1,12,30,7,4,54,2,20,16,2,2,42,96
TOTAL (STATES),2001,By Over Alcoholism,1,178,457,351,170,1157,0,32,36,42,10,120,1277
TOTAL (STATES),2001,By Drowning,275,1352,1626,950,472,4675,198,1529,959,508,353,3547,8222
TOTAL (STATES),2001,By Fire/Self Immolation,105,1040,1334,705,247,3431,165,3592,2214,784,356,7111,10542
TOTAL (STATES),2001,By Fire-Arms,12,101,65,52,21,251,1,71,27,15,5,119,370
TOTAL (STATES),2001,By Hanging,269,5846,6815,4410,1632,18972,272,4459,3004,1456,531,9722,28694
TOTAL (STATES),2001,By Consuming Insecticides,255,4217,4501,3181,1202,13356,291,3697,2521,1096,377,7982,21338
TOTAL (STATES),2001,By Consuming Other Poison,217,3819,4566,2864,937,12403,226,3283,2369,1136,346,7360,19763
TOTAL (STATES),2001,By Self Infliction of injury,10,56,148,100,51,365,2,71,42,17,10,142,507
TOTAL (STATES),2001,By Jumping from (Building),13,107,157,87,27,391,13,63,42,39,60,217,608
TOTAL (STATES),2001,By Jumping from (Other sites),21,131,184,101,36,473,16,89,88,32,21,246,719
TOTAL (STATES),2001,By Jumping off Moving Vehicles/Trains,5,150,184,103,68,510,10,52,53,29,8,152,662
TOTAL (STATES),2001,By Machine,5,88,73,32,3,201,3,5,5,1,2,16,217
TOTAL (STATES),2001,By Overdose of sleeping pills,11,143,235,189,112,690,7,111,93,93,89,393,1083
TOTAL (STATES),2001,By touching electric wires,17,269,249,193,90,818,16,67,60,41,28,212,1030
TOTAL (STATES),2001,By coming under running vehicles/trains,23,684,1092,646,256,2701,15,339,265,154,71,844,3545
TOTAL (STATES),2001,By Other means (please specify),240,1344,1388,1215,517,4704,237,1005,935,667,350,3194,7898
TOTAL (STATES),2001,Total,1479,19525,23074,15179,5841,65098,1472,18465,12713,6110,2617,41377,106475
TOTAL (STATES),2001,Total (Poison),482,8092,9215,6145,2190,26124,519,7051,4932,2249,733,15484,41608
TOTAL (STATES),2001,Total (Jumping),34,238,341,188,63,864,29,152,130,71,81,463,1327
TOTAL (STATES),2002,By Over Alcoholism,0,190,481,419,141,1231,2,15,24,23,14,78,1309
TOTAL (STATES),2002,By Drowning,195,1392,1480,1037,498,4602,165,1384,1067,558,343,3517,8119
TOTAL (STATES),2002,By Fire/Self Immolation,55,1117,1276,765,269,3482,168,3434,2171,850,328,6951,10433
TOTAL (STATES),2002,By Fire-Arms,9,112,132,71,22,346,2,48,50,13,0,113,459
TOTAL (STATES),2002,By Hanging,258,6233,7538,4665,1865,20559,314,4615,2981,1347,545,9802,30361
TOTAL (STATES),2002,By Consuming Insecticides,203,4407,4823,2985,1130,13548,242,3555,2312,1091,427,7627,21175
TOTAL (STATES),2002,By Consuming Other Poison,201,3691,4284,2973,1154,12303,222,3208,2098,1095,371,6994,19297
TOTAL (STATES),2002,By Self Infliction of injury,3,83,109,111,58,364,2,48,60,36,10,156,520
TOTAL (STATES),2002,By Jumping from (Building),8,102,189,108,42,449,16,64,68,58,18,224,673
TOTAL (STATES),2002,By Jumping from (Other sites),21,147,183,116,47,514,19,75,89,40,37,260,774
TOTAL (STATES),2002,By Jumping off Moving Vehicles/Trains,8,111,177,109,62,467,8,51,31,13,9,112,579
TOTAL (STATES),2002,By Machine,2,78,53,34,4,171,2,8,3,0,0,13,184
TOTAL (STATES),2002,By Overdose of sleeping pills,7,137,198,120,78,540,10,119,125,78,60,392,932
TOTAL (STATES),2002,By touching electric wires,33,181,188,114,49,565,11,43,47,24,17,142,707
TOTAL (STATES),2002,By coming under running vehicles/trains,22,877,1166,665,284,3014,18,274,263,129,50,734,3748
TOTAL (STATES),2002,By Other means (please specify),257,1597,2086,1427,566,5933,351,1052,1120,492,281,3296,9229
TOTAL (STATES),2002,Total,1282,20455,24363,15719,6269,68088,1552,17993,12509,5847,2510,40411,108499
TOTAL (STATES),2002,Total (Poison),407,8181,9216,6069,2342,26215,466,6811,4470,2222,808,14777,40992
TOTAL (STATES),2002,Total (Jumping),29,249,372,224,89,963,35,139,157,98,55,484,1447
TOTAL (STATES),2003,By Over Alcoholism,5,179,425,330,87,1026,3,17,25,20,7,72,1098
TOTAL (STATES),2003,By Drowning,248,1526,1706,908,424,4812,145,1329,959,380,319,3132,7944
TOTAL (STATES),2003,By Fire/Self Immolation,75,1221,1337,675,205,3513,146,3273,2087,871,319,6696,10209
TOTAL (STATES),2003,By Fire-Arms,6,127,126,87,13,359,8,63,33,15,2,121,480
TOTAL (STATES),2003,By Hanging,251,6564,7579,4889,1922,21205,255,4893,3082,1560,485,10275,31480
TOTAL (STATES),2003,By Consuming Insecticides,213,4824,5393,3346,1249,15025,244,3529,2307,1284,453,7817,22842
TOTAL (STATES),2003,By Consuming Other Poison,149,3665,4106,3062,1266,12248,230,2912,2265,1174,450,7031,19279
TOTAL (STATES),2003,By Self Infliction of injury,0,89,82,72,28,271,2,59,42,26,22,151,422
TOTAL (STATES),2003,By Jumping from (Building),11,124,161,103,39,438,7,77,73,31,17,205,643
TOTAL (STATES),2003,By Jumping from (Other sites),8,121,138,106,28,401,3,61,57,31,10,162,563
TOTAL (STATES),2003,By Jumping off Moving Vehicles/Trains,5,108,141,83,28,365,2,48,46,13,11,120,485
TOTAL (STATES),2003,By Machine,2,33,46,29,5,115,0,2,2,1,0,5,120
TOTAL (STATES),2003,By Overdose of sleeping pills,1,226,214,204,129,774,7,115,151,159,169,601,1375
TOTAL (STATES),2003,By touching electric wires,33,187,208,135,50,613,8,41,45,23,8,125,738
TOTAL (STATES),2003,By coming under running vehicles/trains,35,764,878,495,222,2394,20,208,186,107,62,583,2977
TOTAL (STATES),2003,By Other means (please specify),210,1429,1649,1375,683,5346,194,1083,809,453,282,2821,8167
TOTAL (STATES),2003,Total,1252,21187,24189,15899,6378,68905,1274,17710,12169,6148,2616,39917,108822
TOTAL (STATES),2003,Total (Poison),362,8578,9581,6480,2543,27544,476,6500,4614,2484,925,14999,42543
TOTAL (STATES),2003,Total (Jumping),19,245,299,209,67,839,10,138,130,62,27,367,1206
TOTAL (STATES),2004,By Over Alcoholism,1,170,419,357,87,1034,1,8,16,8,2,35,1069
TOTAL (STATES),2004,By Drowning,232,1244,1457,878,351,4162,156,1148,905,475,344,3028,7190
TOTAL (STATES),2004,By Fire/Self Immolation,61,852,1026,611,191,2741,141,2820,1800,732,286,5779,8520
TOTAL (STATES),2004,By Fire-Arms,4,108,160,62,21,355,4,68,39,20,2,133,488
TOTAL (STATES),2004,By Hanging,305,6897,8540,5413,2059,23214,299,5253,3455,1480,578,11065,34279
TOTAL (STATES),2004,By Consuming Insecticides,190,4840,5352,3411,1320,15113,273,3830,2312,1136,509,8060,23173
TOTAL (STATES),2004,By Consuming Other Poison,194,3630,4117,2862,1169,11972,270,2960,2081,1143,359,6813,18785
TOTAL (STATES),2004,By Self Infliction of injury,3,74,69,50,11,207,1,47,35,9,1,93,300
TOTAL (STATES),2004,By Jumping from (Building),9,81,117,63,22,292,4,48,33,17,4,106,398
TOTAL (STATES),2004,By Jumping from (Other sites),22,143,169,94,32,460,11,50,49,21,5,136,596
TOTAL (STATES),2004,By Jumping off Moving Vehicles/Trains,5,171,190,120,35,521,5,26,38,13,3,85,606
TOTAL (STATES),2004,By Machine,2,30,39,22,3,96,0,3,3,3,0,9,105
TOTAL (STATES),2004,By Overdose of sleeping pills,7,169,184,166,93,619,4,150,123,93,26,396,1015
TOTAL (STATES),2004,By touching electric wires,20,275,305,171,36,807,13,95,88,32,9,237,1044
TOTAL (STATES),2004,By coming under running vehicles/trains,22,661,930,578,270,2461,9,222,217,117,76,641,3102
TOTAL (STATES),2004,By Other means (please specify),370,1783,2303,1959,887,7302,233,1349,1050,725,324,3681,10983
TOTAL (STATES),2004,Total,1447,21128,25377,16817,6587,71356,1424,18077,12244,6024,2528,40297,111653
TOTAL (STATES),2004,Total (Poison),387,8544,9538,6323,2500,27292,544,6837,4428,2288,869,14966,42258
TOTAL (STATES),2004,Total (Jumping),31,224,286,157,54,752,15,98,82,38,9,242,994
TOTAL (STATES),2005,By Over Alcoholism,3,184,395,324,49,955,5,20,32,21,7,85,1040
TOTAL (STATES),2005,By Drowning,216,1234,1564,994,513,4521,166,1326,935,480,313,3220,7741
TOTAL (STATES),2005,By Fire/Self Immolation,65,830,1139,572,217,2823,123,2814,1832,839,363,5971,8794
TOTAL (STATES),2005,By Fire-Arms,64,188,189,116,21,578,9,74,48,19,2,152,730
TOTAL (STATES),2005,By Hanging,277,7162,8829,5573,2053,23894,277,5549,3411,1550,563,11350,35244
TOTAL (STATES),2005,By Consuming Insecticides,176,4469,5027,3454,1311,14437,175,3494,2332,1225,516,7742,22179
TOTAL (STATES),2005,By Consuming Other Poison,177,3749,4122,2903,1095,12046,209,2943,2007,1201,468,6828,18874
TOTAL (STATES),2005,By Self Infliction of injury,1,64,67,39,9,180,4,36,24,7,1,72,252
TOTAL (STATES),2005,By Jumping from (Building),7,106,161,69,28,371,8,54,69,13,10,154,525
TOTAL (STATES),2005,By Jumping from (Other sites),13,101,134,58,24,330,2,36,30,14,5,87,417
TOTAL (STATES),2005,By Jumping off Moving Vehicles/Trains,4,194,223,126,41,588,1,56,62,22,10,151,739
TOTAL (STATES),2005,By Machine,0,26,36,16,1,79,2,1,3,0,0,6,85
TOTAL (STATES),2005,By Overdose of sleeping pills,3,70,137,203,89,502,1,118,90,57,57,323,825
TOTAL (STATES),2005,By touching electric wires,15,260,315,170,34,794,8,92,89,43,18,250,1044
TOTAL (STATES),2005,By coming under running vehicles/trains,22,775,784,568,241,2390,26,240,206,120,53,645,3035
TOTAL (STATES),2005,By Other means (please specify),268,1892,2358,1784,794,7096,192,1117,861,712,300,3182,10278
TOTAL (STATES),2005,Total,1311,21304,25480,16969,6520,71584,1208,17970,12031,6323,2686,40218,111802
TOTAL (STATES),2005,Total (Poison),354,8282,9216,6396,2415,26663,388,6473,4363,2433,985,14642,41305
TOTAL (STATES),2005,Total (Jumping),20,207,295,127,52,701,10,90,99,27,15,241,942
TOTAL (STATES),2006,By Over Alcoholism,4,185,548,355,97,1189,0,10,17,17,7,51,1240
TOTAL (STATES),2006,By Drowning,193,1517,1829,1139,521,5199,195,1326,980,495,364,3360,8559
TOTAL (STATES),2006,By Fire/Self Immolation,37,931,1388,753,240,3349,109,3346,2054,821,338,6668,10017
TOTAL (STATES),2006,By Fire-Arms,2,91,132,50,12,287,3,19,21,10,0,53,340
TOTAL (STATES),2006,By Hanging,249,7339,9381,5690,1970,24629,242,6118,3824,1886,560,12630,37259
TOTAL (STATES),2006,By Consuming Insecticides,191,4607,5592,3539,1370,15299,227,3471,2263,1056,483,7500,22799
TOTAL (STATES),2006,By Consuming Other Poison,157,4006,4263,2707,986,12119,230,2843,1979,1006,315,6373,18492
TOTAL (STATES),2006,By Self Infliction of injury,7,38,52,34,16,147,2,26,24,5,3,60,207
TOTAL (STATES),2006,By Jumping from (Building),4,119,136,59,22,340,4,75,34,17,7,137,477
TOTAL (STATES),2006,By Jumping from (Other sites),11,191,245,123,35,605,3,75,90,55,20,243,848
TOTAL (STATES),2006,By Jumping off Moving Vehicles/Trains,17,218,241,162,35,673,6,82,76,23,13,200,873
TOTAL (STATES),2006,By Machine,1,32,29,25,2,89,0,9,12,5,1,27,116
TOTAL (STATES),2006,By Overdose of sleeping pills,9,82,154,128,134,507,10,98,64,54,40,266,773
TOTAL (STATES),2006,By touching electric wires,14,197,179,75,22,487,5,43,45,11,3,107,594
TOTAL (STATES),2006,By coming under running vehicles/trains,37,835,1093,778,294,3037,22,276,253,160,69,780,3817
TOTAL (STATES),2006,By Other means (please specify),243,1774,1999,1464,767,6247,181,1156,945,591,284,3157,9404
TOTAL (STATES),2006,Total,1176,22162,27261,17081,6523,74203,1239,18973,12681,6212,2507,41612,115815
TOTAL (STATES),2006,Total (Poison),355,8651,9907,6280,2372,27565,459,6340,4266,2067,801,13933,41498
TOTAL (STATES),2006,Total (Jumping),15,310,381,182,57,945,7,150,124,72,27,380,1325
TOTAL (STATES),2007,By Over Alcoholism,0,193,526,432,108,1259,0,49,35,28,11,123,1382
TOTAL (STATES),2007,By Drowning,199,1429,1876,1206,483,5193,212,1188,902,525,302,3129,8322
TOTAL (STATES),2007,By Fire/Self Immolation,52,988,1348,767,233,3388,151,3443,2082,753,381,6810,10198
TOTAL (STATES),2007,By Fire-Arms,2,118,210,146,57,533,5,65,59,26,10,165,698
TOTAL (STATES),2007,By Hanging,273,7939,9241,6051,1969,25473,252,5735,3806,1593,487,11873,37346
TOTAL (STATES),2007,By Consuming Insecticides,167,4647,5647,3739,1620,15820,237,3940,2316,1231,494,8218,24038
TOTAL (STATES),2007,By Consuming Other Poison,131,3630,4196,3004,985,11946,156,2589,2111,1110,369,6335,18281
TOTAL (STATES),2007,By Self Infliction of injury,1,59,73,33,24,190,1,29,31,7,9,77,267
TOTAL (STATES),2007,By Jumping from (Building),11,124,297,135,27,594,16,83,58,66,9,232,826
TOTAL (STATES),2007,By Jumping from (Other sites),7,93,76,73,34,283,7,52,38,16,3,116,399
TOTAL (STATES),2007,By Jumping off Moving Vehicles/Trains,5,141,211,93,50,500,5,54,59,26,12,156,656
TOTAL (STATES),2007,By Machine,0,70,35,15,5,125,0,23,6,5,0,34,159
TOTAL (STATES),2007,By Overdose of sleeping pills,15,111,191,104,50,471,4,158,111,45,27,345,816
TOTAL (STATES),2007,By touching electric wires,32,222,225,102,28,609,4,35,51,23,12,125,734
TOTAL (STATES),2007,By coming under running vehicles/trains,27,1001,1362,862,327,3579,27,326,273,141,60,827,4406
TOTAL (STATES),2007,By Other means (please specify),245,2097,2466,2104,924,7836,191,1412,1135,822,383,3943,11779
TOTAL (STATES),2007,Total,1167,22862,27980,18866,6924,77799,1268,19181,13073,6417,2569,42508,120307
TOTAL (STATES),2007,Total (Poison),299,8336,9916,6776,2629,27956,394,6558,4458,2348,872,14630,42586
TOTAL (STATES),2007,Total (Jumping),18,217,373,208,61,877,23,135,96,82,12,348,1225
TOTAL (STATES),2008,By Over Alcoholism,4,267,584,381,120,1356,0,59,61,26,10,156,1512
TOTAL (STATES),2008,By Drowning,180,1514,1903,1072,515,5184,190,1225,968,470,304,3157,8341
TOTAL (STATES),2008,By Fire/Self Immolation,47,1181,1580,868,252,3928,114,3562,2081,752,357,6866,10794
TOTAL (STATES),2008,By Fire-Arms,3,111,150,59,16,339,3,59,35,16,13,126,465
TOTAL (STATES),2008,By Hanging,287,8412,9877,5839,1969,26384,288,5945,3988,1709,542,12472,38856
TOTAL (STATES),2008,By Consuming Insecticides,157,4832,5709,3682,1302,15682,189,3726,2563,1120,492,8090,23772
TOTAL (STATES),2008,By Consuming Other Poison,116,3803,4313,3028,917,12177,141,3001,2392,1106,355,6995,19172
TOTAL (STATES),2008,By Self Infliction of injury,2,65,79,35,23,204,3,62,26,16,17,124,328
TOTAL (STATES),2008,By Jumping from (Building),5,129,205,96,26,461,4,60,61,30,24,179,640
TOTAL (STATES),2008,By Jumping from (Other sites),9,124,108,83,34,358,11,35,28,22,8,104,462
TOTAL (STATES),2008,By Jumping off Moving Vehicles/Trains,3,126,148,79,18,374,3,58,42,11,6,120,494
TOTAL (STATES),2008,By Machine,0,26,34,26,3,89,0,3,8,15,2,28,117
TOTAL (STATES),2008,By Overdose of sleeping pills,8,74,139,106,49,376,1,113,81,55,30,280,656
TOTAL (STATES),2008,By touching electric wires,27,288,300,169,30,814,5,55,59,39,10,168,982
TOTAL (STATES),2008,By coming under running vehicles/trains,30,804,977,842,262,2915,25,325,261,121,49,781,3696
TOTAL (STATES),2008,By Other means (please specify),268,2111,2939,2212,1042,8572,221,1461,1202,817,342,4043,12615
TOTAL (STATES),2008,Total,1146,23867,29045,18577,6578,79213,1198,19749,13856,6325,2561,43689,122902
TOTAL (STATES),2008,Total (Poison),275,8700,10101,6745,2242,28063,333,6789,4981,2242,864,15209,43272
TOTAL (STATES),2008,Total (Jumping),14,253,313,179,60,819,15,95,89,52,32,283,1102
TOTAL (STATES),2009,By Over Alcoholism,4,283,580,463,131,1461,1,17,41,24,19,102,1563
TOTAL (STATES),2009,By Drowning,263,1473,1650,946,450,4782,157,1030,926,515,312,2940,7722
TOTAL (STATES),2009,By Fire/Self Immolation,37,1123,1613,813,302,3888,128,3625,2439,974,393,7559,11447
TOTAL (STATES),2009,By Fire-Arms,3,129,158,82,25,397,6,68,44,24,5,147,544
TOTAL (STATES),2009,By Hanging,303,8268,9343,6095,2116,26125,308,5910,3860,1761,581,12420,38545
TOTAL (STATES),2009,By Consuming Insecticides,147,4842,6308,4243,1570,17110,228,3880,2680,1403,552,8743,25853
TOTAL (STATES),2009,By Consuming Other Poison,130,3107,3843,2584,771,10435,158,2759,1914,946,342,6119,16554
TOTAL (STATES),2009,By Self Infliction of injury,2,65,75,42,39,223,0,43,32,6,4,85,308
TOTAL (STATES),2009,By Jumping from (Building),18,142,228,120,61,569,21,87,76,35,20,239,808
TOTAL (STATES),2009,By Jumping from (Other sites),14,162,288,112,66,642,7,186,109,52,16,370,1012
TOTAL (STATES),2009,By Jumping off Moving Vehicles/Trains,16,178,360,162,27,743,7,76,83,29,13,208,951
TOTAL (STATES),2009,By Machine,1,23,58,49,3,134,0,7,4,4,1,16,150
TOTAL (STATES),2009,By Overdose of sleeping pills,2,112,130,86,46,376,6,86,90,41,19,242,618
TOTAL (STATES),2009,By touching electric wires,40,275,286,192,41,834,16,72,65,64,12,229,1063
TOTAL (STATES),2009,By coming under running vehicles/trains,31,765,1034,642,238,2710,19,363,262,166,96,906,3616
TOTAL (STATES),2009,By Other means (please specify),472,2186,2911,2710,1329,9608,356,1450,1325,896,481,4508,14116
TOTAL (STATES),2009,Total,1483,23133,28865,19341,7215,80037,1418,19659,13950,6940,2866,44833,124870
TOTAL (STATES),2009,Total (Poison),279,8014,10226,6869,2380,27768,386,6682,4626,2355,898,14947,42715
TOTAL (STATES),2009,Total (Jumping),32,304,516,232,127,1211,28,273,185,87,36,609,1820
TOTAL (STATES),2010,By Over Alcoholism,1,307,503,385,123,1319,0,75,19,41,21,156,1475
TOTAL (STATES),2010,By Drowning,287,1561,1624,1118,522,5112,159,1248,911,552,382,3252,8364
TOTAL (STATES),2010,By Fire/Self Immolation,75,1249,1671,787,288,4070,174,3726,2336,915,472,7623,11693
TOTAL (STATES),2010,By Fire-Arms,1,148,145,73,32,399,23,139,64,18,8,252,651
TOTAL (STATES),2010,By Hanging,360,8799,10087,6493,2218,27957,293,6237,3882,1725,615,12752,40709
TOTAL (STATES),2010,By Consuming Insecticides,222,5171,5885,4114,1305,16697,262,3930,2582,1157,483,8414,25111
TOTAL (STATES),2010,By Consuming Other Poison,117,3520,4146,3212,1332,12327,139,2759,2164,1171,481,6714,19041
TOTAL (STATES),2010,By Self Infliction of injury,12,224,218,123,42,619,9,97,66,25,13,210,829
TOTAL (STATES),2010,By Jumping from (Building),15,181,232,113,48,589,8,86,67,29,10,200,789
TOTAL (STATES),2010,By Jumping from (Other sites),13,198,203,122,34,570,10,85,90,65,33,283,853
TOTAL (STATES),2010,By Jumping off Moving Vehicles/Trains,9,173,204,118,63,567,9,76,47,21,10,163,730
TOTAL (STATES),2010,By Machine,1,47,66,24,4,142,3,15,10,5,2,35,177
TOTAL (STATES),2010,By Overdose of sleeping pills,5,119,121,83,26,354,1,96,76,41,15,229,583
TOTAL (STATES),2010,By touching electric wires,30,289,301,190,48,858,10,95,80,76,23,284,1142
TOTAL (STATES),2010,By coming under running vehicles/trains,29,988,1160,800,329,3306,21,325,283,196,67,892,4198
TOTAL (STATES),2010,By Other means (please specify),438,2839,3335,2758,1431,10801,340,1706,1505,1028,501,5080,15881
TOTAL (STATES),2010,Total,1615,25813,29901,20513,7845,85687,1461,20695,14182,7065,3136,46539,132226
TOTAL (STATES),2010,Total (Poison),351,8915,10249,7449,2679,29643,410,6786,4812,2353,977,15338,44981
TOTAL (STATES),2010,Total (Jumping),28,379,435,235,82,1159,18,171,157,94,43,483,1642
TOTAL (STATES),2011,By Over Alcoholism,3,222,537,399,144,1305,1,15,21,19,9,65,1370
TOTAL (STATES),2011,By Drowning,226,1499,1652,1052,553,4982,157,1295,841,470,286,3049,8031
TOTAL (STATES),2011,By Fire/Self Immolation,67,1323,1592,922,292,4196,159,3669,2309,897,454,7488,11684
TOTAL (STATES),2011,By Fire-Arms,1,102,124,54,19,300,2,49,22,6,0,79,379
TOTAL (STATES),2011,By Hanging,284,9138,10723,7062,2242,29449,315,6662,4270,1861,691,13799,43248
TOTAL (STATES),2011,By Consuming Insecticides,170,4621,4965,3298,1394,14448,209,3572,2096,1018,374,7269,21717
TOTAL (STATES),2011,By Consuming Other Poison,158,3894,4810,3267,1355,13484,198,3291,2643,1226,412,7770,21254
TOTAL (STATES),2011,By Self Infliction of injury,2,108,104,59,45,318,3,51,40,32,23,149,467
TOTAL (STATES),2011,By Jumping from (Building),9,135,159,92,36,431,13,95,69,37,9,223,654
TOTAL (STATES),2011,By Jumping from (Other sites),14,128,142,67,30,381,26,88,59,43,18,234,615
TOTAL (STATES),2011,By Jumping off Moving Vehicles/Trains,6,145,144,121,62,478,8,74,54,19,13,168,646
TOTAL (STATES),2011,By Machine,3,30,43,24,8,108,1,9,7,5,2,24,132
TOTAL (STATES),2011,By Overdose of sleeping pills,1,106,95,72,41,315,7,108,81,37,16,249,564
TOTAL (STATES),2011,By touching electric wires,24,217,208,99,43,591,7,61,41,24,8,141,732
TOTAL (STATES),2011,By coming under running vehicles/trains,16,988,1587,905,338,3834,5,390,398,145,72,1010,4844
TOTAL (STATES),2011,By Other means (please specify),568,3151,3936,2719,1071,11445,320,1476,1664,1122,611,5193,16638
TOTAL (STATES),2011,Total,1552,25807,30821,20212,7673,86065,1431,20905,14615,6961,2998,46910,132975
TOTAL (STATES),2011,Total (Poison),330,8623,9879,6624,2794,28250,410,6914,4779,2276,809,15188,43438
TOTAL (STATES),2011,Total (Jumping),23,263,301,159,66,812,39,183,128,80,27,457,1269
TOTAL (STATES),2012,By Over Alcoholism,6,233,550,418,176,1383,13,26,28,19,21,107,1490
TOTAL (STATES),2012,By Drowning,245,1453,1638,1105,535,4976,143,1107,876,460,294,2880,7856
TOTAL (STATES),2012,By Fire/Self Immolation,61,1160,1683,847,315,4066,150,3367,2291,929,499,7236,11302
TOTAL (STATES),2012,By Fire-Arms,0,122,116,70,24,332,2,60,18,8,7,95,427
TOTAL (STATES),2012,By Hanging,359,10421,11849,7931,2718,33278,361,7225,4473,2072,672,14803,48081
TOTAL (STATES),2012,By Consuming Insecticides,110,3999,4540,3254,1229,13132,174,3159,1992,1024,408,6757,19889
TOTAL (STATES),2012,By Consuming Other Poison,133,3251,4350,3073,1299,12106,192,2923,2221,1257,440,7033,19139
TOTAL (STATES),2012,By Self Infliction of injury,2,120,145,61,22,350,7,96,87,30,4,224,574
TOTAL (STATES),2012,By Jumping from (Building),8,124,132,89,39,392,8,75,42,17,13,155,547
TOTAL (STATES),2012,By Jumping from (Other sites),15,142,210,105,43,515,7,88,75,24,15,209,724
TOTAL (STATES),2012,By Jumping off Moving Vehicles/Trains,8,137,166,84,46,441,8,82,51,20,8,169,610
TOTAL (STATES),2012,By Machine,4,19,38,14,7,82,0,6,3,1,0,10,92
TOTAL (STATES),2012,By Overdose of sleeping pills,5,96,147,104,29,381,9,106,84,48,25,272,653
TOTAL (STATES),2012,By touching electric wires,26,251,267,179,48,771,4,54,50,20,21,149,920
TOTAL (STATES),2012,By coming under running vehicles/trains,11,1121,1213,846,345,3536,16,280,220,133,53,702,4238
TOTAL (STATES),2012,By Other means (please specify),329,2502,4020,2758,1263,10872,253,1484,1705,1154,657,5253,16125
TOTAL (STATES),2012,Total,1322,25151,31064,20938,8138,86613,1347,20138,14216,7216,3137,46054,132667
TOTAL (STATES),2012,Total (Poison),245,7370,9035,6388,2550,25588,373,6178,4300,2311,852,14014,39602
TOTAL (STATES),2012,Total (Jumping),23,266,342,194,82,907,15,163,117,41,28,364,1271
A & N ISLANDS,2001,By Over Alcoholism,0,0,0,0,0,0,0,0,0,0,0,0,0
A & N ISLANDS,2001,By Drowning,0,0,1,1,0,2,0,0,1,0,0,1,3
A & N ISLANDS,2001,By Fire/Self Immolation,0,1,0,0,0,1,0,2,1,1,0,4,5
A & N ISLANDS,2001,By Fire-Arms,0,0,0,0,0,0,0,0,0,0,0,0,0
A & N ISLANDS,2001,By Hanging,2,20,22,17,8,69,2,20,7,4,3,36,105
A & N ISLANDS,2001,By Consuming Insecticides,0,0,0,0,0,0,0,0,0,0,0,0,0
A & N ISLANDS,2001,By Consuming Other Poison,0,4,0,3,0,7,0,9,0,0,0,9,16
A & N ISLANDS,2001,By Self Infliction of injury,0,0,0,0,0,0,0,0,0,0,0,0,0
A & N ISLANDS,2001,By Jumping from (Building),0,0,0,0,0,0,0,0,0,0,0,0,0
A & N ISLANDS,2001,By Jumping from (Other sites),0,0,0,0,0,0,0,0,0,0,0,0,0
A & N ISLANDS,2001,By Jumping off Moving Vehicles/Trains,0,0,0,0,0,0,0,0,0,0,0,0,0
A & N ISLANDS,2001,By Machine,0,0,0,0,0,0,0,0,0,0,0,0,0
A & N ISLANDS,2001,By Overdose of sleeping pills,0,0,0,0,0,0,0,0,0,0,0,0,0
A & N ISLANDS,2001,By touching electric wires,0,0,0,0,0,0,0,0,0,0,0,0,0
A & N ISLANDS,2001,By coming under running vehicles/trains,0,0,0,0,0,0,0,0,0,0,0,0,0
A & N ISLANDS,2001,By Other means (please specify),0,0,0,0,0,0,0,0,0,0,0,0,0
A & N ISLANDS,2001,Total,2,25,23,21,8,79,2,31,9,5,3,50,129
A & N ISLANDS,2001,Total (Poison),0,4,0,3,0,7,0,9,0,0,0,9,16
A & N ISLANDS,2001,Total (Jumping),0,0,0,0,0,0,0,0,0,0,0,0,0
A & N ISLANDS,2002,By Over Alcoholism,0,0,0,0,0,0,0,0,0,0,0,0,0
A & N ISLANDS,2002,By Drowning,0,0,1,1,0,2,0,0,0,0,0,0,2
A & N ISLANDS,2002,By Fire/Self Immolation,0,0,0,0,1,1,0,4,2,1,1,8,9
A & N ISLANDS,2002,By Fire-Arms,0,0,0,0,0,0,0,0,0,0,0,0,0
A & N ISLANDS,2002,By Hanging,2,23,23,17,12,77,2,20,8,4,1,35,112
A & N ISLANDS,2002,By Consuming Insecticides,0,0,0,0,0,0,0,0,0,0,0,0,0
A & N ISLANDS,2002,By Consuming Other Poison,0,4,4,3,0,11,0,4,4,1,1,10,21
A & N ISLANDS,2002,By Self Infliction of injury,0,0,0,0,0,0,0,0,0,0,0,0,0
A & N ISLANDS,2002,By Jumping from (Building),0,0,0,0,0,0,0,0,0,0,0,0,0
A & N ISLANDS,2002,By Jumping from (Other sites),0,0,0,0,0,0,0,0,0,0,0,0,0
A & N ISLANDS,2002,By Jumping off Moving Vehicles/Trains,0,0,0,0,0,0,0,0,0,0,0,0,0
A & N ISLANDS,2002,By Machine,0,0,0,0,0,0,0,0,0,0,0,0,0
A & N ISLANDS,2002,By Overdose of sleeping pills,0,0,0,0,0,0,0,0,0,0,0,0,0
A & N ISLANDS,2002,By touching electric wires,0,0,0,0,0,0,0,0,0,0,0,0,0
A & N ISLANDS,2002,By coming under running vehicles/trains,0,0,0,0,0,0,0,0,0,0,0,0,0
A & N ISLANDS,2002,By Other means,0,0,0,0,0,0,0,0,0,0,0,0,0
A & N ISLANDS,2002,Total,2,27,28,21,13,91,2,28,14,6,3,53,144
A & N ISLANDS,2002,Total (Poison),0,4,4,3,0,11,0,4,4,1,1,10,21
A & N ISLANDS,2002,Total (Jumping),0,0,0,0,0,0,0,0,0,0,0,0,0
A & N ISLANDS,2003,By Over Alcoholism,0,0,0,0,0,0,0,0,0,0,0,0,0
A & N ISLANDS,2003,By Drowning,0,0,0,0,1,1,0,0,0,0,0,0,1
A & N ISLANDS,2003,By Fire/Self Immolation,0,0,0,0,0,0,0,0,0,0,0,0,0
A & N ISLANDS,2003,By Fire-Arms,0,0,0,0,0,0,0,0,0,0,0,0,0
A & N ISLANDS,2003,By Hanging,1,22,23,15,5,66,4,20,5,1,1,31,97
A & N ISLANDS,2003,By Consuming Insecticides,0,1,0,1,0,2,0,5,3,0,0,8,10
A & N ISLANDS,2003,By Consuming Other Poison,0,0,0,0,0,0,0,0,0,0,0,0,0
A & N ISLANDS,2003,By Self Infliction of injury,0,0,0,0,0,0,0,0,0,0,0,0,0
A & N ISLANDS,2003,By Jumping from (Building),0,0,0,0,0,0,0,0,0,0,0,0,0
A & N ISLANDS,2003,By Jumping from (Other sites),0,0,0,0,0,0,0,0,0,0,0,0,0
A & N ISLANDS,2003,By Jumping off Moving Vehicles/Trains,0,0,0,0,0,0,0,0,0,0,0,0,0
A & N ISLANDS,2003,By Machine,0,0,0,0,0,0,0,0,0,0,0,0,0
A & N ISLANDS,2003,By Overdose of sleeping pills,0,0,0,0,0,0,0,0,0,0,0,0,0
A & N ISLANDS,2003,By touching electric wires,0,0,0,0,0,0,0,0,0,0,0,0,0
A & N ISLANDS,2003,By coming under running vehicles/trains,0,0,0,0,0,0,0,0,0,0,0,0,0
A & N ISLANDS,2003,By Other means (please specify),0,0,0,1,0,1,0,3,0,1,0,4,5
A & N ISLANDS,2003,Total,1,23,23,17,6,70,4,28,8,2,1,43,113
A & N ISLANDS,2003,Total (Poison),0,1,0,1,0,2,0,5,3,0,0,8,10
A & N ISLANDS,2003,Total (Jumping),0,0,0,0,0,0,0,0,0,0,0,0,0
A & N ISLANDS,2004,By Over Alcoholism,0,0,0,0,0,0,0,0,0,0,0,0,0
A & N ISLANDS,2004,By Drowning,0,0,0,1,0,1,0,0,0,0,0,0,1
A & N ISLANDS,2004,By Fire/Self Immolation,0,0,0,0,0,0,0,1,2,0,0,3,3
A & N ISLANDS,2004,By Fire-Arms,0,0,0,0,0,0,0,0,0,0,0,0,0
A & N ISLANDS,2004,By Hanging,0,30,22,12,9,73,1,17,11,2,1,32,105
A & N ISLANDS,2004,By Consuming Insecticides,0,0,0,0,0,0,0,0,0,0,0,0,0
A & N ISLANDS,2004,By Consuming Other Poison,0,3,1,1,0,5,0,5,0,1,0,6,11
A & N ISLANDS,2004,By Self Infliction of injury,0,0,0,0,0,0,0,0,0,0,0,0,0
A & N ISLANDS,2004,By Jumping from (Building),0,0,0,0,0,0,0,0,0,0,0,0,0
A & N ISLANDS,2004,By Jumping from (Other sites),0,0,0,0,0,0,0,0,0,0,0,0,0
A & N ISLANDS,2004,By Jumping off Moving Vehicles/Trains,0,0,0,0,0,0,0,0,0,0,0,0,0
A & N ISLANDS,2004,By Machine,0,0,0,0,0,0,0,0,0,0,0,0,0
A & N ISLANDS,2004,By Overdose of sleeping pills,0,0,0,0,0,0,0,0,0,0,0,0,0
A & N ISLANDS,2004,By touching electric wires,0,1,1,0,0,2,0,0,0,0,0,0,2
A & N ISLANDS,2004,By coming under running vehicles/trains,0,0,0,0,0,0,0,0,0,0,0,0,0
A & N ISLANDS,2004,By Other means (please specify),0,0,0,0,0,0,0,0,0,0,0,0,0
A & N ISLANDS,2004,Total,0,34,24,14,9,81,1,23,13,3,1,41,122
A & N ISLANDS,2004,Total (Poison),0,3,1,1,0,5,0,5,0,1,0,6,11
A & N ISLANDS,2004,Total (Jumping),0,0,0,0,0,0,0,0,0,0,0,0,0
A & N ISLANDS,2005,By Over Alcoholism,0,0,0,0,0,0,0,0,0,0,0,0,0
A & N ISLANDS,2005,By Drowning,0,0,0,0,0,0,0,0,1,0,0,1,1
A & N ISLANDS,2005,By Fire/Self Immolation,0,0,1,1,0,2,0,2,1,0,0,3,5
A & N ISLANDS,2005,By Fire-Arms,0,0,0,0,0,0,0,0,0,0,0,0,0
A & N ISLANDS,2005,By Hanging,4,13,21,23,17,78,3,20,3,7,3,36,114
A & N ISLANDS,2005,By Consuming Insecticides,1,2,2,1,0,6,0,5,3,3,2,13,19
A & N ISLANDS,2005,By Consuming Other Poison,0,0,0,0,0,0,0,0,0,0,0,0,0
A & N ISLANDS,2005,By Self Infliction of injury,0,0,0,0,0,0,0,0,0,0,0,0,0
A & N ISLANDS,2005,By Jumping from (Building),0,0,0,0,0,0,0,0,0,0,0,0,0
A & N ISLANDS,2005,By Jumping from (Other sites),0,0,0,0,0,0,0,0,0,0,0,0,0
A & N ISLANDS,2005,By Jumping off Moving Vehicles/Trains,0,0,0,0,0,0,0,0,0,0,0,0,0
A & N ISLANDS,2005,By Machine,0,0,0,0,0,0,0,0,0,0,0,0,0
A & N ISLANDS,2005,By Overdose of sleeping pills,0,0,0,0,0,0,0,0,0,0,0,0,0
A & N ISLANDS,2005,By touching electric wires,0,0,0,0,0,0,0,0,0,0,0,0,0
A & N ISLANDS,2005,By coming under running vehicles/trains,0,0,0,0,0,0,0,0,0,0,0,0,0
A & N ISLANDS,2005,By Other means (please specify),0,0,0,0,0,0,0,0,0,0,0,0,0
A & N ISLANDS,2005,Total,5,15,24,25,17,86,3,27,8,10,5,53,139
A & N ISLANDS,2005,Total (Poison),1,2,2,1,0,6,0,5,3,3,2,13,19
A & N ISLANDS,2005,Total (Jumping),0,0,0,0,0,0,0,0,0,0,0,0,0
A & N ISLANDS,2006,By Over Alcoholism,0,0,0,0,0,0,0,0,0,0,0,0,0
A & N ISLANDS,2006,By Drowning,2,0,1,0,0,3,0,1,0,0,0,1,4
A & N ISLANDS,2006,By Fire/Self Immolation,0,0,2,0,2,4,0,1,1,0,0,2,6
A & N ISLANDS,2006,By Fire-Arms,0,0,0,0,0,0,0,0,0,0,0,0,0
A & N ISLANDS,2006,By Hanging,1,19,28,23,10,81,0,15,7,2,2,26,107
A & N ISLANDS,2006,By Consuming Insecticides,0,0,0,0,0,0,0,0,0,0,0,0,0
A & N ISLANDS,2006,By Consuming Other Poison,1,2,3,2,0,8,1,4,2,1,0,8,16
A & N ISLANDS,2006,By Self Infliction of injury,0,0,0,0,0,0,0,0,0,0,0,0,0
A & N ISLANDS,2006,By Jumping from (Building),0,0,0,0,0,0,0,0,0,0,0,0,0
A & N ISLANDS,2006,By Jumping from (Other sites),0,0,0,0,0,0,0,0,0,0,0,0,0
A & N ISLANDS,2006,By Jumping off Moving Vehicles/Trains,0,0,0,0,0,0,0,0,0,0,0,0,0
A & N ISLANDS,2006,By Machine,0,0,0,0,0,0,0,0,0,0,0,0,0
A & N ISLANDS,2006,By Overdose of sleeping pills,0,0,0,0,0,0,0,0,0,0,0,0,0
A & N ISLANDS,2006,By touching electric wires,0,0,0,0,0,0,0,0,0,0,0,0,0
A & N ISLANDS,2006,By coming under running vehicles/trains,0,0,0,0,0,0,0,0,0,0,0,0,0
A & N ISLANDS,2006,By Other means (please specify),0,0,0,0,0,0,0,0,0,0,0,0,0
A & N ISLANDS,2006,Total,4,21,34,25,12,96,1,21,10,3,2,37,133
A & N ISLANDS,2006,Total (Poison),1,2,3,2,0,8,1,4,2,1,0,8,16
A & N ISLANDS,2006,Total (Jumping),0,0,0,0,0,0,0,0,0,0,0,0,0
A & N ISLANDS,2007,By Over Alcoholism,0,0,0,0,0,0,0,0,0,0,0,0,0
A & N ISLANDS,2007,By Drowning,0,0,3,0,0,3,0,1,1,0,0,2,5
A & N ISLANDS,2007,By Fire/Self Immolation,0,0,1,0,0,1,1,1,0,0,0,2,3
A & N ISLANDS,2007,By Fire-Arms,0,0,0,0,0,0,0,0,0,0,0,0,0
A & N ISLANDS,2007,By Hanging,0,32,20,23,8,83,4,25,7,8,2,46,129
A & N ISLANDS,2007,By Consuming Insecticides,0,0,0,0,0,0,0,0,0,0,0,0,0
A & N ISLANDS,2007,By Consuming Other Poison,0,4,2,4,3,13,1,3,2,0,0,6,19
A & N ISLANDS,2007,By Self Infliction of injury,0,0,0,0,0,0,0,0,0,0,0,0,0
A & N ISLANDS,2007,By Jumping from (Building),0,0,0,0,0,0,0,0,0,0,0,0,0
A & N ISLANDS,2007,By Jumping from (Other sites),0,0,0,0,0,0,0,0,0,0,0,0,0
A & N ISLANDS,2007,By Jumping off Moving Vehicles/Trains,0,0,0,0,0,0,0,0,0,0,0,0,0
A & N ISLANDS,2007,By Machine,0,0,0,0,0,0,0,0,0,0,0,0,0
A & N ISLANDS,2007,By Overdose of sleeping pills,0,0,0,0,0,0,0,0,0,0,0,0,0
A & N ISLANDS,2007,By touching electric wires,0,0,0,0,0,0,0,0,0,0,0,0,0
A & N ISLANDS,2007,By coming under running vehicles/trains,0,0,0,0,0,0,0,0,0,0,0,0,0
A & N ISLANDS,2007,By Other means (please specify),0,0,0,0,0,0,0,0,0,0,0,0,0
A & N ISLANDS,2007,Total,0,36,26,27,11,100,6,30,10,8,2,56,156
A & N ISLANDS,2007,Total (Poison),0,4,2,4,3,13,1,3,2,0,0,6,19
A & N ISLANDS,2007,Total (Jumping),0,0,0,0,0,0,0,0,0,0,0,0,0
A & N ISLANDS,2008,By Over Alcoholism,0,0,0,0,0,0,0,0,0,0,0,0,0
A & N ISLANDS,2008,By Drowning,0,0,0,0,0,0,0,0,0,0,0,0,0
A & N ISLANDS,2008,By Fire/Self Immolation,0,0,1,0,0,1,0,2,1,0,0,3,4
A & N ISLANDS,2008,By Fire-Arms,0,0,0,0,0,0,0,0,0,0,0,0,0
A & N ISLANDS,2008,By Hanging,0,27,27,17,12,83,0,18,11,5,3,37,120
A & N ISLANDS,2008,By Consuming Insecticides,0,0,0,0,0,0,0,0,0,0,0,0,0
A & N ISLANDS,2008,By Consuming Other Poison,0,4,4,4,2,14,0,3,1,0,1,5,19
A & N ISLANDS,2008,By Self Infliction of injury,0,0,0,0,0,0,0,0,0,0,0,0,0
A & N ISLANDS,2008,By Jumping from (Building),0,0,0,0,0,0,0,0,0,0,0,0,0
A & N ISLANDS,2008,By Jumping from (Other sites),0,0,0,0,0,0,0,0,0,0,0,0,0
A & N ISLANDS,2008,By Jumping off Moving Vehicles/Trains,0,0,0,0,0,0,0,0,0,0,0,0,0
A & N ISLANDS,2008,By Machine,0,0,0,0,0,0,0,0,0,0,0,0,0
A & N ISLANDS,2008,By Overdose of sleeping pills,0,0,0,0,0,0,0,0,0,0,0,0,0
A & N ISLANDS,2008,By touching electric wires,0,0,0,0,0,0,0,0,0,0,0,0,0
A & N ISLANDS,2008,By coming under running vehicles/trains,0,0,0,0,0,0,0,0,0,0,0,0,0
A & N ISLANDS,2008,By Other means (please specify),0,0,0,0,0,0,0,0,0,0,0,0,0
A & N ISLANDS,2008,Total,0,31,32,21,14,98,0,23,13,5,4,45,143
A & N ISLANDS,2008,Total (Poison),0,4,4,4,2,14,0,3,1,0,1,5,19
A & N ISLANDS,2008,Total (Jumping),0,0,0,0,0,0,0,0,0,0,0,0,0
A & N ISLANDS,2009,By Over Alcoholism,0,0,0,0,0,0,0,0,0,0,0,0,0
A & N ISLANDS,2009,By Drowning,0,0,1,0,0,1,0,0,1,0,0,1,2
A & N ISLANDS,2009,By Fire/Self Immolation,0,0,0,1,0,1,0,2,2,1,0,5,6
A & N ISLANDS,2009,By Fire-Arms,0,0,0,0,0,0,0,0,0,0,0,0,0
A & N ISLANDS,2009,By Hanging,1,26,20,21,5,73,6,14,10,2,1,33,106
A & N ISLANDS,2009,By Consuming Insecticides,0,1,1,0,0,2,0,0,0,0,0,0,2
A & N ISLANDS,2009,By Consuming Other Poison,0,4,1,3,1,9,1,3,1,1,0,6,15
A & N ISLANDS,2009,By Self Infliction of injury,0,0,0,0,0,0,0,0,0,0,0,0,0
A & N ISLANDS,2009,By Jumping from (Building),0,0,0,0,0,0,0,0,0,0,0,0,0
A & N ISLANDS,2009,By Jumping from (Other sites),0,0,0,0,0,0,0,0,0,0,0,0,0
A & N ISLANDS,2009,By Jumping off Moving Vehicles/Trains,0,0,0,0,0,0,0,0,0,0,0,0,0
A & N ISLANDS,2009,By Machine,0,0,0,0,0,0,0,0,0,0,0,0,0
A & N ISLANDS,2009,By Overdose of sleeping pills,0,0,0,0,0,0,0,0,0,0,0,0,0
A & N ISLANDS,2009,By touching electric wires,0,0,0,0,0,0,0,0,0,0,0,0,0
A & N ISLANDS,2009,By coming under running vehicles/trains,0,0,0,0,0,0,0,0,0,0,0,0,0
A & N ISLANDS,2009,By Other means (please specify),0,0,0,0,0,0,0,0,0,0,0,0,0
A & N ISLANDS,2009,Total,1,31,23,25,6,86,7,19,14,4,1,45,131
A & N ISLANDS,2009,Total (Poison),0,5,2,3,1,11,1,3,1,1,0,6,17
A & N ISLANDS,2009,Total (Jumping),0,0,0,0,0,0,0,0,0,0,0,0,0
A & N ISLANDS,2010,By Over Alcoholism,0,0,0,0,0,0,0,0,0,0,0,0,0
A & N ISLANDS,2010,By Drowning,0,1,0,0,1,2,0,0,0,0,0,0,2
A & N ISLANDS,2010,By Fire/Self Immolation,0,0,1,0,1,2,0,2,1,0,0,3,5
A & N ISLANDS,2010,By Fire-Arms,0,0,0,0,0,0,0,0,0,0,0,0,0
A & N ISLANDS,2010,By Hanging,3,35,28,15,14,95,0,19,8,2,2,31,126
A & N ISLANDS,2010,By Consuming Insecticides,1,3,3,3,2,12,0,6,2,0,1,9,21
A & N ISLANDS,2010,By Consuming Other Poison,0,0,1,0,0,1,0,1,0,0,0,1,2
A & N ISLANDS,2010,By Self Infliction of injury,0,0,0,0,0,0,0,0,0,0,0,0,0
A & N ISLANDS,2010,By Jumping from (Building),0,0,0,0,0,0,0,0,0,0,0,0,0
A & N ISLANDS,2010,By Jumping from (Other sites),0,0,0,0,0,0,0,0,0,0,0,0,0
A & N ISLANDS,2010,By Jumping off Moving Vehicles/Trains,0,0,0,0,0,0,0,0,0,0,0,0,0
A & N ISLANDS,2010,By Machine,0,0,0,0,0,0,0,0,0,0,0,0,0
A & N ISLANDS,2010,By Overdose of sleeping pills,0,0,0,0,0,0,0,0,0,0,0,0,0
A & N ISLANDS,2010,By touching electric wires,0,0,0,0,0,0,0,0,0,0,0,0,0
A & N ISLANDS,2010,By coming under running vehicles/trains,0,0,0,0,0,0,0,0,0,0,0,0,0
A & N ISLANDS,2010,By Other means (please specify),0,0,0,0,0,0,0,0,0,0,0,0,0
A & N ISLANDS,2010,Total,4,39,33,18,18,112,0,28,11,2,3,44,156
A & N ISLANDS,2010,Total (Poison),1,3,4,3,2,13,0,7,2,0,1,10,23
A & N ISLANDS,2010,Total (Jumping),0,0,0,0,0,0,0,0,0,0,0,0,0
A & N ISLANDS,2011,By Over Alcoholism,0,0,0,0,0,0,0,0,0,0,0,0,0
A & N ISLANDS,2011,By Drowning,0,0,1,0,0,1,0,0,0,0,0,0,1
A & N ISLANDS,2011,By Fire/Self Immolation,0,1,0,0,0,1,1,1,1,1,0,4,5
A & N ISLANDS,2011,By Fire-Arms,0,1,0,0,0,1,0,0,0,0,0,0,1
A & N ISLANDS,2011,By Hanging,1,25,30,16,7,79,2,15,8,2,1,28,107
A & N ISLANDS,2011,By Consuming Insecticides,0,0,1,1,2,4,0,2,1,0,1,4,8
A & N ISLANDS,2011,By Consuming Other Poison,0,0,2,0,1,3,0,1,1,1,0,3,6
A & N ISLANDS,2011,By Self Infliction of injury,0,0,0,0,0,0,0,0,0,0,0,0,0
A & N ISLANDS,2011,By Jumping from (Building),0,0,0,0,0,0,0,0,0,0,0,0,0
A & N ISLANDS,2011,By Jumping from (Other sites),0,0,0,0,0,0,0,0,0,0,0,0,0
A & N ISLANDS,2011,By Jumping off Moving Vehicles/Trains,0,0,0,0,0,0,0,0,0,0,0,0,0
A & N ISLANDS,2011,By Machine,0,0,0,0,0,0,0,0,0,0,0,0,0
A & N ISLANDS,2011,By Overdose of sleeping pills,0,0,0,0,0,0,0,0,0,0,0,0,0
A & N ISLANDS,2011,By touching electric wires,0,0,0,0,0,0,0,0,0,0,0,0,0
A & N ISLANDS,2011,By coming under running vehicles/trains,0,0,0,0,0,0,0,0,0,0,0,0,0
A & N ISLANDS,2011,By Other means (please specify),0,1,1,3,0,5,1,0,0,2,0,3,8
A & N ISLANDS,2011,Total,1,28,35,20,10,94,4,19,11,6,2,42,136
A & N ISLANDS,2011,Total (Poison),0,0,3,1,3,7,0,3,2,1,1,7,14
A & N ISLANDS,2011,Total (Jumping),0,0,0,0,0,0,0,0,0,0,0,0,0
A & N ISLANDS,2012,By Over Alcoholism,0,0,0,0,0,0,0,0,0,0,0,0,0
A & N ISLANDS,2012,By Drowning,0,0,0,0,0,0,0,2,0,0,0,2,2
A & N ISLANDS,2012,By Fire/Self Immolation,0,0,0,1,0,1,0,2,2,0,1,5,6
A & N ISLANDS,2012,By Fire-Arms,0,0,0,0,0,0,0,0,0,0,0,0,0
A & N ISLANDS,2012,By Hanging,2,20,25,17,8,72,1,17,8,3,3,32,104
A & N ISLANDS,2012,By Consuming Insecticides,0,0,0,2,1,3,0,0,0,0,0,0,3
A & N ISLANDS,2012,By Consuming Other Poison,0,2,1,0,1,4,0,0,1,0,0,1,5
A & N ISLANDS,2012,By Self Infliction of injury,0,0,0,0,0,0,0,0,0,0,0,0,0
A & N ISLANDS,2012,By Jumping from (Building),0,0,0,0,0,0,0,0,0,0,0,0,0
A & N ISLANDS,2012,By Jumping from (Other sites),0,0,0,0,0,0,0,0,0,0,0,0,0
A & N ISLANDS,2012,By Jumping off Moving Vehicles/Trains,0,0,0,0,0,0,0,0,0,0,0,0,0
A & N ISLANDS,2012,By Machine,0,0,0,0,0,0,0,0,0,0,0,0,0
A & N ISLANDS,2012,By Overdose of sleeping pills,0,0,0,0,0,0,0,0,1,0,0,1,1
A & N ISLANDS,2012,By touching electric wires,0,0,0,0,0,0,0,0,0,0,0,0,0
A & N ISLANDS,2012,By coming under running vehicles/trains,0,0,0,0,0,0,0,0,0,0,0,0,0
A & N ISLANDS,2012,By Other means (please specify),0,0,0,0,0,0,0,0,0,0,0,0,0
A & N ISLANDS,2012,Total,2,22,26,20,10,80,1,21,12,3,4,41,121
A & N ISLANDS,2012,Total (Poison),0,2,1,2,2,7,0,0,1,0,0,1,8
A & N ISLANDS,2012,Total (Jumping),0,0,0,0,0,0,0,0,0,0,0,0,0
CHANDIGARH,2001,By Over Alcoholism,0,0,0,0,0,0,0,0,0,0,0,0,0
CHANDIGARH,2001,By Drowning,0,2,0,0,0,2,0,1,0,0,0,1,3
CHANDIGARH,2001,By Fire/Self Immolation,0,2,4,0,0,6,0,5,6,1,0,12,18
CHANDIGARH,2001,By Fire-Arms,0,0,0,0,0,0,0,0,0,0,0,0,0
CHANDIGARH,2001,By Hanging,0,14,8,0,1,23,0,5,2,0,0,7,30
CHANDIGARH,2001,By Consuming Insecticides,0,0,0,0,0,0,0,0,0,0,0,0,0
CHANDIGARH,2001,By Consuming Other Poison,0,2,0,0,0,2,0,6,1,0,0,7,9
CHANDIGARH,2001,By Self Infliction of injury,0,0,0,0,0,0,0,0,0,0,0,0,0
CHANDIGARH,2001,By Jumping from (Building),0,0,0,1,0,1,0,0,1,0,0,1,2
CHANDIGARH,2001,By Jumping from (Other sites),0,0,0,0,0,0,0,0,0,0,0,0,0
CHANDIGARH,2001,By Jumping off Moving Vehicles/Trains,0,0,0,0,0,0,0,0,0,0,0,0,0
CHANDIGARH,2001,By Machine,0,0,0,0,0,0,0,0,0,0,0,0,0
CHANDIGARH,2001,By Overdose of sleeping pills,0,0,0,1,0,1,0,0,0,0,0,0,1
CHANDIGARH,2001,By touching electric wires,0,0,0,0,0,0,0,0,0,0,0,0,0
CHANDIGARH,2001,By coming under running vehicles/trains,0,0,0,0,0,0,0,0,0,0,0,0,0
CHANDIGARH,2001,By Other means (please specify),0,0,3,0,1,4,0,1,1,1,0,3,7
CHANDIGARH,2001,Total,0,20,15,2,2,39,0,18,11,2,0,31,70
CHANDIGARH,2001,Total (Poison),0,2,0,0,0,2,0,6,1,0,0,7,9
CHANDIGARH,2001,Total (Jumping),0,0,0,1,0,1,0,0,1,0,0,1,2
CHANDIGARH,2002,By Over Alcoholism,0,0,1,0,0,1,0,0,0,0,0,0,1
CHANDIGARH,2002,By Drowning,0,1,1,0,0,2,0,1,0,0,0,1,3
CHANDIGARH,2002,By Fire/Self Immolation,0,1,2,0,0,3,0,2,1,0,1,4,7
CHANDIGARH,2002,By Fire-Arms,0,0,1,0,0,1,0,0,0,0,0,0,1
CHANDIGARH,2002,By Hanging,0,5,14,2,0,21,0,8,1,0,1,10,31
CHANDIGARH,2002,By Consuming Insecticides,0,0,0,0,0,0,0,0,0,0,0,0,0
CHANDIGARH,2002,By Consuming Other Poison,1,14,7,1,0,23,1,11,4,1,0,17,40
CHANDIGARH,2002,By Self Infliction of injury,0,0,0,0,0,0,0,0,0,0,0,0,0
CHANDIGARH,2002,By Jumping from (Building),0,0,0,0,0,0,0,1,0,0,0,1,1
CHANDIGARH,2002,By Jumping from (Other sites),0,0,0,0,0,0,0,0,0,0,0,0,0
CHANDIGARH,2002,By Jumping off Moving Vehicles/Trains,0,0,0,0,0,0,0,0,0,0,0,0,0
CHANDIGARH,2002,By Machine,0,0,0,0,0,0,0,0,0,0,0,0,0
CHANDIGARH,2002,By Overdose of sleeping pills,0,0,0,0,0,0,0,0,0,0,0,0,0
CHANDIGARH,2002,By touching electric wires,0,0,0,0,0,0,0,0,0,0,0,0,0
CHANDIGARH,2002,By coming under running vehicles/trains,0,0,0,0,0,0,0,0,0,0,0,0,0
CHANDIGARH,2002,By Other means,0,2,0,0,0,2,0,0,1,0,0,1,3
CHANDIGARH,2002,Total,1,23,26,3,0,53,1,23,7,1,2,34,87
CHANDIGARH,2002,Total (Poison),1,14,7,1,0,23,1,11,4,1,0,17,40
CHANDIGARH,2002,Total (Jumping),0,0,0,0,0,0,0,1,0,0,0,1,1
CHANDIGARH,2003,By Over Alcoholism,0,0,0,0,0,0,0,0,0,0,0,0,0
CHANDIGARH,2003,By Drowning,0,0,0,0,0,0,0,0,0,0,0,0,0
CHANDIGARH,2003,By Fire/Self Immolation,0,1,4,0,1,6,0,3,1,0,0,4,10
CHANDIGARH,2003,By Fire-Arms,0,1,2,0,0,3,0,0,0,0,0,0,3
CHANDIGARH,2003,By Hanging,0,17,14,2,0,33,1,14,2,0,2,19,52
CHANDIGARH,2003,By Consuming Insecticides,0,0,0,0,0,0,0,0,0,0,0,0,0
CHANDIGARH,2003,By Consuming Other Poison,0,11,6,6,2,25,0,5,4,2,0,11,36
CHANDIGARH,2003,By Self Infliction of injury,0,0,1,0,0,1,0,0,0,0,0,0,1
CHANDIGARH,2003,By Jumping from (Building),0,0,0,0,0,0,0,0,0,0,0,0,0
CHANDIGARH,2003,By Jumping from (Other sites),0,0,0,0,0,0,0,0,1,0,0,1,1
CHANDIGARH,2003,By Jumping off Moving Vehicles/Trains,0,0,0,0,0,0,0,0,0,0,0,0,0
CHANDIGARH,2003,By Machine,0,0,0,0,0,0,0,0,0,0,0,0,0
CHANDIGARH,2003,By Overdose of sleeping pills,0,0,0,0,0,0,0,0,0,0,0,0,0
CHANDIGARH,2003,By touching electric wires,0,0,0,0,0,0,0,0,0,0,0,0,0
CHANDIGARH,2003,By coming under running vehicles/trains,0,0,0,0,0,0,0,0,0,0,0,0,0
CHANDIGARH,2003,By Other means (please specify),0,0,0,0,0,0,0,0,0,0,0,0,0
CHANDIGARH,2003,Total,0,30,27,8,3,68,1,22,8,2,2,35,103
CHANDIGARH,2003,Total (Poison),0,11,7,6,2,26,0,5,4,2,0,11,37
CHANDIGARH,2003,Total (Jumping),0,0,0,0,0,0,0,0,1,0,0,1,1
CHANDIGARH,2004,By Over Alcoholism,0,0,0,0,0,0,0,0,0,0,0,0,0
CHANDIGARH,2004,By Drowning,0,0,0,0,0,0,0,0,0,0,0,0,0
CHANDIGARH,2004,By Fire/Self Immolation,0,2,1,0,0,3,0,2,2,0,0,4,7
CHANDIGARH,2004,By Fire-Arms,0,0,0,0,0,0,0,0,0,0,0,0,0
CHANDIGARH,2004,By Hanging,0,16,14,7,0,37,0,8,0,1,0,9,46
CHANDIGARH,2004,By Consuming Insecticides,0,1,0,0,0,1,0,2,0,0,0,2,3
CHANDIGARH,2004,By Consuming Other Poison,0,4,2,0,0,6,0,7,0,0,0,7,13
CHANDIGARH,2004,By Self Infliction of injury,0,0,0,0,0,0,0,0,0,0,0,0,0
CHANDIGARH,2004,By Jumping from (Building),0,0,0,0,0,0,0,0,0,0,0,0,0
CHANDIGARH,2004,By Jumping from (Other sites),0,0,0,0,0,0,0,0,0,0,0,0,0
CHANDIGARH,2004,By Jumping off Moving Vehicles/Trains,0,0,0,0,0,0,0,0,0,0,0,0,0
CHANDIGARH,2004,By Machine,0,0,0,0,0,0,0,0,0,0,0,0,0
CHANDIGARH,2004,By Overdose of sleeping pills,0,0,0,0,0,0,0,0,0,0,0,0,0
CHANDIGARH,2004,By touching electric wires,0,0,0,0,0,0,0,0,0,0,0,0,0
CHANDIGARH,2004,By coming under running vehicles/trains,0,0,0,0,0,0,0,0,0,0,0,0,0
CHANDIGARH,2004,By Other means (please specify),0,0,4,0,1,5,0,0,0,1,0,1,6
CHANDIGARH,2004,Total,0,23,21,7,1,52,0,19,2,2,0,23,75
CHANDIGARH,2004,Total (Poison),0,5,2,0,0,7,0,9,0,0,0,9,16
CHANDIGARH,2004,Total (Jumping),0,0,0,0,0,0,0,0,0,0,0,0,0
CHANDIGARH,2005,By Over Alcoholism,0,0,2,0,0,2,0,0,0,0,0,0,2
CHANDIGARH,2005,By Drowning,0,6,5,0,0,11,0,2,0,0,0,2,13
CHANDIGARH,2005,By Fire/Self Immolation,0,4,2,2,0,8,0,3,3,1,0,7,15
CHANDIGARH,2005,By Fire-Arms,0,1,0,0,0,1,0,0,0,0,0,0,1
CHANDIGARH,2005,By Hanging,0,17,4,7,0,28,0,8,2,1,0,11,39
CHANDIGARH,2005,By Consuming Insecticides,0,0,0,0,0,0,0,0,0,0,0,0,0
CHANDIGARH,2005,By Consuming Other Poison,1,5,5,1,0,12,0,2,1,1,0,4,16
CHANDIGARH,2005,By Self Infliction of injury,0,0,0,0,0,0,0,0,0,0,0,0,0
CHANDIGARH,2005,By Jumping from (Building),0,0,0,0,0,0,0,0,0,0,0,0,0
CHANDIGARH,2005,By Jumping from (Other sites),0,0,0,0,0,0,0,0,0,0,0,0,0
CHANDIGARH,2005,By Jumping off Moving Vehicles/Trains,0,0,0,0,0,0,0,0,0,0,0,0,0
CHANDIGARH,2005,By Machine,0,0,0,0,0,0,0,0,0,0,0,0,0
CHANDIGARH,2005,By Overdose of sleeping pills,0,0,0,0,0,0,0,0,0,0,0,0,0
CHANDIGARH,2005,By touching electric wires,0,0,0,0,0,0,0,0,0,0,0,0,0
CHANDIGARH,2005,By coming under running vehicles/trains,0,0,0,0,0,0,0,0,0,0,0,0,0
CHANDIGARH,2005,By Other means (please specify),1,0,0,0,0,1,1,0,0,1,0,2,3
CHANDIGARH,2005,Total,2,33,18,10,0,63,1,15,6,4,0,26,89
CHANDIGARH,2005,Total (Poison),1,5,5,1,0,12,0,2,1,1,0,4,16
CHANDIGARH,2005,Total (Jumping),0,0,0,0,0,0,0,0,0,0,0,0,0
CHANDIGARH,2006,By Over Alcoholism,0,0,0,0,0,0,0,0,0,0,0,0,0
CHANDIGARH,2006,By Drowning,0,5,1,0,0,6,0,0,0,0,0,0,6
CHANDIGARH,2006,By Fire/Self Immolation,0,0,0,0,0,0,0,1,3,0,1,5,5
CHANDIGARH,2006,By Fire-Arms,0,2,2,0,1,5,0,0,0,0,0,0,5
CHANDIGARH,2006,By Hanging,0,13,20,3,0,36,2,9,1,1,0,13,49
CHANDIGARH,2006,By Consuming Insecticides,0,0,0,0,0,0,0,0,0,0,0,0,0
CHANDIGARH,2006,By Consuming Other Poison,0,6,2,0,0,8,0,2,2,0,0,4,12
CHANDIGARH,2006,By Self Infliction of injury,0,0,0,0,0,0,0,0,0,0,0,0,0
CHANDIGARH,2006,By Jumping from (Building),0,0,1,0,0,1,0,2,0,0,0,2,3
CHANDIGARH,2006,By Jumping from (Other sites),0,0,0,0,0,0,0,0,0,0,0,0,0
CHANDIGARH,2006,By Jumping off Moving Vehicles/Trains,0,0,0,0,0,0,0,0,0,0,0,0,0
CHANDIGARH,2006,By Machine,0,0,0,0,0,0,0,0,0,0,0,0,0
CHANDIGARH,2006,By Overdose of sleeping pills,0,0,0,0,0,0,0,0,0,0,0,0,0
CHANDIGARH,2006,By touching electric wires,0,0,0,0,0,0,0,0,0,0,0,0,0
CHANDIGARH,2006,By coming under running vehicles/trains,0,0,0,0,0,0,0,0,0,0,0,0,0
CHANDIGARH,2006,By Other means (please specify),0,0,0,0,0,0,0,0,0,0,0,0,0
CHANDIGARH,2006,Total,0,26,26,3,1,56,2,14,6,1,1,24,80
CHANDIGARH,2006,Total (Poison),0,6,2,0,0,8,0,2,2,0,0,4,12
CHANDIGARH,2006,Total (Jumping),0,0,1,0,0,1,0,2,0,0,0,2,3
CHANDIGARH,2007,By Over Alcoholism,0,0,2,0,0,2,0,0,0,0,0,0,2
CHANDIGARH,2007,By Drowning,0,0,0,0,0,0,0,0,0,0,0,0,0
CHANDIGARH,2007,By Fire/Self Immolation,0,2,0,0,0,2,0,1,2,0,1,4,6
CHANDIGARH,2007,By Fire-Arms,0,1,0,0,0,1,0,0,0,0,0,0,1
CHANDIGARH,2007,By Hanging,2,21,14,5,3,45,0,10,4,1,1,16,61
CHANDIGARH,2007,By Consuming Insecticides,0,0,0,0,0,0,0,0,0,0,0,0,0
CHANDIGARH,2007,By Consuming Other Poison,0,2,3,1,0,6,0,0,2,0,0,2,8
CHANDIGARH,2007,By Self Infliction of injury,0,0,0,0,0,0,0,0,0,0,0,0,0
CHANDIGARH,2007,By Jumping from (Building),0,0,2,2,0,4,0,0,0,0,0,0,4
CHANDIGARH,2007,By Jumping from (Other sites),0,0,0,0,0,0,0,0,0,0,0,0,0
CHANDIGARH,2007,By Jumping off Moving Vehicles/Trains,0,0,0,0,0,0,0,0,0,0,0,0,0
CHANDIGARH,2007,By Machine,0,0,0,0,0,0,0,0,0,0,0,0,0
CHANDIGARH,2007,By Overdose of sleeping pills,0,0,0,0,0,0,0,0,0,0,0,0,0
CHANDIGARH,2007,By touching electric wires,0,0,0,0,0,0,0,0,0,0,0,0,0
CHANDIGARH,2007,By coming under running vehicles/trains,0,0,0,0,0,0,0,0,0,0,0,0,0
CHANDIGARH,2007,By Other means (please specify),0,0,0,0,0,0,0,0,0,0,0,0,0
CHANDIGARH,2007,Total,2,26,21,8,3,60,0,11,8,1,2,22,82
CHANDIGARH,2007,Total (Poison),0,2,3,1,0,6,0,0,2,0,0,2,8
CHANDIGARH,2007,Total (Jumping),0,0,2,2,0,4,0,0,0,0,0,0,4
CHANDIGARH,2008,By Over Alcoholism,0,0,0,0,0,0,0,0,0,0,0,0,0
CHANDIGARH,2008,By Drowning,0,0,0,0,0,0,0,0,0,0,0,0,0
CHANDIGARH,2008,By Fire/Self Immolation,0,1,0,1,0,2,0,2,2,1,0,5,7
CHANDIGARH,2008,By Fire-Arms,0,1,1,1,1,4,0,0,0,0,0,0,4
CHANDIGARH,2008,By Hanging,0,15,15,9,0,39,0,9,5,1,0,15,54
CHANDIGARH,2008,By Consuming Insecticides,0,5,1,4,0,10,0,5,0,0,0,5,15
CHANDIGARH,2008,By Consuming Other Poison,0,0,1,0,0,1,0,0,0,0,0,0,1
CHANDIGARH,2008,By Self Infliction of injury,0,0,0,0,0,0,0,0,0,0,0,0,0
CHANDIGARH,2008,By Jumping from (Building),0,0,0,1,0,1,0,0,0,0,0,0,1
CHANDIGARH,2008,By Jumping from (Other sites),0,0,1,0,0,1,0,0,0,0,0,0,1
CHANDIGARH,2008,By Jumping off Moving Vehicles/Trains,0,0,0,0,0,0,0,0,0,0,0,0,0
CHANDIGARH,2008,By Machine,0,0,0,0,0,0,0,0,0,0,0,0,0
CHANDIGARH,2008,By Overdose of sleeping pills,0,0,0,0,0,0,0,0,0,0,0,0,0
CHANDIGARH,2008,By touching electric wires,0,0,0,0,0,0,0,0,0,0,0,0,0
CHANDIGARH,2008,By coming under running vehicles/trains,0,0,0,0,0,0,0,0,0,0,0,0,0
CHANDIGARH,2008,By Other means (please specify),0,0,0,0,0,0,0,0,0,0,0,0,0
CHANDIGARH,2008,Total,0,22,19,16,1,58,0,16,7,2,0,25,83
CHANDIGARH,2008,Total (Poison),0,5,2,4,0,11,0,5,0,0,0,5,16
CHANDIGARH,2008,Total (Jumping),0,0,1,1,0,2,0,0,0,0,0,0,2
CHANDIGARH,2009,By Over Alcoholism,0,0,0,0,0,0,0,0,0,0,0,0,0
CHANDIGARH,2009,By Drowning,0,0,0,0,0,0,0,0,0,0,0,0,0
CHANDIGARH,2009,By Fire/Self Immolation,0,2,0,0,0,2,0,1,3,0,0,4,6
CHANDIGARH,2009,By Fire-Arms,0,0,0,0,1,1,0,0,0,0,0,0,1
CHANDIGARH,2009,By Hanging,0,11,15,5,0,31,1,12,4,0,0,17,48
CHANDIGARH,2009,By Consuming Insecticides,0,0,0,0,0,0,0,0,0,0,0,0,0
CHANDIGARH,2009,By Consuming Other Poison,0,2,3,3,1,9,0,5,2,1,2,10,19
CHANDIGARH,2009,By Self Infliction of injury,0,0,0,0,0,0,0,0,0,0,0,0,0
CHANDIGARH,2009,By Jumping from (Building),0,1,0,0,0,1,0,0,0,0,0,0,1
CHANDIGARH,2009,By Jumping from (Other sites),0,0,0,0,0,0,0,0,0,0,0,0,0
CHANDIGARH,2009,By Jumping off Moving Vehicles/Trains,0,0,0,0,0,0,0,0,0,0,0,0,0
CHANDIGARH,2009,By Machine,0,0,0,0,0,0,0,0,0,0,0,0,0
CHANDIGARH,2009,By Overdose of sleeping pills,0,0,0,0,0,0,0,0,0,0,0,0,0
CHANDIGARH,2009,By touching electric wires,0,0,0,0,0,0,0,0,0,0,0,0,0
CHANDIGARH,2009,By coming under running vehicles/trains,0,0,0,0,0,0,0,0,0,0,0,0,0
CHANDIGARH,2009,By Other means (please specify),0,0,0,0,0,0,0,0,0,0,0,0,0
CHANDIGARH,2009,Total,0,16,18,8,2,44,1,18,9,1,2,31,75
CHANDIGARH,2009,Total (Poison),0,2,3,3,1,9,0,5,2,1,2,10,19
CHANDIGARH,2009,Total (Jumping),0,1,0,0,0,1,0,0,0,0,0,0,1
CHANDIGARH,2010,By Over Alcoholism,0,0,0,0,0,0,0,0,0,0,0,0,0
CHANDIGARH,2010,By Drowning,0,2,0,0,0,2,0,0,0,0,0,0,2
CHANDIGARH,2010,By Fire/Self Immolation,0,0,0,0,0,0,1,6,2,2,0,11,11
CHANDIGARH,2010,By Fire-Arms,0,0,0,0,0,0,0,0,0,0,0,0,0
CHANDIGARH,2010,By Hanging,0,8,12,3,1,24,1,13,3,0,1,18,42
CHANDIGARH,2010,By Consuming Insecticides,0,0,0,0,0,0,0,0,0,0,0,0,0
CHANDIGARH,2010,By Consuming Other Poison,0,4,0,0,0,4,0,6,5,0,0,11,15
CHANDIGARH,2010,By Self Infliction of injury,0,0,0,0,0,0,0,0,0,0,0,0,0
CHANDIGARH,2010,By Jumping from (Building),0,0,0,1,0,1,0,0,0,0,0,0,1
CHANDIGARH,2010,By Jumping from (Other sites),0,0,0,0,0,0,0,0,0,0,0,0,0
CHANDIGARH,2010,By Jumping off Moving Vehicles/Trains,0,0,0,0,0,0,0,0,0,0,0,0,0
CHANDIGARH,2010,By Machine,0,0,0,0,0,0,0,0,0,0,0,0,0
CHANDIGARH,2010,By Overdose of sleeping pills,0,0,0,0,0,0,0,0,0,0,0,0,0
CHANDIGARH,2010,By touching electric wires,0,0,0,0,0,0,0,0,0,0,0,0,0
CHANDIGARH,2010,By coming under running vehicles/trains,0,0,0,0,0,0,0,0,0,0,0,0,0
CHANDIGARH,2010,By Other means (please specify),0,0,0,0,0,0,0,0,0,0,0,0,0
CHANDIGARH,2010,Total,0,14,12,4,1,31,2,25,10,2,1,40,71
CHANDIGARH,2010,Total (Poison),0,4,0,0,0,4,0,6,5,0,0,11,15
CHANDIGARH,2010,Total (Jumping),0,0,0,1,0,1,0,0,0,0,0,0,1
CHANDIGARH,2011,By Over Alcoholism,0,0,0,0,0,0,0,0,0,0,0,0,0
CHANDIGARH,2011,By Drowning,0,3,1,0,0,4,0,1,1,0,0,2,6
CHANDIGARH,2011,By Fire/Self Immolation,0,2,1,1,1,5,0,3,4,1,0,8,13
CHANDIGARH,2011,By Fire-Arms,0,0,1,0,0,1,0,0,0,0,0,0,1
CHANDIGARH,2011,By Hanging,0,9,12,8,0,29,0,21,2,2,0,25,54
CHANDIGARH,2011,By Consuming Insecticides,0,0,0,0,0,0,0,0,0,0,0,0,0
CHANDIGARH,2011,By Consuming Other Poison,0,6,3,1,0,10,0,5,7,0,0,12,22
CHANDIGARH,2011,By Self Infliction of injury,0,2,0,0,0,2,0,1,0,0,0,1,3
CHANDIGARH,2011,By Jumping from (Building),0,1,0,2,0,3,0,0,0,0,0,0,3
CHANDIGARH,2011,By Jumping from (Other sites),0,0,0,0,0,0,0,0,0,0,0,0,0
CHANDIGARH,2011,By Jumping off Moving Vehicles/Trains,0,0,0,0,0,0,0,0,0,0,0,0,0
CHANDIGARH,2011,By Machine,0,0,0,0,0,0,0,0,0,0,0,0,0
CHANDIGARH,2011,By Overdose of sleeping pills,0,0,0,0,0,0,0,0,0,0,0,0,0
CHANDIGARH,2011,By touching electric wires,0,0,0,0,0,0,0,0,0,0,0,0,0
CHANDIGARH,2011,By coming under running vehicles/trains,0,0,0,0,0,0,0,0,0,0,0,0,0
CHANDIGARH,2011,By Other means (please specify),0,1,1,1,0,3,0,0,0,0,0,0,3
CHANDIGARH,2011,Total,0,24,19,13,1,57,0,31,14,3,0,48,105
CHANDIGARH,2011,Total (Poison),0,8,3,1,0,12,0,6,7,0,0,13,25
CHANDIGARH,2011,Total (Jumping),0,1,0,2,0,3,0,0,0,0,0,0,3
CHANDIGARH,2012,By Over Alcoholism,0,0,2,0,0,2,0,0,0,0,0,0,2
CHANDIGARH,2012,By Drowning,0,0,1,0,0,1,0,0,0,0,0,0,1
CHANDIGARH,2012,By Fire/Self Immolation,0,1,3,1,0,5,1,5,4,0,1,11,16
CHANDIGARH,2012,By Fire-Arms,0,1,1,0,0,2,0,0,0,0,0,0,2
CHANDIGARH,2012,By Hanging,2,27,19,5,1,54,0,22,3,0,0,25,79
CHANDIGARH,2012,By Consuming Insecticides,0,0,0,0,0,0,0,0,0,0,0,0,0
CHANDIGARH,2012,By Consuming Other Poison,0,4,5,1,0,10,0,2,1,0,0,3,13
CHANDIGARH,2012,By Self Infliction of injury,0,0,0,0,0,0,0,0,0,0,0,0,0
CHANDIGARH,2012,By Jumping from (Building),0,0,0,1,0,1,0,0,0,0,0,0,1
CHANDIGARH,2012,By Jumping from (Other sites),0,0,0,0,0,0,0,0,0,0,0,0,0
CHANDIGARH,2012,By Jumping off Moving Vehicles/Trains,0,0,0,0,0,0,0,0,0,0,0,0,0
CHANDIGARH,2012,By Machine,0,0,0,0,0,0,0,0,0,0,0,0,0
CHANDIGARH,2012,By Overdose of sleeping pills,0,0,0,0,0,0,0,0,0,0,0,0,0
CHANDIGARH,2012,By touching electric wires,0,0,0,0,0,0,0,0,0,0,0,0,0
CHANDIGARH,2012,By coming under running vehicles/trains,0,0,0,0,0,0,0,0,0,0,0,0,0
CHANDIGARH,2012,By Other means (please specify),0,0,0,0,0,0,0,0,0,0,0,0,0
CHANDIGARH,2012,Total,2,33,31,8,1,75,1,29,8,0,1,39,114
CHANDIGARH,2012,Total (Poison),0,4,5,1,0,10,0,2,1,0,0,3,13
CHANDIGARH,2012,Total (Jumping),0,0,0,1,0,1,0,0,0,0,0,0,1
D & N HAVELI,2001,By Over Alcoholism,0,0,0,0,0,0,0,0,0,0,0,0,0
D & N HAVELI,2001,By Drowning,0,0,0,0,0,0,0,0,0,0,0,0,0
D & N HAVELI,2001,By Fire/Self Immolation,0,0,0,0,0,0,0,0,1,0,0,1,1
D & N HAVELI,2001,By Fire-Arms,0,0,0,0,0,0,0,0,0,0,0,0,0
D & N HAVELI,2001,By Hanging,0,6,7,6,8,27,1,5,2,0,0,8,35
D & N HAVELI,2001,By Consuming Insecticides,0,0,0,0,0,0,0,0,0,0,0,0,0
D & N HAVELI,2001,By Consuming Other Poison,0,4,3,0,0,7,0,4,0,1,0,5,12
D & N HAVELI,2001,By Self Infliction of injury,0,0,0,0,0,0,0,0,0,0,0,0,0
D & N HAVELI,2001,By Jumping from (Building),0,0,0,0,0,0,0,0,0,0,0,0,0
D & N HAVELI,2001,By Jumping from (Other sites),0,0,0,0,0,0,0,0,0,0,0,0,0
D & N HAVELI,2001,By Jumping off Moving Vehicles/Trains,0,0,0,0,0,0,0,0,0,0,0,0,0
D & N HAVELI,2001,By Machine,0,0,0,0,0,0,0,0,0,0,0,0,0
D & N HAVELI,2001,By Overdose of sleeping pills,0,0,0,0,0,0,0,0,0,0,0,0,0
D & N HAVELI,2001,By touching electric wires,0,0,0,0,0,0,0,0,0,0,0,0,0
D & N HAVELI,2001,By coming under running vehicles/trains,0,0,0,0,0,0,0,0,0,0,0,0,0
D & N HAVELI,2001,By Other means (please specify),0,0,0,1,0,1,0,0,1,0,0,1,2
D & N HAVELI,2001,Total,0,10,10,7,8,35,1,9,4,1,0,15,50
D & N HAVELI,2001,Total (Poison),0,4,3,0,0,7,0,4,0,1,0,5,12
D & N HAVELI,2001,Total (Jumping),0,0,0,0,0,0,0,0,0,0,0,0,0
D & N HAVELI,2002,By Over Alcoholism,0,0,0,0,0,0,0,0,0,0,0,0,0
D & N HAVELI,2002,By Drowning,0,0,0,0,0,0,0,0,0,0,0,0,0
D & N HAVELI,2002,By Fire/Self Immolation,0,0,0,0,0,0,0,0,0,1,0,1,1
D & N HAVELI,2002,By Fire-Arms,0,0,0,0,0,0,0,0,0,0,0,0,0
D & N HAVELI,2002,By Hanging,1,8,5,5,5,24,0,5,1,1,0,7,31
D & N HAVELI,2002,By Consuming Insecticides,0,0,0,1,0,1,0,1,0,0,1,2,3
D & N HAVELI,2002,By Consuming Other Poison,0,1,3,3,0,7,0,5,2,0,1,8,15
D & N HAVELI,2002,By Self Infliction of injury,0,0,0,0,0,0,0,0,0,0,0,0,0
D & N HAVELI,2002,By Jumping from (Building),0,0,0,0,0,0,0,0,0,0,0,0,0
D & N HAVELI,2002,By Jumping from (Other sites),0,0,0,0,0,0,0,0,0,0,0,0,0
D & N HAVELI,2002,By Jumping off Moving Vehicles/Trains,0,0,0,0,0,0,0,0,0,0,0,0,0
D & N HAVELI,2002,By Machine,0,0,0,0,0,0,0,0,0,0,0,0,0
D & N HAVELI,2002,By Overdose of sleeping pills,0,0,0,0,0,0,0,0,0,0,0,0,0
D & N HAVELI,2002,By touching electric wires,0,0,0,0,0,0,0,0,0,0,0,0,0
D & N HAVELI,2002,By coming under running vehicles/trains,0,0,0,0,0,0,0,0,0,0,0,0,0
D & N HAVELI,2002,By Other means,0,0,0,0,0,0,0,0,0,0,0,0,0
D & N HAVELI,2002,Total,1,9,8,9,5,32,0,11,3,2,2,18,50
D & N HAVELI,2002,Total (Poison),0,1,3,4,0,8,0,6,2,0,2,10,18
D & N HAVELI,2002,Total (Jumping),0,0,0,0,0,0,0,0,0,0,0,0,0
D & N HAVELI,2003,By Over Alcoholism,0,0,0,0,0,0,0,0,0,0,0,0,0
D & N HAVELI,2003,By Drowning,0,0,0,0,0,0,0,0,0,0,0,0,0
D & N HAVELI,2003,By Fire/Self Immolation,0,0,0,0,0,0,0,0,0,0,0,0,0
D & N HAVELI,2003,By Fire-Arms,0,0,0,0,0,0,0,0,0,0,0,0,0
D & N HAVELI,2003,By Hanging,1,4,5,3,4,17,0,5,3,4,0,12,29
D & N HAVELI,2003,By Consuming Insecticides,0,0,0,0,0,0,0,0,0,0,0,0,0
D & N HAVELI,2003,By Consuming Other Poison,1,3,2,4,1,11,0,1,4,2,0,7,18
D & N HAVELI,2003,By Self Infliction of injury,0,0,0,0,0,0,0,0,0,0,0,0,0
D & N HAVELI,2003,By Jumping from (Building),0,1,0,0,0,1,0,0,0,0,0,0,1
D & N HAVELI,2003,By Jumping from (Other sites),0,0,0,0,0,0,0,0,0,1,0,1,1
D & N HAVELI,2003,By Jumping off Moving Vehicles/Trains,0,0,0,0,0,0,0,0,0,0,0,0,0
D & N HAVELI,2003,By Machine,0,0,0,0,0,0,0,0,0,0,0,0,0
D & N HAVELI,2003,By Overdose of sleeping pills,0,0,0,0,0,0,0,0,0,0,0,0,0
D & N HAVELI,2003,By touching electric wires,0,0,0,0,0,0,0,0,0,0,0,0,0
D & N HAVELI,2003,By coming under running vehicles/trains,0,0,0,0,0,0,0,0,0,0,0,0,0
D & N HAVELI,2003,By Other means (please specify),0,0,1,0,0,1,0,0,0,2,0,2,3
D & N HAVELI,2003,Total,2,8,8,7,5,30,0,6,7,9,0,22,52
D & N HAVELI,2003,Total (Poison),1,3,2,4,1,11,0,1,4,2,0,7,18
D & N HAVELI,2003,Total (Jumping),0,1,0,0,0,1,0,0,0,1,0,1,2
D & N HAVELI,2004,By Over Alcoholism,0,0,0,0,0,0,0,0,0,0,0,0,0
D & N HAVELI,2004,By Drowning,0,0,0,0,0,0,0,0,0,0,0,0,0
D & N HAVELI,2004,By Fire/Self Immolation,0,0,2,0,0,2,0,2,1,0,0,3,5
D & N HAVELI,2004,By Fire-Arms,0,0,0,0,0,0,0,0,0,0,0,0,0
D & N HAVELI,2004,By Hanging,0,7,2,3,2,14,0,6,2,0,1,9,23
D & N HAVELI,2004,By Consuming Insecticides,0,0,0,0,0,0,0,0,0,0,0,0,0
D & N HAVELI,2004,By Consuming Other Poison,0,0,2,1,1,4,0,4,2,1,0,7,11
D & N HAVELI,2004,By Self Infliction of injury,0,0,0,0,0,0,0,0,0,0,0,0,0
D & N HAVELI,2004,By Jumping from (Building),0,0,0,0,0,0,0,0,0,0,0,0,0
D & N HAVELI,2004,By Jumping from (Other sites),0,0,0,0,0,0,0,0,0,0,0,0,0
D & N HAVELI,2004,By Jumping off Moving Vehicles/Trains,0,0,0,0,0,0,0,0,0,0,0,0,0
D & N HAVELI,2004,By Machine,0,0,0,0,0,0,0,0,0,0,0,0,0
D & N HAVELI,2004,By Overdose of sleeping pills,0,0,0,0,0,0,0,0,0,0,0,0,0
D & N HAVELI,2004,By touching electric wires,0,0,0,0,0,0,0,0,0,0,0,0,0
D & N HAVELI,2004,By coming under running vehicles/trains,0,0,0,0,0,0,0,0,0,0,0,0,0
D & N HAVELI,2004,By Other means (please specify),0,0,0,0,0,0,0,0,0,0,0,0,0
D & N HAVELI,2004,Total,0,7,6,4,3,20,0,12,5,1,1,19,39
D & N HAVELI,2004,Total (Poison),0,0,2,1,1,4,0,4,2,1,0,7,11
D & N HAVELI,2004,Total (Jumping),0,0,0,0,0,0,0,0,0,0,0,0,0
D & N HAVELI,2005,By Over Alcoholism,0,0,0,0,0,0,0,0,0,0,0,0,0
D & N HAVELI,2005,By Drowning,0,0,0,0,1,1,0,0,0,0,0,0,1
D & N HAVELI,2005,By Fire/Self Immolation,0,1,0,0,0,1,0,3,1,0,0,4,5
D & N HAVELI,2005,By Fire-Arms,0,0,0,0,0,0,0,0,0,0,0,0,0
D & N HAVELI,2005,By Hanging,0,9,10,5,5,29,0,6,2,4,1,13,42
D & N HAVELI,2005,By Consuming Insecticides,0,1,0,0,0,1,0,2,0,2,0,4,5
D & N HAVELI,2005,By Consuming Other Poison,0,5,3,1,0,9,0,1,5,1,0,7,16
D & N HAVELI,2005,By Self Infliction of injury,0,0,0,0,0,0,0,0,0,0,0,0,0
D & N HAVELI,2005,By Jumping from (Building),0,0,0,0,0,0,0,0,0,0,0,0,0
D & N HAVELI,2005,By Jumping from (Other sites),0,0,0,0,0,0,0,0,0,0,0,0,0
D & N HAVELI,2005,By Jumping off Moving Vehicles/Trains,0,0,0,0,0,0,0,0,0,0,0,0,0
D & N HAVELI,2005,By Machine,0,0,0,0,0,0,0,0,0,0,0,0,0
D & N HAVELI,2005,By Overdose of sleeping pills,0,0,0,0,0,0,0,0,0,0,0,0,0
D & N HAVELI,2005,By touching electric wires,0,0,0,0,0,0,0,0,0,0,0,0,0
D & N HAVELI,2005,By coming under running vehicles/trains,0,0,0,0,0,0,0,0,0,0,0,0,0
D & N HAVELI,2005,By Other means (please specify),0,0,0,0,0,0,0,0,0,0,0,0,0
D & N HAVELI,2005,Total,0,16,13,6,6,41,0,12,8,7,1,28,69
D & N HAVELI,2005,Total (Poison),0,6,3,1,0,10,0,3,5,3,0,11,21
D & N HAVELI,2005,Total (Jumping),0,0,0,0,0,0,0,0,0,0,0,0,0
D & N HAVELI,2006,By Over Alcoholism,0,0,0,0,0,0,0,0,0,0,0,0,0
D & N HAVELI,2006,By Drowning,0,0,0,0,0,0,0,0,0,0,0,0,0
D & N HAVELI,2006,By Fire/Self Immolation,0,0,1,0,0,1,0,0,0,0,0,0,1
D & N HAVELI,2006,By Fire-Arms,0,0,0,0,0,0,0,0,0,0,0,0,0
D & N HAVELI,2006,By Hanging,0,6,4,3,6,19,1,6,5,2,2,16,35
D & N HAVELI,2006,By Consuming Insecticides,0,0,0,0,0,0,0,0,0,0,0,0,0
D & N HAVELI,2006,By Consuming Other Poison,0,2,0,0,1,3,0,2,1,0,0,3,6
D & N HAVELI,2006,By Self Infliction of injury,0,0,0,0,0,0,0,0,0,0,0,0,0
D & N HAVELI,2006,By Jumping from (Building),0,0,0,0,0,0,0,0,0,0,0,0,0
D & N HAVELI,2006,By Jumping from (Other sites),0,0,0,0,0,0,0,0,0,0,0,0,0
D & N HAVELI,2006,By Jumping off Moving Vehicles/Trains,0,0,0,0,0,0,0,0,0,0,0,0,0
D & N HAVELI,2006,By Machine,0,0,0,0,0,0,0,0,0,0,0,0,0
D & N HAVELI,2006,By Overdose of sleeping pills,0,0,0,0,0,0,0,0,0,0,0,0,0
D & N HAVELI,2006,By touching electric wires,0,0,0,0,0,0,0,0,0,0,0,0,0
D & N HAVELI,2006,By coming under running vehicles/trains,0,0,0,0,0,0,0,0,0,0,0,0,0
D & N HAVELI,2006,By Other means (please specify),0,0,0,0,0,0,0,0,0,0,0,0,0
D & N HAVELI,2006,Total,0,8,5,3,7,23,1,8,6,2,2,19,42
D & N HAVELI,2006,Total (Poison),0,2,0,0,1,3,0,2,1,0,0,3,6
D & N HAVELI,2006,Total (Jumping),0,0,0,0,0,0,0,0,0,0,0,0,0
D & N HAVELI,2007,By Over Alcoholism,0,0,0,0,0,0,0,0,0,0,0,0,0
D & N HAVELI,2007,By Drowning,0,0,0,0,0,0,0,0,0,0,0,0,0
D & N HAVELI,2007,By Fire/Self Immolation,0,0,1,0,0,1,0,1,1,0,0,2,3
D & N HAVELI,2007,By Fire-Arms,0,0,0,0,0,0,0,0,0,0,0,0,0
D & N HAVELI,2007,By Hanging,0,13,12,4,7,36,0,10,5,3,1,19,55
D & N HAVELI,2007,By Consuming Insecticides,0,0,0,0,0,0,0,0,0,0,0,0,0
D & N HAVELI,2007,By Consuming Other Poison,0,2,1,3,1,7,0,8,2,1,0,11,18
D & N HAVELI,2007,By Self Infliction of injury,0,0,0,0,0,0,0,0,0,0,0,0,0
D & N HAVELI,2007,By Jumping from (Building),0,0,0,0,0,0,0,0,0,0,0,0,0
D & N HAVELI,2007,By Jumping from (Other sites),0,0,0,0,0,0,0,0,0,0,0,0,0
D & N HAVELI,2007,By Jumping off Moving Vehicles/Trains,0,0,0,0,0,0,0,0,0,0,0,0,0
D & N HAVELI,2007,By Machine,0,0,0,0,0,0,0,0,0,0,0,0,0
D & N HAVELI,2007,By Overdose of sleeping pills,0,0,0,0,0,0,0,0,0,0,0,0,0
D & N HAVELI,2007,By touching electric wires,0,0,0,0,0,0,0,0,0,0,0,0,0
D & N HAVELI,2007,By coming under running vehicles/trains,0,0,0,0,0,0,0,0,0,0,0,0,0
D & N HAVELI,2007,By Other means (please specify),0,0,0,0,0,0,0,0,0,0,0,0,0
D & N HAVELI,2007,Total,0,15,14,7,8,44,0,19,8,4,1,32,76
D & N HAVELI,2007,Total (Poison),0,2,1,3,1,7,0,8,2,1,0,11,18
D & N HAVELI,2007,Total (Jumping),0,0,0,0,0,0,0,0,0,0,0,0,0
D & N HAVELI,2008,By Over Alcoholism,0,0,0,0,0,0,0,0,0,0,0,0,0
D & N HAVELI,2008,By Drowning,1,0,1,1,0,3,0,1,0,0,1,2,5
D & N HAVELI,2008,By Fire/Self Immolation,0,0,0,0,0,0,0,2,0,1,0,3,3
D & N HAVELI,2008,By Fire-Arms,0,0,0,0,0,0,0,0,0,0,0,0,0
D & N HAVELI,2008,By Hanging,0,9,10,5,0,24,0,8,3,4,0,15,39
D & N HAVELI,2008,By Consuming Insecticides,0,2,0,1,0,3,0,2,1,0,0,3,6
D & N HAVELI,2008,By Consuming Other Poison,0,0,0,1,1,2,0,2,2,1,0,5,7
D & N HAVELI,2008,By Self Infliction of injury,0,0,0,0,0,0,0,0,0,0,0,0,0
D & N HAVELI,2008,By Jumping from (Building),0,0,0,0,0,0,0,0,0,0,0,0,0
D & N HAVELI,2008,By Jumping from (Other sites),0,0,0,0,0,0,0,0,0,0,0,0,0
D & N HAVELI,2008,By Jumping off Moving Vehicles/Trains,0,0,0,0,0,0,0,0,0,0,0,0,0
D & N HAVELI,2008,By Machine,0,0,0,0,0,0,0,0,0,0,0,0,0
D & N HAVELI,2008,By Overdose of sleeping pills,0,0,0,0,0,0,0,0,0,0,0,0,0
D & N HAVELI,2008,By touching electric wires,0,0,0,0,0,0,0,0,0,0,0,0,0
D & N HAVELI,2008,By coming under running vehicles/trains,0,0,0,0,0,0,0,0,0,0,0,0,0
D & N HAVELI,2008,By Other means (please specify),0,0,0,0,0,0,0,0,0,0,0,0,0
D & N HAVELI,2008,Total,1,11,11,8,1,32,0,15,6,6,1,28,60
D & N HAVELI,2008,Total (Poison),0,2,0,2,1,5,0,4,3,1,0,8,13
D & N HAVELI,2008,Total (Jumping),0,0,0,0,0,0,0,0,0,0,0,0,0
D & N HAVELI,2009,By Over Alcoholism,0,0,0,0,0,0,0,0,0,0,0,0,0
D & N HAVELI,2009,By Drowning,0,0,0,0,0,0,0,0,0,0,0,0,0
D & N HAVELI,2009,By Fire/Self Immolation,0,0,1,0,0,1,0,4,0,0,1,5,6
D & N HAVELI,2009,By Fire-Arms,0,0,0,0,0,0,0,0,0,0,0,0,0
D & N HAVELI,2009,By Hanging,0,8,6,7,2,23,0,8,4,0,5,17,40
D & N HAVELI,2009,By Consuming Insecticides,0,2,3,1,0,6,0,1,0,0,1,2,8
D & N HAVELI,2009,By Consuming Other Poison,0,0,0,0,0,0,0,1,0,1,0,2,2
D & N HAVELI,2009,By Self Infliction of injury,0,0,0,0,0,0,0,0,0,0,0,0,0
D & N HAVELI,2009,By Jumping from (Building),0,0,0,0,0,0,0,0,0,0,0,0,0
D & N HAVELI,2009,By Jumping from (Other sites),0,0,0,0,0,0,0,0,0,0,0,0,0
D & N HAVELI,2009,By Jumping off Moving Vehicles/Trains,0,0,0,0,0,0,0,0,0,0,0,0,0
D & N HAVELI,2009,By Machine,0,0,0,0,0,0,0,0,0,0,0,0,0
D & N HAVELI,2009,By Overdose of sleeping pills,0,0,0,0,0,0,0,0,0,0,0,0,0
D & N HAVELI,2009,By touching electric wires,0,0,0,0,0,0,0,0,0,0,0,0,0
D & N HAVELI,2009,By coming under running vehicles/trains,0,0,0,0,0,0,0,0,0,0,0,0,0
D & N HAVELI,2009,By Other means (please specify),0,0,0,0,0,0,0,0,0,0,0,0,0
D & N HAVELI,2009,Total,0,10,10,8,2,30,0,14,4,1,7,26,56
D & N HAVELI,2009,Total (Poison),0,2,3,1,0,6,0,2,0,1,1,4,10
D & N HAVELI,2009,Total (Jumping),0,0,0,0,0,0,0,0,0,0,0,0,0
D & N HAVELI,2010,By Over Alcoholism,0,0,0,0,0,0,0,0,0,0,0,0,0
D & N HAVELI,2010,By Drowning,0,0,0,0,0,0,0,0,0,0,0,0,0
D & N HAVELI,2010,By Fire/Self Immolation,0,0,0,0,0,0,0,0,0,0,0,0,0
D & N HAVELI,2010,By Fire-Arms,0,0,0,0,0,0,0,0,0,0,0,0,0
D & N HAVELI,2010,By Hanging,0,13,10,5,4,32,0,14,2,2,0,18,50
D & N HAVELI,2010,By Consuming Insecticides,0,1,1,0,0,2,0,1,0,0,0,1,3
D & N HAVELI,2010,By Consuming Other Poison,0,0,1,1,1,3,0,3,2,2,0,7,10
D & N HAVELI,2010,By Self Infliction of injury,0,0,0,0,0,0,0,0,0,0,0,0,0
D & N HAVELI,2010,By Jumping from (Building),0,0,0,0,0,0,0,0,0,0,0,0,0
D & N HAVELI,2010,By Jumping from (Other sites),0,0,0,0,0,0,0,0,0,0,0,0,0
D & N HAVELI,2010,By Jumping off Moving Vehicles/Trains,0,0,0,0,0,0,0,0,0,0,0,0,0
D & N HAVELI,2010,By Machine,0,0,0,0,0,0,0,0,0,0,0,0,0
D & N HAVELI,2010,By Overdose of sleeping pills,0,0,0,0,0,0,0,0,0,0,0,0,0
D & N HAVELI,2010,By touching electric wires,0,0,0,0,0,0,0,0,0,0,0,0,0
D & N HAVELI,2010,By coming under running vehicles/trains,0,0,0,0,0,0,0,0,0,0,0,0,0
D & N HAVELI,2010,By Other means (please specify),0,0,0,0,0,0,0,0,0,0,0,0,0
D & N HAVELI,2010,Total,0,14,12,6,5,37,0,18,4,4,0,26,63
D & N HAVELI,2010,Total (Poison),0,1,2,1,1,5,0,4,2,2,0,8,13
D & N HAVELI,2010,Total (Jumping),0,0,0,0,0,0,0,0,0,0,0,0,0
D & N HAVELI,2011,By Over Alcoholism,0,0,0,0,0,0,0,0,0,0,0,0,0
D & N HAVELI,2011,By Drowning,0,0,0,0,0,0,0,0,0,0,0,0,0
D & N HAVELI,2011,By Fire/Self Immolation,0,0,1,3,0,4,0,2,1,0,0,3,7
D & N HAVELI,2011,By Fire-Arms,0,0,0,0,0,0,0,0,0,0,0,0,0
D & N HAVELI,2011,By Hanging,0,20,6,5,1,32,0,9,3,3,0,15,47
D & N HAVELI,2011,By Consuming Insecticides,0,0,0,0,0,0,0,0,1,0,0,1,1
D & N HAVELI,2011,By Consuming Other Poison,0,1,1,1,0,3,0,2,0,0,1,3,6
D & N HAVELI,2011,By Self Infliction of injury,0,0,0,0,0,0,0,0,0,0,0,0,0
D & N HAVELI,2011,By Jumping from (Building),0,0,0,0,0,0,0,0,0,0,0,0,0
D & N HAVELI,2011,By Jumping from (Other sites),0,1,0,0,0,1,0,0,0,0,0,0,1
D & N HAVELI,2011,By Jumping off Moving Vehicles/Trains,0,0,0,0,0,0,0,0,0,0,0,0,0
D & N HAVELI,2011,By Machine,0,0,0,0,0,0,0,0,0,0,0,0,0
D & N HAVELI,2011,By Overdose of sleeping pills,0,0,0,0,0,0,0,0,0,0,0,0,0
D & N HAVELI,2011,By touching electric wires,0,0,0,0,0,0,0,0,0,0,0,0,0
D & N HAVELI,2011,By coming under running vehicles/trains,0,0,0,0,0,0,0,0,0,0,0,0,0
D & N HAVELI,2011,By Other means (please specify),0,1,0,0,0,1,0,0,0,0,0,0,1
D & N HAVELI,2011,Total,0,23,8,9,1,41,0,13,5,3,1,22,63
D & N HAVELI,2011,Total (Poison),0,1,1,1,0,3,0,2,1,0,1,4,7
D & N HAVELI,2011,Total (Jumping),0,1,0,0,0,1,0,0,0,0,0,0,1
D & N HAVELI,2012,By Over Alcoholism,0,0,0,0,0,0,0,0,0,0,0,0,0
D & N HAVELI,2012,By Drowning,0,0,0,0,0,0,0,0,0,0,1,1,1
D & N HAVELI,2012,By Fire/Self Immolation,0,0,1,0,0,1,0,0,0,1,0,1,2
D & N HAVELI,2012,By Fire-Arms,0,0,0,0,0,0,0,0,0,0,0,0,0
D & N HAVELI,2012,By Hanging,0,12,13,4,3,32,0,9,1,0,2,12,44
D & N HAVELI,2012,By Consuming Insecticides,0,0,0,0,0,0,0,0,0,0,0,0,0
D & N HAVELI,2012,By Consuming Other Poison,0,1,0,0,0,1,0,3,0,1,0,4,5
D & N HAVELI,2012,By Self Infliction of injury,0,0,0,0,0,0,0,0,0,0,0,0,0
D & N HAVELI,2012,By Jumping from (Building),0,0,0,0,0,0,0,0,0,0,0,0,0
D & N HAVELI,2012,By Jumping from (Other sites),0,2,0,0,0,2,0,0,0,0,0,0,2
D & N HAVELI,2012,By Jumping off Moving Vehicles/Trains,0,0,0,0,0,0,0,0,0,0,0,0,0
D & N HAVELI,2012,By Machine,0,0,0,0,0,0,0,0,0,0,0,0,0
D & N HAVELI,2012,By Overdose of sleeping pills,0,0,0,0,0,0,0,0,0,0,0,0,0
D & N HAVELI,2012,By touching electric wires,0,0,0,0,0,0,0,0,0,0,0,0,0
D & N HAVELI,2012,By coming under running vehicles/trains,0,0,0,0,0,0,0,0,0,0,0,0,0
D & N HAVELI,2012,By Other means (please specify),0,2,2,1,0,5,0,6,1,0,0,7,12
D & N HAVELI,2012,Total,0,17,16,5,3,41,0,18,2,2,3,25,66
D & N HAVELI,2012,Total (Poison),0,1,0,0,0,1,0,3,0,1,0,4,5
D & N HAVELI,2012,Total (Jumping),0,2,0,0,0,2,0,0,0,0,0,0,2
DAMAN & DIU,2001,By Over Alcoholism,0,0,0,0,0,0,0,0,0,0,0,0,0
DAMAN & DIU,2001,By Drowning,0,0,0,0,0,0,0,0,0,0,0,0,0
DAMAN & DIU,2001,By Fire/Self Immolation,0,0,1,0,0,1,0,1,0,0,0,1,2
DAMAN & DIU,2001,By Fire-Arms,0,0,0,0,0,0,0,0,0,0,0,0,0
DAMAN & DIU,2001,By Hanging,0,2,3,0,0,5,0,1,0,0,0,1,6
DAMAN & DIU,2001,By Consuming Insecticides,0,0,0,0,0,0,0,0,0,0,0,0,0
DAMAN & DIU,2001,By Consuming Other Poison,0,1,1,0,0,2,0,1,0,0,0,1,3
DAMAN & DIU,2001,By Self Infliction of injury,0,0,0,0,0,0,0,0,0,0,0,0,0
DAMAN & DIU,2001,By Jumping from (Building),0,0,0,0,0,0,0,0,0,0,0,0,0
DAMAN & DIU,2001,By Jumping from (Other sites),0,0,0,0,0,0,0,0,0,0,0,0,0
DAMAN & DIU,2001,By Jumping off Moving Vehicles/Trains,0,0,0,0,0,0,0,0,0,0,0,0,0
DAMAN & DIU,2001,By Machine,0,0,0,0,0,0,0,0,0,0,0,0,0
DAMAN & DIU,2001,By Overdose of sleeping pills,0,0,0,0,0,0,0,0,0,0,0,0,0
DAMAN & DIU,2001,By touching electric wires,0,0,0,0,0,0,0,0,0,0,0,0,0
DAMAN & DIU,2001,By coming under running vehicles/trains,0,0,0,0,0,0,0,0,0,0,0,0,0
DAMAN & DIU,2001,By Other means (please specify),0,1,1,0,0,2,0,1,0,0,0,1,3
DAMAN & DIU,2001,Total,0,4,6,0,0,10,0,4,0,0,0,4,14
DAMAN & DIU,2001,Total (Poison),0,1,1,0,0,2,0,1,0,0,0,1,3
DAMAN & DIU,2001,Total (Jumping),0,0,0,0,0,0,0,0,0,0,0,0,0
DAMAN & DIU,2002,By Over Alcoholism,0,0,0,0,0,0,0,0,0,0,0,0,0
DAMAN & DIU,2002,By Drowning,0,0,0,0,0,0,0,0,0,0,0,0,0
DAMAN & DIU,2002,By Fire/Self Immolation,0,0,1,0,1,2,0,0,0,0,0,0,2
DAMAN & DIU,2002,By Fire-Arms,0,0,0,0,0,0,0,0,0,0,0,0,0
DAMAN & DIU,2002,By Hanging,0,3,7,1,0,11,0,1,1,0,0,2,13
DAMAN & DIU,2002,By Consuming Insecticides,0,0,0,0,0,0,0,0,0,0,0,0,0
DAMAN & DIU,2002,By Consuming Other Poison,0,1,1,0,0,2,0,0,0,0,0,0,2
DAMAN & DIU,2002,By Self Infliction of injury,0,0,0,0,0,0,0,0,0,0,0,0,0
DAMAN & DIU,2002,By Jumping from (Building),0,0,0,0,0,0,0,0,0,0,0,0,0
DAMAN & DIU,2002,By Jumping from (Other sites),0,0,0,0,0,0,0,0,0,0,0,0,0
DAMAN & DIU,2002,By Jumping off Moving Vehicles/Trains,0,0,0,0,0,0,0,0,0,0,0,0,0
DAMAN & DIU,2002,By Machine,0,0,0,0,0,0,0,0,0,0,0,0,0
DAMAN & DIU,2002,By Overdose of sleeping pills,0,0,0,0,0,0,0,0,0,0,0,0,0
DAMAN & DIU,2002,By touching electric wires,0,0,0,0,0,0,0,0,0,0,0,0,0
DAMAN & DIU,2002,By coming under running vehicles/trains,0,0,0,0,0,0,0,0,0,0,0,0,0
DAMAN & DIU,2002,By Other means,0,0,0,0,0,0,0,0,0,0,0,0,0
DAMAN & DIU,2002,Total,0,4,9,1,1,15,0,1,1,0,0,2,17
DAMAN & DIU,2002,Total (Poison),0,1,1,0,0,2,0,0,0,0,0,0,2
DAMAN & DIU,2002,Total (Jumping),0,0,0,0,0,0,0,0,0,0,0,0,0
DAMAN & DIU,2003,By Over Alcoholism,0,0,0,0,0,0,0,0,0,0,0,0,0
DAMAN & DIU,2003,By Drowning,0,0,1,0,0,1,0,0,0,0,0,0,1
DAMAN & DIU,2003,By Fire/Self Immolation,1,2,2,0,0,5,0,1,2,0,0,3,8
DAMAN & DIU,2003,By Fire-Arms,0,0,0,0,0,0,0,0,0,0,0,0,0
DAMAN & DIU,2003,By Hanging,0,5,2,2,0,9,0,1,0,1,0,2,11
DAMAN & DIU,2003,By Consuming Insecticides,0,0,2,0,0,2,0,0,0,0,0,0,2
DAMAN & DIU,2003,By Consuming Other Poison,0,0,1,0,0,1,0,0,0,0,0,0,1
DAMAN & DIU,2003,By Self Infliction of injury,0,0,0,0,0,0,0,0,0,0,0,0,0
DAMAN & DIU,2003,By Jumping from (Building),0,0,0,0,0,0,0,0,0,0,0,0,0
DAMAN & DIU,2003,By Jumping from (Other sites),0,0,0,0,0,0,0,0,0,0,0,0,0
DAMAN & DIU,2003,By Jumping off Moving Vehicles/Trains,0,0,0,0,0,0,0,0,0,0,0,0,0
DAMAN & DIU,2003,By Machine,0,0,0,0,0,0,0,0,0,0,0,0,0
DAMAN & DIU,2003,By Overdose of sleeping pills,0,0,0,0,0,0,0,0,0,0,0,0,0
DAMAN & DIU,2003,By touching electric wires,0,0,0,0,0,0,0,0,0,0,0,0,0
DAMAN & DIU,2003,By coming under running vehicles/trains,0,0,0,0,0,0,0,0,0,0,0,0,0
DAMAN & DIU,2003,By Other means (please specify),0,0,0,0,0,0,0,1,0,0,0,1,1
DAMAN & DIU,2003,Total,1,7,8,2,0,18,0,3,2,1,0,6,24
DAMAN & DIU,2003,Total (Poison),0,0,3,0,0,3,0,0,0,0,0,0,3
DAMAN & DIU,2003,Total (Jumping),0,0,0,0,0,0,0,0,0,0,0,0,0
DAMAN & DIU,2004,By Over Alcoholism,0,0,0,0,0,0,0,0,0,0,0,0,0
DAMAN & DIU,2004,By Drowning,0,0,0,1,0,1,0,0,0,0,0,0,1
DAMAN & DIU,2004,By Fire/Self Immolation,0,0,0,0,0,0,0,2,0,0,0,2,2
DAMAN & DIU,2004,By Fire-Arms,0,0,0,0,0,0,0,0,0,0,0,0,0
DAMAN & DIU,2004,By Hanging,0,1,3,0,0,4,0,5,0,0,0,5,9
DAMAN & DIU,2004,By Consuming Insecticides,0,0,0,0,0,0,0,0,0,0,0,0,0
DAMAN & DIU,2004,By Consuming Other Poison,0,0,0,0,0,0,0,1,0,0,0,1,1
DAMAN & DIU,2004,By Self Infliction of injury,0,0,0,0,0,0,0,0,0,0,0,0,0
DAMAN & DIU,2004,By Jumping from (Building),0,0,0,0,0,0,0,0,0,0,0,0,0
DAMAN & DIU,2004,By Jumping from (Other sites),0,0,0,0,0,0,0,0,0,0,0,0,0
DAMAN & DIU,2004,By Jumping off Moving Vehicles/Trains,0,0,0,0,0,0,0,0,0,0,0,0,0
DAMAN & DIU,2004,By Machine,0,0,0,0,0,0,0,0,0,0,0,0,0
DAMAN & DIU,2004,By Overdose of sleeping pills,0,0,0,0,0,0,0,0,0,0,0,0,0
DAMAN & DIU,2004,By touching electric wires,0,0,0,0,0,0,0,0,0,0,0,0,0
DAMAN & DIU,2004,By coming under running vehicles/trains,0,0,0,0,0,0,0,0,0,0,0,0,0
DAMAN & DIU,2004,By Other means (please specify),0,0,0,0,0,0,0,0,0,0,0,0,0
DAMAN & DIU,2004,Total,0,1,3,1,0,5,0,8,0,0,0,8,13
DAMAN & DIU,2004,Total (Poison),0,0,0,0,0,0,0,1,0,0,0,1,1
DAMAN & DIU,2004,Total (Jumping),0,0,0,0,0,0,0,0,0,0,0,0,0
DAMAN & DIU,2005,By Over Alcoholism,0,0,0,0,0,0,0,0,0,0,0,0,0
DAMAN & DIU,2005,By Drowning,0,3,0,2,0,5,0,0,1,0,0,1,6
DAMAN & DIU,2005,By Fire/Self Immolation,0,0,0,0,0,0,0,2,0,0,0,2,2
DAMAN & DIU,2005,By Fire-Arms,0,0,0,0,0,0,0,0,0,0,0,0,0
DAMAN & DIU,2005,By Hanging,0,6,3,0,0,9,0,2,1,0,0,3,12
DAMAN & DIU,2005,By Consuming Insecticides,1,1,0,0,0,2,0,0,0,0,0,0,2
DAMAN & DIU,2005,By Consuming Other Poison,0,0,0,0,0,0,0,0,0,0,0,0,0
DAMAN & DIU,2005,By Self Infliction of injury,0,0,0,0,0,0,0,0,0,0,0,0,0
DAMAN & DIU,2005,By Jumping from (Building),0,0,0,0,0,0,0,0,0,0,0,0,0
DAMAN & DIU,2005,By Jumping from (Other sites),0,0,0,0,0,0,0,0,0,0,0,0,0
DAMAN & DIU,2005,By Jumping off Moving Vehicles/Trains,0,0,0,0,0,0,0,0,0,0,0,0,0
DAMAN & DIU,2005,By Machine,0,0,0,0,0,0,0,0,0,0,0,0,0
DAMAN & DIU,2005,By Overdose of sleeping pills,0,0,0,0,0,0,0,0,0,0,0,0,0
DAMAN & DIU,2005,By touching electric wires,0,0,0,0,0,0,0,0,0,0,0,0,0
DAMAN & DIU,2005,By coming under running vehicles/trains,0,0,0,0,0,0,0,0,0,0,0,0,0
DAMAN & DIU,2005,By Other means (please specify),0,0,1,8,0,9,0,1,0,0,0,1,10
DAMAN & DIU,2005,Total,1,10,4,10,0,25,0,5,2,0,0,7,32
DAMAN & DIU,2005,Total (Poison),1,1,0,0,0,2,0,0,0,0,0,0,2
DAMAN & DIU,2005,Total (Jumping),0,0,0,0,0,0,0,0,0,0,0,0,0
DAMAN & DIU,2006,By Over Alcoholism,0,0,0,0,0,0,0,0,0,0,0,0,0
DAMAN & DIU,2006,By Drowning,0,0,0,0,0,0,0,0,0,0,0,0,0
DAMAN & DIU,2006,By Fire/Self Immolation,0,1,0,0,0,1,0,0,0,0,0,0,1
DAMAN & DIU,2006,By Fire-Arms,0,0,0,0,0,0,0,0,0,0,0,0,0
DAMAN & DIU,2006,By Hanging,0,4,4,0,0,8,1,2,0,0,0,3,11
DAMAN & DIU,2006,By Consuming Insecticides,0,0,0,0,0,0,0,0,0,0,0,0,0
DAMAN & DIU,2006,By Consuming Other Poison,0,2,0,0,1,3,2,2,1,0,0,5,8
DAMAN & DIU,2006,By Self Infliction of injury,0,0,0,0,0,0,0,0,0,0,0,0,0
DAMAN & DIU,2006,By Jumping from (Building),0,0,0,0,0,0,0,0,0,0,0,0,0
DAMAN & DIU,2006,By Jumping from (Other sites),0,0,0,0,0,0,0,0,0,0,0,0,0
DAMAN & DIU,2006,By Jumping off Moving Vehicles/Trains,0,0,0,0,0,0,0,0,0,0,0,0,0
DAMAN & DIU,2006,By Machine,0,0,0,0,0,0,0,0,0,0,0,0,0
DAMAN & DIU,2006,By Overdose of sleeping pills,0,0,0,0,0,0,0,0,0,0,0,0,0
DAMAN & DIU,2006,By touching electric wires,0,0,0,0,0,0,0,0,0,0,0,0,0
DAMAN & DIU,2006,By coming under running vehicles/trains,0,0,0,0,0,0,0,0,0,0,0,0,0
DAMAN & DIU,2006,By Other means (please specify),0,0,1,1,0,2,0,0,0,0,0,0,2
DAMAN & DIU,2006,Total,0,7,5,1,1,14,3,4,1,0,0,8,22
DAMAN & DIU,2006,Total (Poison),0,2,0,0,1,3,2,2,1,0,0,5,8
DAMAN & DIU,2006,Total (Jumping),0,0,0,0,0,0,0,0,0,0,0,0,0
DAMAN & DIU,2007,By Over Alcoholism,0,0,0,0,0,0,0,0,1,0,0,1,1
DAMAN & DIU,2007,By Drowning,0,0,0,0,0,0,0,0,0,0,0,0,0
DAMAN & DIU,2007,By Fire/Self Immolation,0,1,0,0,0,1,0,4,1,0,0,5,6
DAMAN & DIU,2007,By Fire-Arms,0,0,0,1,0,1,0,0,0,0,0,0,1
DAMAN & DIU,2007,By Hanging,0,2,1,0,0,3,0,3,0,0,0,3,6
DAMAN & DIU,2007,By Consuming Insecticides,0,0,0,0,0,0,0,0,0,0,0,0,0
DAMAN & DIU,2007,By Consuming Other Poison,0,0,0,1,0,1,0,0,0,0,0,0,1
DAMAN & DIU,2007,By Self Infliction of injury,0,0,0,0,0,0,0,0,0,0,0,0,0
DAMAN & DIU,2007,By Jumping from (Building),0,0,0,0,0,0,0,0,0,0,0,0,0
DAMAN & DIU,2007,By Jumping from (Other sites),0,0,0,0,0,0,0,0,0,0,0,0,0
DAMAN & DIU,2007,By Jumping off Moving Vehicles/Trains,0,0,0,0,0,0,0,0,0,0,0,0,0
DAMAN & DIU,2007,By Machine,0,0,0,0,0,0,0,0,0,0,0,0,0
DAMAN & DIU,2007,By Overdose of sleeping pills,0,0,0,0,0,0,0,0,0,0,0,0,0
DAMAN & DIU,2007,By touching electric wires,0,0,0,0,0,0,0,0,0,0,0,0,0
DAMAN & DIU,2007,By coming under running vehicles/trains,0,0,0,0,0,0,0,0,0,0,0,0,0
DAMAN & DIU,2007,By Other means (please specify),0,0,0,0,0,0,0,0,0,0,0,0,0
DAMAN & DIU,2007,Total,0,3,1,2,0,6,0,7,2,0,0,9,15
DAMAN & DIU,2007,Total (Poison),0,0,0,1,0,1,0,0,0,0,0,0,1
DAMAN & DIU,2007,Total (Jumping),0,0,0,0,0,0,0,0,0,0,0,0,0
DAMAN & DIU,2008,By Over Alcoholism,0,0,0,0,0,0,0,0,0,0,0,0,0
DAMAN & DIU,2008,By Drowning,0,0,0,2,0,2,0,0,0,0,1,1,3
DAMAN & DIU,2008,By Fire/Self Immolation,0,2,0,0,0,2,0,0,0,0,0,0,2
DAMAN & DIU,2008,By Fire-Arms,0,0,0,1,0,1,0,0,0,0,0,0,1
DAMAN & DIU,2008,By Hanging,0,2,3,3,0,8,0,1,0,1,0,2,10
DAMAN & DIU,2008,By Consuming Insecticides,0,0,0,0,0,0,0,0,0,0,0,0,0
DAMAN & DIU,2008,By Consuming Other Poison,0,0,1,0,0,1,0,0,0,0,2,2,3
DAMAN & DIU,2008,By Self Infliction of injury,0,0,0,0,0,0,0,0,0,0,0,0,0
DAMAN & DIU,2008,By Jumping from (Building),0,0,0,0,0,0,0,0,0,0,0,0,0
DAMAN & DIU,2008,By Jumping from (Other sites),0,0,0,0,0,0,0,0,0,0,0,0,0
DAMAN & DIU,2008,By Jumping off Moving Vehicles/Trains,0,0,0,0,0,0,0,0,0,0,0,0,0
DAMAN & DIU,2008,By Machine,0,0,0,0,0,0,0,0,0,0,0,0,0
DAMAN & DIU,2008,By Overdose of sleeping pills,0,0,0,0,0,0,0,0,0,0,0,0,0
DAMAN & DIU,2008,By touching electric wires,0,0,0,0,0,0,0,0,0,0,0,0,0
DAMAN & DIU,2008,By coming under running vehicles/trains,0,0,0,0,0,0,0,0,0,0,0,0,0
DAMAN & DIU,2008,By Other means (please specify),0,0,0,0,0,0,0,0,0,0,0,0,0
DAMAN & DIU,2008,Total,0,4,4,6,0,14,0,1,0,1,3,5,19
DAMAN & DIU,2008,Total (Poison),0,0,1,0,0,1,0,0,0,0,2,2,3
DAMAN & DIU,2008,Total (Jumping),0,0,0,0,0,0,0,0,0,0,0,0,0
DAMAN & DIU,2009,By Over Alcoholism,0,0,0,0,0,0,0,0,0,0,0,0,0
DAMAN & DIU,2009,By Drowning,0,2,0,2,0,4,0,0,1,0,0,1,5
DAMAN & DIU,2009,By Fire/Self Immolation,0,0,1,1,0,2,1,0,2,1,0,4,6
DAMAN & DIU,2009,By Fire-Arms,0,0,0,0,0,0,0,0,0,0,0,0,0
DAMAN & DIU,2009,By Hanging,0,3,1,0,0,4,0,0,2,0,0,2,6
DAMAN & DIU,2009,By Consuming Insecticides,0,0,0,0,0,0,0,0,0,0,0,0,0
DAMAN & DIU,2009,By Consuming Other Poison,0,2,0,0,2,4,0,1,0,0,0,1,5
DAMAN & DIU,2009,By Self Infliction of injury,0,0,0,0,0,0,0,0,0,0,0,0,0
DAMAN & DIU,2009,By Jumping from (Building),0,1,0,0,0,1,0,0,0,0,0,0,1
DAMAN & DIU,2009,By Jumping from (Other sites),0,0,0,0,0,0,0,0,0,0,0,0,0
DAMAN & DIU,2009,By Jumping off Moving Vehicles/Trains,0,0,0,0,0,0,0,0,0,0,0,0,0
DAMAN & DIU,2009,By Machine,0,0,0,0,0,0,0,0,0,0,0,0,0
DAMAN & DIU,2009,By Overdose of sleeping pills,0,0,0,0,0,0,0,0,0,0,0,0,0
DAMAN & DIU,2009,By touching electric wires,0,0,0,0,0,0,0,0,0,0,0,0,0
DAMAN & DIU,2009,By coming under running vehicles/trains,0,0,0,0,0,0,0,0,0,0,0,0,0
DAMAN & DIU,2009,By Other means (please specify),0,0,0,0,0,0,0,0,0,0,0,0,0
DAMAN & DIU,2009,Total,0,8,2,3,2,15,1,1,5,1,0,8,23
DAMAN & DIU,2009,Total (Poison),0,2,0,0,2,4,0,1,0,0,0,1,5
DAMAN & DIU,2009,Total (Jumping),0,1,0,0,0,1,0,0,0,0,0,0,1
DAMAN & DIU,2010,By Over Alcoholism,0,0,0,0,0,0,0,0,0,0,0,0,0
DAMAN & DIU,2010,By Drowning,1,0,0,0,0,1,0,1,0,0,0,1,2
DAMAN & DIU,2010,By Fire/Self Immolation,2,1,2,0,0,5,0,4,0,0,0,4,9
DAMAN & DIU,2010,By Fire-Arms,0,0,0,0,0,0,0,0,0,0,0,0,0
DAMAN & DIU,2010,By Hanging,0,4,2,1,0,7,0,3,2,0,0,5,12
DAMAN & DIU,2010,By Consuming Insecticides,0,0,1,0,0,1,0,0,0,0,0,0,1
DAMAN & DIU,2010,By Consuming Other Poison,0,3,1,1,0,5,0,2,0,0,0,2,7
DAMAN & DIU,2010,By Self Infliction of injury,0,0,0,0,0,0,0,0,0,0,0,0,0
DAMAN & DIU,2010,By Jumping from (Building),0,0,0,0,0,0,0,0,0,0,0,0,0
DAMAN & DIU,2010,By Jumping from (Other sites),0,0,0,0,0,0,0,0,0,0,0,0,0
DAMAN & DIU,2010,By Jumping off Moving Vehicles/Trains,0,0,0,0,0,0,0,0,0,0,0,0,0
DAMAN & DIU,2010,By Machine,0,0,0,0,0,0,0,0,0,0,0,0,0
DAMAN & DIU,2010,By Overdose of sleeping pills,0,0,0,0,0,0,0,0,0,0,0,0,0
DAMAN & DIU,2010,By touching electric wires,0,0,0,0,0,0,0,0,0,0,0,0,0
DAMAN & DIU,2010,By coming under running vehicles/trains,0,0,0,0,0,0,0,0,0,0,0,0,0
DAMAN & DIU,2010,By Other means (please specify),0,0,0,0,0,0,0,0,0,0,0,0,0
DAMAN & DIU,2010,Total,3,8,6,2,0,19,0,10,2,0,0,12,31
DAMAN & DIU,2010,Total (Poison),0,3,2,1,0,6,0,2,0,0,0,2,8
DAMAN & DIU,2010,Total (Jumping),0,0,0,0,0,0,0,0,0,0,0,0,0
DAMAN & DIU,2011,By Over Alcoholism,0,0,0,0,0,0,0,0,0,0,0,0,0
DAMAN & DIU,2011,By Drowning,0,0,0,0,0,0,0,1,0,0,0,1,1
DAMAN & DIU,2011,By Fire/Self Immolation,0,0,1,0,0,1,0,0,1,0,0,1,2
DAMAN & DIU,2011,By Fire-Arms,0,0,0,0,0,0,0,0,0,0,0,0,0
DAMAN & DIU,2011,By Hanging,1,5,3,3,0,12,0,9,0,1,0,10,22
DAMAN & DIU,2011,By Consuming Insecticides,0,0,0,1,0,1,0,0,0,0,0,0,1
DAMAN & DIU,2011,By Consuming Other Poison,0,1,2,0,0,3,0,2,0,0,0,2,5
DAMAN & DIU,2011,By Self Infliction of injury,0,0,0,0,0,0,0,0,0,0,0,0,0
DAMAN & DIU,2011,By Jumping from (Building),0,0,0,0,0,0,0,0,0,0,0,0,0
DAMAN & DIU,2011,By Jumping from (Other sites),0,0,0,0,0,0,0,0,0,0,0,0,0
DAMAN & DIU,2011,By Jumping off Moving Vehicles/Trains,0,0,0,0,0,0,0,0,0,0,0,0,0
DAMAN & DIU,2011,By Machine,0,0,0,0,0,0,0,0,0,0,0,0,0
DAMAN & DIU,2011,By Overdose of sleeping pills,0,0,0,0,0,0,0,0,0,0,0,0,0
DAMAN & DIU,2011,By touching electric wires,0,0,0,0,0,0,0,0,0,0,0,0,0
DAMAN & DIU,2011,By coming under running vehicles/trains,0,0,0,0,0,0,0,0,0,0,0,0,0
DAMAN & DIU,2011,By Other means (please specify),0,1,0,0,0,1,0,1,0,0,0,1,2
DAMAN & DIU,2011,Total,1,7,6,4,0,18,0,13,1,1,0,15,33
DAMAN & DIU,2011,Total (Poison),0,1,2,1,0,4,0,2,0,0,0,2,6
DAMAN & DIU,2011,Total (Jumping),0,0,0,0,0,0,0,0,0,0,0,0,0
DAMAN & DIU,2012,By Over Alcoholism,0,0,0,0,0,0,0,0,0,0,0,0,0
DAMAN & DIU,2012,By Drowning,0,1,3,3,0,7,0,1,0,0,0,1,8
DAMAN & DIU,2012,By Fire/Self Immolation,0,1,1,0,0,2,0,0,3,0,0,3,5
DAMAN & DIU,2012,By Fire-Arms,0,0,0,0,0,0,0,0,0,0,0,0,0
DAMAN & DIU,2012,By Hanging,0,1,6,1,0,8,1,3,1,0,0,5,13
DAMAN & DIU,2012,By Consuming Insecticides,0,0,0,0,0,0,0,0,0,0,0,0,0
DAMAN & DIU,2012,By Consuming Other Poison,0,1,0,1,0,2,0,1,1,0,0,2,4
DAMAN & DIU,2012,By Self Infliction of injury,0,0,0,0,0,0,0,0,0,0,0,0,0
DAMAN & DIU,2012,By Jumping from (Building),0,0,0,0,0,0,0,0,0,0,0,0,0
DAMAN & DIU,2012,By Jumping from (Other sites),0,0,1,1,0,2,0,0,0,0,0,0,2
DAMAN & DIU,2012,By Jumping off Moving Vehicles/Trains,0,0,0,0,0,0,0,0,0,0,0,0,0
DAMAN & DIU,2012,By Machine,0,0,0,0,0,0,0,0,0,0,0,0,0
DAMAN & DIU,2012,By Overdose of sleeping pills,0,0,0,0,0,0,0,0,0,0,0,0,0
DAMAN & DIU,2012,By touching electric wires,0,0,0,0,0,0,0,0,0,0,0,0,0
DAMAN & DIU,2012,By coming under running vehicles/trains,0,0,0,0,0,0,0,0,0,0,0,0,0
DAMAN & DIU,2012,By Other means (please specify),0,2,2,0,0,4,0,0,0,0,0,0,4
DAMAN & DIU,2012,Total,0,6,13,6,0,25,1,5,5,0,0,11,36
DAMAN & DIU,2012,Total (Poison),0,1,0,1,0,2,0,1,1,0,0,2,4
DAMAN & DIU,2012,Total (Jumping),0,0,1,1,0,2,0,0,0,0,0,0,2
DELHI (UT),2001,By Over Alcoholism,0,5,2,4,2,13,0,0,0,0,1,1,14
DELHI (UT),2001,By Drowning,2,6,1,3,1,13,1,2,0,0,0,3,16
DELHI (UT),2001,By Fire/Self Immolation,2,24,21,3,1,51,5,77,41,12,4,139,190
DELHI (UT),2001,By Fire-Arms,0,6,8,1,1,16,2,4,2,0,0,8,24
DELHI (UT),2001,By Hanging,4,163,133,62,4,366,5,131,70,6,3,215,581
DELHI (UT),2001,By Consuming Insecticides,1,39,30,6,1,77,6,19,14,2,1,42,119
DELHI (UT),2001,By Consuming Other Poison,5,51,39,18,5,118,5,36,20,8,0,69,187
DELHI (UT),2001,By Self Infliction of injury,0,2,2,4,0,8,0,3,1,0,0,4,12
DELHI (UT),2001,By Jumping from (Building),0,2,1,2,1,6,0,1,1,0,1,3,9
DELHI (UT),2001,By Jumping from (Other sites),0,1,2,1,3,7,0,0,1,1,0,2,9
DELHI (UT),2001,By Jumping off Moving Vehicles/Trains,0,2,4,1,0,7,0,2,0,0,0,2,9
DELHI (UT),2001,By Machine,0,0,0,0,0,0,0,0,0,0,0,0,0
DELHI (UT),2001,By Overdose of sleeping pills,0,0,0,0,0,0,0,2,0,0,0,2,2
DELHI (UT),2001,By touching electric wires,0,2,0,0,0,2,0,1,0,0,0,1,3
DELHI (UT),2001,By coming under running vehicles/trains,0,0,1,1,0,2,0,1,0,0,0,1,3
DELHI (UT),2001,By Other means (please specify),1,12,16,9,6,44,4,3,7,2,1,17,61
DELHI (UT),2001,Total,15,315,260,115,25,730,28,282,157,31,11,509,1239
DELHI (UT),2001,Total (Poison),6,92,71,28,6,203,11,58,35,10,1,115,318
DELHI (UT),2001,Total (Jumping),0,3,3,3,4,13,0,1,2,1,1,5,18
DELHI (UT),2002,By Over Alcoholism,0,6,2,1,0,9,0,0,0,0,0,0,9
DELHI (UT),2002,By Drowning,0,2,3,1,0,6,0,1,3,1,0,5,11
DELHI (UT),2002,By Fire/Self Immolation,0,28,20,4,0,52,1,62,32,3,2,100,152
DELHI (UT),2002,By Fire-Arms,0,5,4,1,0,10,0,1,0,0,0,1,11
DELHI (UT),2002,By Hanging,9,160,116,36,3,324,10,99,46,5,0,160,484
DELHI (UT),2002,By Consuming Insecticides,1,33,27,11,2,74,3,28,14,10,0,55,129
DELHI (UT),2002,By Consuming Other Poison,4,48,33,20,9,114,0,46,27,4,2,79,193
DELHI (UT),2002,By Self Infliction of injury,0,3,2,2,0,7,0,0,0,0,0,0,7
DELHI (UT),2002,By Jumping from (Building),0,5,2,4,0,11,0,0,0,0,0,0,11
DELHI (UT),2002,By Jumping from (Other sites),0,1,3,1,0,5,0,0,1,0,0,1,6
DELHI (UT),2002,By Jumping off Moving Vehicles/Trains,0,0,1,0,0,1,0,0,0,0,0,0,1
DELHI (UT),2002,By Machine,0,0,1,0,0,1,0,0,0,0,0,0,1
DELHI (UT),2002,By Overdose of sleeping pills,0,0,2,3,0,5,0,0,0,0,0,0,5
DELHI (UT),2002,By touching electric wires,0,4,0,4,1,9,0,0,1,0,0,1,10
DELHI (UT),2002,By coming under running vehicles/trains,1,4,1,4,1,11,1,3,2,0,0,6,17
DELHI (UT),2002,By Other means,0,2,1,1,0,4,1,1,0,0,0,2,6
DELHI (UT),2002,Total,15,301,218,93,16,643,16,241,126,23,4,410,1053
DELHI (UT),2002,Total (Poison),5,84,62,33,11,195,3,74,41,14,2,134,329
DELHI (UT),2002,Total (Jumping),0,6,5,5,0,16,0,0,1,0,0,1,17
DELHI (UT),2003,By Over Alcoholism,0,6,0,0,0,6,0,2,0,0,0,2,8
DELHI (UT),2003,By Drowning,2,1,1,0,0,4,0,1,0,0,0,1,5
DELHI (UT),2003,By Fire/Self Immolation,2,15,6,5,2,30,0,43,23,9,2,77,107
DELHI (UT),2003,By Fire-Arms,0,18,20,9,2,49,0,7,4,1,0,12,61
DELHI (UT),2003,By Hanging,2,163,154,45,13,377,4,101,49,7,0,161,538
DELHI (UT),2003,By Consuming Insecticides,2,22,14,3,0,41,1,7,4,5,0,17,58
DELHI (UT),2003,By Consuming Other Poison,4,64,51,10,4,133,8,36,16,3,1,64,197
DELHI (UT),2003,By Self Infliction of injury,0,1,0,2,0,3,0,1,0,0,0,1,4
DELHI (UT),2003,By Jumping from (Building),0,8,7,7,5,27,0,10,3,13,0,26,53
DELHI (UT),2003,By Jumping from (Other sites),0,3,2,0,0,5,0,0,0,0,0,0,5
DELHI (UT),2003,By Jumping off Moving Vehicles/Trains,1,1,1,1,0,4,0,1,0,1,0,2,6
DELHI (UT),2003,By Machine,0,0,0,0,0,0,0,0,0,0,0,0,0
DELHI (UT),2003,By Overdose of sleeping pills,0,0,4,0,0,4,0,0,0,0,0,0,4
DELHI (UT),2003,By touching electric wires,0,7,3,0,1,11,0,1,0,1,0,2,13
DELHI (UT),2003,By coming under running vehicles/trains,0,6,0,2,0,8,1,4,0,0,1,6,14
DELHI (UT),2003,By Other means (please specify),5,13,15,6,0,39,5,21,13,1,1,41,80
DELHI (UT),2003,Total,18,328,278,90,27,741,19,235,112,41,5,412,1153
DELHI (UT),2003,Total (Poison),6,87,65,15,4,177,9,44,20,8,1,82,259
DELHI (UT),2003,Total (Jumping),0,11,9,7,5,32,0,10,3,13,0,26,58
DELHI (UT),2004,By Over Alcoholism,0,1,0,0,0,1,0,0,0,0,0,0,1
DELHI (UT),2004,By Drowning,1,3,3,0,0,7,0,0,0,2,0,2,9
DELHI (UT),2004,By Fire/Self Immolation,0,12,13,12,2,39,2,39,17,3,4,65,104
DELHI (UT),2004,By Fire-Arms,1,2,2,3,1,9,0,3,1,2,0,6,15
DELHI (UT),2004,By Hanging,13,226,151,49,11,450,13,144,57,9,10,233,683
DELHI (UT),2004,By Consuming Insecticides,0,5,11,3,0,19,0,9,2,1,0,12,31
DELHI (UT),2004,By Consuming Other Poison,3,48,49,13,1,114,1,45,17,4,0,67,181
DELHI (UT),2004,By Self Infliction of injury,0,1,3,0,0,4,0,0,0,0,2,2,6
DELHI (UT),2004,By Jumping from (Building),0,0,1,0,0,1,0,1,0,0,0,1,2
DELHI (UT),2004,By Jumping from (Other sites),0,3,4,1,0,8,0,7,0,0,0,7,15
DELHI (UT),2004,By Jumping off Moving Vehicles/Trains,0,2,3,3,0,8,0,3,1,0,0,4,12
DELHI (UT),2004,By Machine,0,0,0,0,0,0,0,0,0,0,0,0,0
DELHI (UT),2004,By Overdose of sleeping pills,0,1,0,0,0,1,0,0,0,0,0,0,1
DELHI (UT),2004,By touching electric wires,0,0,1,0,0,1,0,0,0,0,0,0,1
DELHI (UT),2004,By coming under running vehicles/trains,0,0,0,0,0,0,0,0,0,0,0,0,0
DELHI (UT),2004,By Other means (please specify),1,38,57,36,5,137,1,32,22,3,0,58,195
DELHI (UT),2004,Total,19,342,298,120,20,799,17,283,117,24,16,457,1256
DELHI (UT),2004,Total (Poison),3,54,63,16,1,137,1,54,19,5,2,81,218
DELHI (UT),2004,Total (Jumping),0,3,5,1,0,9,0,8,0,0,0,8,17
DELHI (UT),2005,By Over Alcoholism,0,3,5,0,0,8,0,0,0,0,0,0,8
DELHI (UT),2005,By Drowning,0,9,6,2,0,17,0,4,0,0,0,4,21
DELHI (UT),2005,By Fire/Self Immolation,0,16,5,5,0,26,0,48,16,3,3,70,96
DELHI (UT),2005,By Fire-Arms,0,12,7,1,0,20,0,1,0,0,0,1,21
DELHI (UT),2005,By Hanging,5,233,178,65,17,498,8,146,76,16,1,247,745
DELHI (UT),2005,By Consuming Insecticides,0,14,8,1,0,23,0,19,8,0,0,27,50
DELHI (UT),2005,By Consuming Other Poison,0,49,32,15,5,101,1,26,18,4,2,51,152
DELHI (UT),2005,By Self Infliction of injury,0,1,1,0,0,2,1,1,0,0,0,2,4
DELHI (UT),2005,By Jumping from (Building),0,7,7,2,0,16,0,2,1,1,0,4,20
DELHI (UT),2005,By Jumping from (Other sites),2,2,2,1,0,7,1,0,1,1,0,3,10
DELHI (UT),2005,By Jumping off Moving Vehicles/Trains,0,0,0,1,0,1,0,1,0,0,0,1,2
DELHI (UT),2005,By Machine,0,0,0,0,0,0,0,0,0,0,0,0,0
DELHI (UT),2005,By Overdose of sleeping pills,0,2,0,1,0,3,0,0,0,0,0,0,3
DELHI (UT),2005,By touching electric wires,0,1,3,2,0,6,1,1,1,0,0,3,9
DELHI (UT),2005,By coming under running vehicles/trains,0,2,1,1,1,5,0,2,0,0,0,2,7
DELHI (UT),2005,By Other means (please specify),1,19,9,14,1,44,1,30,19,1,2,53,97
DELHI (UT),2005,Total,8,370,264,111,24,777,13,281,140,26,8,468,1245
DELHI (UT),2005,Total (Poison),0,64,41,16,5,126,2,46,26,4,2,80,206
DELHI (UT),2005,Total (Jumping),2,9,9,3,0,23,1,2,2,2,0,7,30
DELHI (UT),2006,By Over Alcoholism,0,9,4,2,0,15,0,0,0,0,0,0,15
DELHI (UT),2006,By Drowning,0,6,1,0,0,7,0,3,0,0,0,3,10
DELHI (UT),2006,By Fire/Self Immolation,0,20,27,11,3,61,1,57,20,4,1,83,144
DELHI (UT),2006,By Fire-Arms,0,2,4,1,0,7,0,0,1,0,0,1,8
DELHI (UT),2006,By Hanging,5,295,194,81,11,586,9,199,91,13,1,313,899
DELHI (UT),2006,By Consuming Insecticides,1,27,21,6,1,56,1,22,10,3,2,38,94
DELHI (UT),2006,By Consuming Other Poison,0,53,40,10,0,103,2,32,14,2,0,50,153
DELHI (UT),2006,By Self Infliction of injury,1,3,2,0,1,7,0,1,0,0,0,1,8
DELHI (UT),2006,By Jumping from (Building),0,10,11,8,2,31,0,4,0,1,0,5,36
DELHI (UT),2006,By Jumping from (Other sites),2,5,6,0,0,13,0,1,0,0,0,1,14
DELHI (UT),2006,By Jumping off Moving Vehicles/Trains,0,5,0,3,0,8,0,4,1,0,0,5,13
DELHI (UT),2006,By Machine,0,0,1,0,0,1,0,0,0,0,0,0,1
DELHI (UT),2006,By Overdose of sleeping pills,0,2,0,2,2,6,0,0,0,0,0,0,6
DELHI (UT),2006,By touching electric wires,0,3,1,1,0,5,0,1,1,0,0,2,7
DELHI (UT),2006,By coming under running vehicles/trains,0,1,2,1,0,4,0,0,0,0,0,0,4
DELHI (UT),2006,By Other means (please specify),0,8,26,13,3,50,3,11,10,5,1,30,80
DELHI (UT),2006,Total,9,449,340,139,23,960,16,335,148,28,5,532,1492
DELHI (UT),2006,Total (Poison),2,83,63,16,2,166,3,55,24,5,2,89,255
DELHI (UT),2006,Total (Jumping),2,15,17,8,2,44,0,5,0,1,0,6,50
DELHI (UT),2007,By Over Alcoholism,0,1,0,0,0,1,0,0,0,0,0,0,1
DELHI (UT),2007,By Drowning,0,1,0,0,2,3,1,1,0,0,0,2,5
DELHI (UT),2007,By Fire/Self Immolation,0,13,15,5,2,35,1,37,18,0,2,58,93
DELHI (UT),2007,By Fire-Arms,0,6,6,0,1,13,0,5,1,0,0,6,19
DELHI (UT),2007,By Hanging,7,293,251,62,12,625,7,212,65,5,1,290,915
DELHI (UT),2007,By Consuming Insecticides,0,11,10,4,0,25,0,12,4,3,0,19,44
DELHI (UT),2007,By Consuming Other Poison,1,46,42,19,8,116,3,43,21,4,2,73,189
DELHI (UT),2007,By Self Infliction of injury,0,2,2,0,2,6,1,0,0,1,0,2,8
DELHI (UT),2007,By Jumping from (Building),3,6,7,1,0,17,0,4,1,0,0,5,22
DELHI (UT),2007,By Jumping from (Other sites),0,2,2,2,0,6,1,1,0,0,1,3,9
DELHI (UT),2007,By Jumping off Moving Vehicles/Trains,0,0,1,0,0,1,0,0,0,0,0,0,1
DELHI (UT),2007,By Machine,0,1,0,3,0,4,0,0,0,0,0,0,4
DELHI (UT),2007,By Overdose of sleeping pills,0,2,1,0,0,3,0,0,0,0,0,0,3
DELHI (UT),2007,By touching electric wires,0,2,1,0,0,3,0,3,0,0,0,3,6
DELHI (UT),2007,By coming under running vehicles/trains,0,0,0,0,0,0,0,0,0,0,0,0,0
DELHI (UT),2007,By Other means (please specify),2,45,37,19,5,108,1,28,18,5,2,54,162
DELHI (UT),2007,Total,13,431,375,115,32,966,15,346,128,18,8,515,1481
DELHI (UT),2007,Total (Poison),1,59,54,23,10,147,4,55,25,8,2,94,241
DELHI (UT),2007,Total (Jumping),3,8,9,3,0,23,1,5,1,0,1,8,31
DELHI (UT),2008,By Over Alcoholism,0,1,3,4,0,8,0,2,0,1,0,3,11
DELHI (UT),2008,By Drowning,0,1,0,0,0,1,0,0,0,0,0,0,1
DELHI (UT),2008,By Fire/Self Immolation,0,10,11,5,0,26,1,41,17,7,1,67,93
DELHI (UT),2008,By Fire-Arms,0,3,2,2,1,8,0,0,1,0,0,1,9
DELHI (UT),2008,By Hanging,10,276,194,54,11,545,12,226,65,12,1,316,861
DELHI (UT),2008,By Consuming Insecticides,2,13,11,6,0,32,1,15,4,0,0,20,52
DELHI (UT),2008,By Consuming Other Poison,3,41,38,18,7,107,3,47,21,4,0,75,182
DELHI (UT),2008,By Self Infliction of injury,0,0,1,0,0,1,0,0,0,0,0,0,1
DELHI (UT),2008,By Jumping from (Building),0,10,9,3,0,22,0,5,1,0,1,7,29
DELHI (UT),2008,By Jumping from (Other sites),0,0,0,0,1,1,0,0,0,0,0,0,1
DELHI (UT),2008,By Jumping off Moving Vehicles/Trains,0,1,0,0,0,1,0,1,0,0,0,1,2
DELHI (UT),2008,By Machine,0,0,0,0,0,0,0,0,0,0,0,0,0
DELHI (UT),2008,By Overdose of sleeping pills,0,1,0,1,1,3,0,0,0,0,0,0,3
DELHI (UT),2008,By touching electric wires,0,1,2,0,0,3,0,0,0,0,0,0,3
DELHI (UT),2008,By coming under running vehicles/trains,0,0,0,1,0,1,0,0,0,0,0,0,1
DELHI (UT),2008,By Other means (please specify),1,13,15,3,4,36,1,10,6,1,0,18,54
DELHI (UT),2008,Total,16,371,286,97,25,795,18,347,115,25,3,508,1303
DELHI (UT),2008,Total (Poison),5,54,50,24,7,140,4,62,25,4,0,95,235
DELHI (UT),2008,Total (Jumping),0,10,9,3,1,23,0,5,1,0,1,7,30
DELHI (UT),2009,By Over Alcoholism,0,2,2,4,1,9,0,0,0,0,0,0,9
DELHI (UT),2009,By Drowning,1,3,1,0,0,5,3,0,0,0,0,3,8
DELHI (UT),2009,By Fire/Self Immolation,0,18,14,8,3,43,1,27,27,2,2,59,102
DELHI (UT),2009,By Fire-Arms,0,8,5,1,0,14,0,0,1,0,0,1,15
DELHI (UT),2009,By Hanging,8,295,201,62,15,581,8,255,57,20,1,341,922
DELHI (UT),2009,By Consuming Insecticides,0,15,6,1,0,22,0,10,2,0,1,13,35
DELHI (UT),2009,By Consuming Other Poison,3,72,42,13,1,131,1,49,20,3,2,75,206
DELHI (UT),2009,By Self Infliction of injury,0,2,0,0,0,2,0,1,0,0,0,1,3
DELHI (UT),2009,By Jumping from (Building),0,3,8,5,1,17,0,3,0,0,0,3,20
DELHI (UT),2009,By Jumping from (Other sites),0,3,1,0,1,5,0,1,0,0,0,1,6
DELHI (UT),2009,By Jumping off Moving Vehicles/Trains,0,4,1,2,1,8,0,0,1,0,0,1,9
DELHI (UT),2009,By Machine,0,0,0,0,0,0,0,0,0,0,0,0,0
DELHI (UT),2009,By Overdose of sleeping pills,0,0,0,0,0,0,0,2,0,0,0,2,2
DELHI (UT),2009,By touching electric wires,1,5,3,0,0,9,0,0,1,0,0,1,10
DELHI (UT),2009,By coming under running vehicles/trains,0,0,1,0,0,1,0,0,0,0,0,0,1
DELHI (UT),2009,By Other means (please specify),2,27,40,12,5,86,6,12,16,8,1,43,129
DELHI (UT),2009,Total,15,457,325,108,28,933,19,360,125,33,7,544,1477
DELHI (UT),2009,Total (Poison),3,89,48,14,1,155,1,60,22,3,3,89,244
DELHI (UT),2009,Total (Jumping),0,6,9,5,2,22,0,4,0,0,0,4,26
DELHI (UT),2010,By Over Alcoholism,0,0,3,7,5,15,0,0,0,0,0,0,15
DELHI (UT),2010,By Drowning,0,11,11,0,2,24,1,8,3,1,1,14,38
DELHI (UT),2010,By Fire/Self Immolation,2,19,13,7,1,42,0,29,12,5,2,48,90
DELHI (UT),2010,By Fire-Arms,0,4,5,2,2,13,0,1,1,0,0,2,15
DELHI (UT),2010,By Hanging,10,284,222,74,26,616,19,234,83,19,5,360,976
DELHI (UT),2010,By Consuming Insecticides,0,36,28,9,1,74,1,21,13,2,0,37,111
DELHI (UT),2010,By Consuming Other Poison,2,39,22,18,7,88,1,40,19,4,1,65,153
DELHI (UT),2010,By Self Infliction of injury,0,2,1,0,0,3,0,1,0,0,0,1,4
DELHI (UT),2010,By Jumping from (Building),0,1,3,0,0,4,0,0,1,0,0,1,5
DELHI (UT),2010,By Jumping from (Other sites),0,2,4,0,0,6,2,3,0,0,0,5,11
DELHI (UT),2010,By Jumping off Moving Vehicles/Trains,0,4,5,2,0,11,0,2,0,0,0,2,13
DELHI (UT),2010,By Machine,0,0,0,0,0,0,0,0,0,0,0,0,0
DELHI (UT),2010,By Overdose of sleeping pills,0,0,0,0,0,0,0,0,0,0,0,0,0
DELHI (UT),2010,By touching electric wires,0,2,1,0,0,3,0,2,3,0,0,5,8
DELHI (UT),2010,By coming under running vehicles/trains,0,1,1,1,0,3,0,2,0,1,0,3,6
DELHI (UT),2010,By Other means (please specify),2,24,20,10,3,59,0,20,15,4,0,39,98
DELHI (UT),2010,Total,16,429,339,130,47,961,24,363,150,36,9,582,1543
DELHI (UT),2010,Total (Poison),2,77,51,27,8,165,2,62,32,6,1,103,268
DELHI (UT),2010,Total (Jumping),0,3,7,0,0,10,2,3,1,0,0,6,16
DELHI (UT),2011,By Over Alcoholism,0,8,10,1,0,19,0,0,0,0,0,0,19
DELHI (UT),2011,By Drowning,2,7,4,2,1,16,0,0,0,0,0,0,16
DELHI (UT),2011,By Fire/Self Immolation,0,20,20,12,5,57,1,24,18,3,0,46,103
DELHI (UT),2011,By Fire-Arms,0,10,3,4,0,17,0,1,0,2,1,4,21
DELHI (UT),2011,By Hanging,11,408,253,70,14,756,12,245,86,28,6,377,1133
DELHI (UT),2011,By Consuming Insecticides,0,13,6,0,0,19,0,7,1,0,1,9,28
DELHI (UT),2011,By Consuming Other Poison,2,91,43,19,8,163,3,34,18,5,4,64,227
DELHI (UT),2011,By Self Infliction of injury,0,5,2,4,0,11,0,0,0,0,0,0,11
DELHI (UT),2011,By Jumping from (Building),0,6,6,2,4,18,0,7,3,0,0,10,28
DELHI (UT),2011,By Jumping from (Other sites),0,2,0,0,0,2,0,0,0,0,0,0,2
DELHI (UT),2011,By Jumping off Moving Vehicles/Trains,0,0,0,0,0,0,0,0,0,0,0,0,0
DELHI (UT),2011,By Machine,0,0,0,0,0,0,0,0,0,0,0,0,0
DELHI (UT),2011,By Overdose of sleeping pills,0,0,3,0,1,4,0,0,0,0,0,0,4
DELHI (UT),2011,By touching electric wires,0,5,2,1,0,8,0,1,0,0,0,1,9
DELHI (UT),2011,By coming under running vehicles/trains,0,1,1,0,0,2,0,0,0,0,0,0,2
DELHI (UT),2011,By Other means (please specify),3,46,14,12,1,76,3,24,9,0,1,37,113
DELHI (UT),2011,Total,18,622,367,127,34,1168,19,343,135,38,13,548,1716
DELHI (UT),2011,Total (Poison),2,109,51,23,8,193,3,41,19,5,5,73,266
DELHI (UT),2011,Total (Jumping),0,8,6,2,4,20,0,7,3,0,0,10,30
DELHI (UT),2012,By Over Alcoholism,0,12,15,2,0,29,0,0,0,0,0,0,29
DELHI (UT),2012,By Drowning,2,5,3,0,0,10,0,2,1,0,1,4,14
DELHI (UT),2012,By Fire/Self Immolation,1,15,7,1,0,24,1,16,12,2,1,32,56
DELHI (UT),2012,By Fire-Arms,0,4,6,4,1,15,0,4,1,0,1,6,21
DELHI (UT),2012,By Hanging,20,465,294,87,19,885,23,299,95,24,6,447,1332
DELHI (UT),2012,By Consuming Insecticides,0,2,3,1,1,7,0,3,2,0,0,5,12
DELHI (UT),2012,By Consuming Other Poison,2,62,45,19,10,138,6,53,31,11,3,104,242
DELHI (UT),2012,By Self Infliction of injury,0,7,2,1,1,11,0,8,2,0,0,10,21
DELHI (UT),2012,By Jumping from (Building),0,6,0,1,0,7,0,6,4,1,0,11,18
DELHI (UT),2012,By Jumping from (Other sites),0,5,0,2,0,7,0,4,1,0,0,5,12
DELHI (UT),2012,By Jumping off Moving Vehicles/Trains,0,2,3,0,2,7,0,2,1,0,0,3,10
DELHI (UT),2012,By Machine,0,0,0,0,0,0,0,0,1,0,0,1,1
DELHI (UT),2012,By Overdose of sleeping pills,0,1,0,3,0,4,0,2,0,0,0,2,6
DELHI (UT),2012,By touching electric wires,0,0,2,2,0,4,0,0,0,0,0,0,4
DELHI (UT),2012,By coming under running vehicles/trains,0,4,6,2,1,13,0,1,0,1,0,2,15
DELHI (UT),2012,By Other means (please specify),1,31,40,12,1,85,1,9,8,2,1,21,106
DELHI (UT),2012,Total,26,621,426,137,36,1246,31,409,159,41,13,653,1899
DELHI (UT),2012,Total (Poison),2,71,50,21,12,156,6,64,35,11,3,119,275
DELHI (UT),2012,Total (Jumping),0,11,0,3,0,14,0,10,5,1,0,16,30
LAKSHADWEEP,2001,By Over Alcoholism,0,0,0,0,0,0,0,0,0,0,0,0,0
LAKSHADWEEP,2001,By Drowning,0,0,0,0,0,0,0,0,0,0,0,0,0
LAKSHADWEEP,2001,By Fire/Self Immolation,0,0,0,0,0,0,0,0,0,0,0,0,0
LAKSHADWEEP,2001,By Fire-Arms,0,0,0,0,0,0,0,0,0,0,0,0,0
LAKSHADWEEP,2001,By Hanging,0,0,0,0,0,0,0,0,0,0,0,0,0
LAKSHADWEEP,2001,By Consuming Insecticides,0,0,0,0,0,0,0,0,0,0,0,0,0
LAKSHADWEEP,2001,By Consuming Other Poison,0,0,0,0,0,0,0,0,0,0,0,0,0
LAKSHADWEEP,2001,By Self Infliction of injury,0,0,0,0,0,0,0,0,0,0,0,0,0
LAKSHADWEEP,2001,By Jumping from (Building),0,0,0,0,0,0,0,0,0,0,0,0,0
LAKSHADWEEP,2001,By Jumping from (Other sites),0,0,0,0,0,0,0,0,0,0,0,0,0
LAKSHADWEEP,2001,By Jumping off Moving Vehicles/Trains,0,0,0,0,0,0,0,0,0,0,0,0,0
LAKSHADWEEP,2001,By Machine,0,0,0,0,0,0,0,0,0,0,0,0,0
LAKSHADWEEP,2001,By Overdose of sleeping pills,0,0,0,0,0,0,0,0,0,0,0,0,0
LAKSHADWEEP,2001,By touching electric wires,0,0,0,0,0,0,0,0,0,0,0,0,0
LAKSHADWEEP,2001,By coming under running vehicles/trains,0,0,0,0,0,0,0,0,0,0,0,0,0
LAKSHADWEEP,2001,By Other means (please specify),0,0,0,0,0,0,0,0,0,0,0,0,0
LAKSHADWEEP,2001,Total,0,0,0,0,0,0,0,0,0,0,0,0,0
LAKSHADWEEP,2001,Total (Poison),0,0,0,0,0,0,0,0,0,0,0,0,0
LAKSHADWEEP,2001,Total (Jumping),0,0,0,0,0,0,0,0,0,0,0,0,0
LAKSHADWEEP,2002,By Over Alcoholism,0,0,0,0,0,0,0,0,0,0,0,0,0
LAKSHADWEEP,2002,By Drowning,0,0,0,0,0,0,0,0,0,0,0,0,0
LAKSHADWEEP,2002,By Fire/Self Immolation,0,0,0,0,0,0,0,0,0,0,0,0,0
LAKSHADWEEP,2002,By Fire-Arms,0,0,0,0,0,0,0,0,0,0,0,0,0
LAKSHADWEEP,2002,By Hanging,0,0,0,0,0,0,0,0,0,0,0,0,0
LAKSHADWEEP,2002,By Consuming Insecticides,0,0,0,0,0,0,0,0,0,0,0,0,0
LAKSHADWEEP,2002,By Consuming Other Poison,0,0,0,0,0,0,0,0,0,0,0,0,0
LAKSHADWEEP,2002,By Self Infliction of injury,0,0,0,0,0,0,0,0,0,0,0,0,0
LAKSHADWEEP,2002,By Jumping from (Building),0,0,0,0,0,0,0,0,0,0,0,0,0
LAKSHADWEEP,2002,By Jumping from (Other sites),0,0,0,0,0,0,0,0,0,0,0,0,0
LAKSHADWEEP,2002,By Jumping off Moving Vehicles/Trains,0,0,0,0,0,0,0,0,0,0,0,0,0
LAKSHADWEEP,2002,By Machine,0,0,0,0,0,0,0,0,0,0,0,0,0
LAKSHADWEEP,2002,By Overdose of sleeping pills,0,0,0,0,0,0,0,0,0,0,0,0,0
LAKSHADWEEP,2002,By touching electric wires,0,0,0,0,0,0,0,0,0,0,0,0,0
LAKSHADWEEP,2002,By coming under running vehicles/trains,0,0,0,0,0,0,0,0,0,0,0,0,0
LAKSHADWEEP,2002,By Other means,0,0,0,0,0,0,0,0,0,0,0,0,0
LAKSHADWEEP,2002,Total,0,0,0,0,0,0,0,0,0,0,0,0,0
LAKSHADWEEP,2002,Total (Poison),0,0,0,0,0,0,0,0,0,0,0,0,0
LAKSHADWEEP,2002,Total (Jumping),0,0,0,0,0,0,0,0,0,0,0,0,0
LAKSHADWEEP,2003,By Over Alcoholism,0,0,0,0,0,0,0,0,0,0,0,0,0
LAKSHADWEEP,2003,By Drowning,0,0,0,0,0,0,0,0,0,0,0,0,0
LAKSHADWEEP,2003,By Fire/Self Immolation,0,0,0,0,0,0,0,1,0,0,0,1,1
LAKSHADWEEP,2003,By Fire-Arms,0,0,0,0,0,0,0,0,0,0,0,0,0
LAKSHADWEEP,2003,By Hanging,0,0,0,0,1,1,0,0,0,0,0,0,1
LAKSHADWEEP,2003,By Consuming Insecticides,0,0,0,0,0,0,0,0,0,0,0,0,0
LAKSHADWEEP,2003,By Consuming Other Poison,0,0,0,0,0,0,0,0,0,0,0,0,0
LAKSHADWEEP,2003,By Self Infliction of injury,0,0,0,0,0,0,0,0,0,0,0,0,0
LAKSHADWEEP,2003,By Jumping from (Building),0,0,0,0,0,0,0,0,0,0,0,0,0
LAKSHADWEEP,2003,By Jumping from (Other sites),0,0,0,0,0,0,0,0,0,0,0,0,0
LAKSHADWEEP,2003,By Jumping off Moving Vehicles/Trains,0,0,0,0,0,0,0,0,0,0,0,0,0
LAKSHADWEEP,2003,By Machine,0,0,0,0,0,0,0,0,0,0,0,0,0
LAKSHADWEEP,2003,By Overdose of sleeping pills,0,0,0,0,0,0,0,0,0,0,0,0,0
LAKSHADWEEP,2003,By touching electric wires,0,0,0,0,0,0,0,0,0,0,0,0,0
LAKSHADWEEP,2003,By coming under running vehicles/trains,0,0,0,0,0,0,0,0,0,0,0,0,0
LAKSHADWEEP,2003,By Other means (please specify),0,0,0,0,0,0,0,0,0,0,0,0,0
LAKSHADWEEP,2003,Total,0,0,0,0,1,1,0,1,0,0,0,1,2
LAKSHADWEEP,2003,Total (Poison),0,0,0,0,0,0,0,0,0,0,0,0,0
LAKSHADWEEP,2003,Total (Jumping),0,0,0,0,0,0,0,0,0,0,0,0,0
LAKSHADWEEP,2004,By Over Alcoholism,0,0,0,0,0,0,0,0,0,0,0,0,0
LAKSHADWEEP,2004,By Drowning,0,0,0,0,0,0,0,0,0,0,0,0,0
LAKSHADWEEP,2004,By Fire/Self Immolation,0,0,0,0,0,0,0,0,0,0,0,0,0
LAKSHADWEEP,2004,By Fire-Arms,0,0,0,0,0,0,0,0,0,0,0,0,0
LAKSHADWEEP,2004,By Hanging,0,0,0,0,0,0,0,0,0,0,0,0,0
LAKSHADWEEP,2004,By Consuming Insecticides,0,0,0,0,0,0,0,0,0,0,0,0,0
LAKSHADWEEP,2004,By Consuming Other Poison,0,0,0,0,0,0,0,0,0,0,0,0,0
LAKSHADWEEP,2004,By Self Infliction of injury,0,0,0,0,0,0,0,0,0,0,0,0,0
LAKSHADWEEP,2004,By Jumping from (Building),0,0,0,0,0,0,0,0,0,0,0,0,0
LAKSHADWEEP,2004,By Jumping from (Other sites),0,0,0,0,0,0,0,0,0,0,0,0,0
LAKSHADWEEP,2004,By Jumping off Moving Vehicles/Trains,0,0,0,0,0,0,0,0,0,0,0,0,0
LAKSHADWEEP,2004,By Machine,0,0,0,0,0,0,0,0,0,0,0,0,0
LAKSHADWEEP,2004,By Overdose of sleeping pills,0,0,0,0,0,0,0,0,0,0,0,0,0
LAKSHADWEEP,2004,By touching electric wires,0,0,0,0,0,0,0,0,0,0,0,0,0
LAKSHADWEEP,2004,By coming under running vehicles/trains,0,0,0,0,0,0,0,0,0,0,0,0,0
LAKSHADWEEP,2004,By Other means (please specify),0,0,0,0,0,0,0,0,0,0,0,0,0
LAKSHADWEEP,2004,Total,0,0,0,0,0,0,0,0,0,0,0,0,0
LAKSHADWEEP,2004,Total (Poison),0,0,0,0,0,0,0,0,0,0,0,0,0
LAKSHADWEEP,2004,Total (Jumping),0,0,0,0,0,0,0,0,0,0,0,0,0
LAKSHADWEEP,2005,By Over Alcoholism,0,0,0,0,0,0,0,0,0,0,0,0,0
LAKSHADWEEP,2005,By Drowning,0,0,0,0,0,0,0,0,0,0,0,0,0
LAKSHADWEEP,2005,By Fire/Self Immolation,0,0,0,0,0,0,0,0,0,0,0,0,0
LAKSHADWEEP,2005,By Fire-Arms,0,0,0,0,0,0,0,0,0,0,0,0,0
LAKSHADWEEP,2005,By Hanging,0,0,0,0,0,0,0,0,0,0,0,0,0
LAKSHADWEEP,2005,By Consuming Insecticides,0,0,0,0,0,0,0,0,0,0,0,0,0
LAKSHADWEEP,2005,By Consuming Other Poison,0,0,0,0,0,0,0,0,0,0,0,0,0
LAKSHADWEEP,2005,By Self Infliction of injury,0,0,0,0,0,0,0,0,0,0,0,0,0
LAKSHADWEEP,2005,By Jumping from (Building),0,0,0,0,0,0,0,0,0,0,0,0,0
LAKSHADWEEP,2005,By Jumping from (Other sites),0,0,0,0,0,0,0,0,0,0,0,0,0
LAKSHADWEEP,2005,By Jumping off Moving Vehicles/Trains,0,0,0,0,0,0,0,0,0,0,0,0,0
LAKSHADWEEP,2005,By Machine,0,0,0,0,0,0,0,0,0,0,0,0,0
LAKSHADWEEP,2005,By Overdose of sleeping pills,0,0,0,0,0,0,0,0,0,0,0,0,0
LAKSHADWEEP,2005,By touching electric wires,0,0,0,0,0,0,0,0,0,0,0,0,0
LAKSHADWEEP,2005,By coming under running vehicles/trains,0,0,0,0,0,0,0,0,0,0,0,0,0
LAKSHADWEEP,2005,By Other means (please specify),0,0,0,0,0,0,0,0,0,0,0,0,0
LAKSHADWEEP,2005,Total,0,0,0,0,0,0,0,0,0,0,0,0,0
LAKSHADWEEP,2005,Total (Poison),0,0,0,0,0,0,0,0,0,0,0,0,0
LAKSHADWEEP,2005,Total (Jumping),0,0,0,0,0,0,0,0,0,0,0,0,0
LAKSHADWEEP,2006,By Over Alcoholism,0,0,0,0,0,0,0,0,0,0,0,0,0
LAKSHADWEEP,2006,By Drowning,0,0,0,0,0,0,0,0,0,0,0,0,0
LAKSHADWEEP,2006,By Fire/Self Immolation,0,0,1,0,0,1,0,1,0,0,0,1,2
LAKSHADWEEP,2006,By Fire-Arms,0,0,0,0,0,0,0,0,0,0,0,0,0
LAKSHADWEEP,2006,By Hanging,0,0,0,0,0,0,0,0,0,0,0,0,0
LAKSHADWEEP,2006,By Consuming Insecticides,0,0,0,0,0,0,0,0,0,0,0,0,0
LAKSHADWEEP,2006,By Consuming Other Poison,0,0,0,0,0,0,0,0,0,0,0,0,0
LAKSHADWEEP,2006,By Self Infliction of injury,0,0,0,0,0,0,0,0,0,0,0,0,0
LAKSHADWEEP,2006,By Jumping from (Building),0,0,0,0,0,0,0,0,0,0,0,0,0
LAKSHADWEEP,2006,By Jumping from (Other sites),0,0,0,0,0,0,0,0,0,0,0,0,0
LAKSHADWEEP,2006,By Jumping off Moving Vehicles/Trains,0,0,0,0,0,0,0,0,0,0,0,0,0
LAKSHADWEEP,2006,By Machine,0,0,0,0,0,0,0,0,0,0,0,0,0
LAKSHADWEEP,2006,By Overdose of sleeping pills,0,0,0,0,0,0,0,0,0,0,0,0,0
LAKSHADWEEP,2006,By touching electric wires,0,0,0,0,0,0,0,0,0,0,0,0,0
LAKSHADWEEP,2006,By coming under running vehicles/trains,0,0,0,0,0,0,0,0,0,0,0,0,0
LAKSHADWEEP,2006,By Other means (please specify),0,0,0,0,0,0,0,0,0,0,0,0,0
LAKSHADWEEP,2006,Total,0,0,1,0,0,1,0,1,0,0,0,1,2
LAKSHADWEEP,2006,Total (Poison),0,0,0,0,0,0,0,0,0,0,0,0,0
LAKSHADWEEP,2006,Total (Jumping),0,0,0,0,0,0,0,0,0,0,0,0,0
LAKSHADWEEP,2007,By Over Alcoholism,0,0,0,0,0,0,0,0,0,0,0,0,0
LAKSHADWEEP,2007,By Drowning,0,0,0,0,0,0,0,0,0,0,0,0,0
LAKSHADWEEP,2007,By Fire/Self Immolation,0,0,1,0,0,1,0,0,0,1,0,1,2
LAKSHADWEEP,2007,By Fire-Arms,0,0,0,0,0,0,0,0,0,0,0,0,0
LAKSHADWEEP,2007,By Hanging,0,0,0,0,0,0,0,0,0,1,0,1,1
LAKSHADWEEP,2007,By Consuming Insecticides,0,0,0,0,0,0,0,0,0,0,0,0,0
LAKSHADWEEP,2007,By Consuming Other Poison,0,0,0,0,0,0,0,0,0,0,0,0,0
LAKSHADWEEP,2007,By Self Infliction of injury,0,0,0,0,0,0,0,0,0,0,0,0,0
LAKSHADWEEP,2007,By Jumping from (Building),0,0,0,0,0,0,0,0,0,0,0,0,0
LAKSHADWEEP,2007,By Jumping from (Other sites),0,0,0,0,0,0,0,0,0,0,0,0,0
LAKSHADWEEP,2007,By Jumping off Moving Vehicles/Trains,0,0,0,0,0,0,0,0,0,0,0,0,0
LAKSHADWEEP,2007,By Machine,0,0,0,0,0,0,0,0,0,0,0,0,0
LAKSHADWEEP,2007,By Overdose of sleeping pills,0,0,0,0,0,0,0,0,0,0,0,0,0
LAKSHADWEEP,2007,By touching electric wires,0,0,0,0,0,0,0,0,0,0,0,0,0
LAKSHADWEEP,2007,By coming under running vehicles/trains,0,0,0,0,0,0,0,0,0,0,0,0,0
LAKSHADWEEP,2007,By Other means (please specify),0,0,0,0,0,0,0,0,0,0,0,0,0
LAKSHADWEEP,2007,Total,0,0,1,0,0,1,0,0,0,2,0,2,3
LAKSHADWEEP,2007,Total (Poison),0,0,0,0,0,0,0,0,0,0,0,0,0
LAKSHADWEEP,2007,Total (Jumping),0,0,0,0,0,0,0,0,0,0,0,0,0
LAKSHADWEEP,2008,By Over Alcoholism,0,0,0,0,0,0,0,0,0,0,0,0,0
LAKSHADWEEP,2008,By Drowning,0,0,0,0,0,0,0,0,0,0,0,0,0
LAKSHADWEEP,2008,By Fire/Self Immolation,0,0,0,0,0,0,0,0,0,0,0,0,0
LAKSHADWEEP,2008,By Fire-Arms,0,0,0,0,0,0,0,0,0,0,0,0,0
LAKSHADWEEP,2008,By Hanging,0,0,0,0,0,0,0,0,0,0,0,0,0
LAKSHADWEEP,2008,By Consuming Insecticides,0,0,0,0,0,0,0,0,0,0,0,0,0
LAKSHADWEEP,2008,By Consuming Other Poison,0,0,0,0,0,0,0,0,0,0,0,0,0
LAKSHADWEEP,2008,By Self Infliction of injury,0,0,0,0,0,0,0,0,0,0,0,0,0
LAKSHADWEEP,2008,By Jumping from (Building),0,0,0,0,0,0,0,0,0,0,0,0,0
LAKSHADWEEP,2008,By Jumping from (Other sites),0,0,0,0,0,0,0,0,0,0,0,0,0
LAKSHADWEEP,2008,By Jumping off Moving Vehicles/Trains,0,0,0,0,0,0,0,0,0,0,0,0,0
LAKSHADWEEP,2008,By Machine,0,0,0,0,0,0,0,0,0,0,0,0,0
LAKSHADWEEP,2008,By Overdose of sleeping pills,0,0,0,0,0,0,0,0,0,0,0,0,0
LAKSHADWEEP,2008,By touching electric wires,0,0,0,0,0,0,0,0,0,0,0,0,0
LAKSHADWEEP,2008,By coming under running vehicles/trains,0,0,0,0,0,0,0,0,0,0,0,0,0
LAKSHADWEEP,2008,By Other means (please specify),0,0,0,0,0,0,0,0,0,0,0,0,0
LAKSHADWEEP,2008,Total,0,0,0,0,0,0,0,0,0,0,0,0,0
LAKSHADWEEP,2008,Total (Poison),0,0,0,0,0,0,0,0,0,0,0,0,0
LAKSHADWEEP,2008,Total (Jumping),0,0,0,0,0,0,0,0,0,0,0,0,0
LAKSHADWEEP,2009,By Over Alcoholism,0,0,0,0,0,0,0,0,0,0,0,0,0
LAKSHADWEEP,2009,By Drowning,0,0,0,0,0,0,0,0,0,0,0,0,0
LAKSHADWEEP,2009,By Fire/Self Immolation,0,0,0,0,0,0,0,0,1,0,0,1,1
LAKSHADWEEP,2009,By Fire-Arms,0,0,0,0,0,0,0,0,0,0,0,0,0
LAKSHADWEEP,2009,By Hanging,0,0,0,0,0,0,0,0,0,0,0,0,0
LAKSHADWEEP,2009,By Consuming Insecticides,0,0,0,0,0,0,0,0,0,0,0,0,0
LAKSHADWEEP,2009,By Consuming Other Poison,0,0,0,0,0,0,0,0,0,0,0,0,0
LAKSHADWEEP,2009,By Self Infliction of injury,0,0,0,0,0,0,0,0,0,0,0,0,0
LAKSHADWEEP,2009,By Jumping from (Building),0,0,0,0,0,0,0,0,0,0,0,0,0
LAKSHADWEEP,2009,By Jumping from (Other sites),0,0,0,0,0,0,0,0,0,0,0,0,0
LAKSHADWEEP,2009,By Jumping off Moving Vehicles/Trains,0,0,0,0,0,0,0,0,0,0,0,0,0
LAKSHADWEEP,2009,By Machine,0,0,0,0,0,0,0,0,0,0,0,0,0
LAKSHADWEEP,2009,By Overdose of sleeping pills,0,0,0,0,0,0,0,0,0,0,0,0,0
LAKSHADWEEP,2009,By touching electric wires,0,0,0,0,0,0,0,0,0,0,0,0,0
LAKSHADWEEP,2009,By coming under running vehicles/trains,0,0,0,0,0,0,0,0,0,0,0,0,0
LAKSHADWEEP,2009,By Other means (please specify),0,0,0,0,0,0,0,0,0,0,0,0,0
LAKSHADWEEP,2009,Total,0,0,0,0,0,0,0,0,1,0,0,1,1
LAKSHADWEEP,2009,Total (Poison),0,0,0,0,0,0,0,0,0,0,0,0,0
LAKSHADWEEP,2009,Total (Jumping),0,0,0,0,0,0,0,0,0,0,0,0,0
LAKSHADWEEP,2010,By Over Alcoholism,0,0,0,0,0,0,0,0,0,0,0,0,0
LAKSHADWEEP,2010,By Drowning,0,0,0,0,0,0,0,0,0,0,0,0,0
LAKSHADWEEP,2010,By Fire/Self Immolation,0,0,0,0,0,0,0,0,0,0,0,0,0
LAKSHADWEEP,2010,By Fire-Arms,0,0,0,0,0,0,0,0,0,0,0,0,0
LAKSHADWEEP,2010,By Hanging,0,0,0,0,0,0,0,0,1,0,0,1,1
LAKSHADWEEP,2010,By Consuming Insecticides,0,0,0,0,0,0,0,0,0,0,0,0,0
LAKSHADWEEP,2010,By Consuming Other Poison,0,0,0,0,0,0,0,0,0,0,0,0,0
LAKSHADWEEP,2010,By Self Infliction of injury,0,0,0,0,0,0,0,0,0,0,0,0,0
LAKSHADWEEP,2010,By Jumping from (Building),0,0,0,0,0,0,0,0,0,0,0,0,0
LAKSHADWEEP,2010,By Jumping from (Other sites),0,0,0,0,0,0,0,0,0,0,0,0,0
LAKSHADWEEP,2010,By Jumping off Moving Vehicles/Trains,0,0,0,0,0,0,0,0,0,0,0,0,0
LAKSHADWEEP,2010,By Machine,0,0,0,0,0,0,0,0,0,0,0,0,0
LAKSHADWEEP,2010,By Overdose of sleeping pills,0,0,0,0,0,0,0,0,0,0,0,0,0
LAKSHADWEEP,2010,By touching electric wires,0,0,0,0,0,0,0,0,0,0,0,0,0
LAKSHADWEEP,2010,By coming under running vehicles/trains,0,0,0,0,0,0,0,0,0,0,0,0,0
LAKSHADWEEP,2010,By Other means (please specify),0,0,0,0,0,0,0,0,0,0,0,0,0
LAKSHADWEEP,2010,Total,0,0,0,0,0,0,0,0,1,0,0,1,1
LAKSHADWEEP,2010,Total (Poison),0,0,0,0,0,0,0,0,0,0,0,0,0
LAKSHADWEEP,2010,Total (Jumping),0,0,0,0,0,0,0,0,0,0,0,0,0
LAKSHADWEEP,2011,By Over Alcoholism,0,0,0,0,0,0,0,0,0,0,0,0,0
LAKSHADWEEP,2011,By Drowning,0,0,0,0,0,0,0,0,0,0,0,0,0
LAKSHADWEEP,2011,By Fire/Self Immolation,0,0,0,0,0,0,0,0,0,0,0,0,0
LAKSHADWEEP,2011,By Fire-Arms,0,0,0,0,0,0,0,0,0,0,0,0,0
LAKSHADWEEP,2011,By Hanging,0,0,0,0,0,0,0,0,0,0,0,0,0
LAKSHADWEEP,2011,By Consuming Insecticides,0,0,0,0,0,0,0,0,0,0,0,0,0
LAKSHADWEEP,2011,By Consuming Other Poison,0,0,0,0,0,0,0,0,0,0,0,0,0
LAKSHADWEEP,2011,By Self Infliction of injury,0,0,0,0,0,0,0,0,0,0,0,0,0
LAKSHADWEEP,2011,By Jumping from (Building),0,0,0,0,0,0,0,0,0,0,0,0,0
LAKSHADWEEP,2011,By Jumping from (Other sites),0,0,0,0,0,0,0,0,0,0,0,0,0
LAKSHADWEEP,2011,By Jumping off Moving Vehicles/Trains,0,0,0,0,0,0,0,0,0,0,0,0,0
LAKSHADWEEP,2011,By Machine,0,0,0,0,0,0,0,0,0,0,0,0,0
LAKSHADWEEP,2011,By Overdose of sleeping pills,0,0,0,0,0,0,0,0,0,0,0,0,0
LAKSHADWEEP,2011,By touching electric wires,0,0,0,0,0,0,0,0,0,0,0,0,0
LAKSHADWEEP,2011,By coming under running vehicles/trains,0,0,0,0,0,0,0,0,0,0,0,0,0
LAKSHADWEEP,2011,By Other means (please specify),0,0,0,0,0,0,0,0,0,0,0,0,0
LAKSHADWEEP,2011,Total,0,0,0,0,0,0,0,0,0,0,0,0,0
LAKSHADWEEP,2011,Total (Poison),0,0,0,0,0,0,0,0,0,0,0,0,0
LAKSHADWEEP,2011,Total (Jumping),0,0,0,0,0,0,0,0,0,0,0,0,0
LAKSHADWEEP,2012,By Over Alcoholism,0,0,0,0,0,0,0,0,0,0,0,0,0
LAKSHADWEEP,2012,By Drowning,0,0,0,0,0,0,0,0,0,0,0,0,0
LAKSHADWEEP,2012,By Fire/Self Immolation,0,0,0,0,0,0,0,0,0,0,0,0,0
LAKSHADWEEP,2012,By Fire-Arms,0,0,0,0,0,0,0,0,0,0,0,0,0
LAKSHADWEEP,2012,By Hanging,0,0,1,0,0,1,0,0,0,0,0,0,1
LAKSHADWEEP,2012,By Consuming Insecticides,0,0,0,0,0,0,0,0,0,0,0,0,0
LAKSHADWEEP,2012,By Consuming Other Poison,0,0,0,0,0,0,0,0,0,0,0,0,0
LAKSHADWEEP,2012,By Self Infliction of injury,0,0,0,0,0,0,0,0,0,0,0,0,0
LAKSHADWEEP,2012,By Jumping from (Building),0,0,0,0,0,0,0,0,0,0,0,0,0
LAKSHADWEEP,2012,By Jumping from (Other sites),0,0,0,0,0,0,0,0,0,0,0,0,0
LAKSHADWEEP,2012,By Jumping off Moving Vehicles/Trains,0,0,0,0,0,0,0,0,0,0,0,0,0
LAKSHADWEEP,2012,By Machine,0,0,0,0,0,0,0,0,0,0,0,0,0
LAKSHADWEEP,2012,By Overdose of sleeping pills,0,0,0,0,0,0,0,0,0,0,0,0,0
LAKSHADWEEP,2012,By touching electric wires,0,0,0,0,0,0,0,0,0,0,0,0,0
LAKSHADWEEP,2012,By coming under running vehicles/trains,0,0,0,0,0,0,0,0,0,0,0,0,0
LAKSHADWEEP,2012,By Other means (please specify),0,0,0,0,0,0,0,0,0,0,0,0,0
LAKSHADWEEP,2012,Total,0,0,1,0,0,1,0,0,0,0,0,0,1
LAKSHADWEEP,2012,Total (Poison),0,0,0,0,0,0,0,0,0,0,0,0,0
LAKSHADWEEP,2012,Total (Jumping),0,0,0,0,0,0,0,0,0,0,0,0,0
PUDUCHERRY,2001,By Over Alcoholism,0,0,0,0,0,0,0,0,0,0,0,0,0
PUDUCHERRY,2001,By Drowning,0,1,2,0,0,3,2,1,2,1,0,6,9
PUDUCHERRY,2001,By Fire/Self Immolation,0,7,9,0,1,17,0,27,14,5,1,47,64
PUDUCHERRY,2001,By Fire-Arms,0,0,1,0,0,1,0,0,0,0,0,0,1
PUDUCHERRY,2001,By Hanging,1,46,65,63,31,206,3,61,22,10,4,100,306
PUDUCHERRY,2001,By Consuming Insecticides,0,12,25,13,4,54,0,9,6,2,2,19,73
PUDUCHERRY,2001,By Consuming Other Poison,1,15,12,7,3,38,1,22,7,4,0,34,72
PUDUCHERRY,2001,By Self Infliction of injury,0,0,0,0,1,1,0,0,0,0,0,0,1
PUDUCHERRY,2001,By Jumping from (Building),0,1,0,0,0,1,0,0,0,0,0,0,1
PUDUCHERRY,2001,By Jumping from (Other sites),0,0,0,0,0,0,0,0,0,0,0,0,0
PUDUCHERRY,2001,By Jumping off Moving Vehicles/Trains,0,0,0,0,0,0,0,0,0,0,0,0,0
PUDUCHERRY,2001,By Machine,0,0,0,0,0,0,0,0,0,0,0,0,0
PUDUCHERRY,2001,By Overdose of sleeping pills,0,0,1,1,0,2,0,0,0,0,0,0,2
PUDUCHERRY,2001,By touching electric wires,0,0,0,0,0,0,0,0,0,0,0,0,0
PUDUCHERRY,2001,By coming under running vehicles/trains,0,0,0,0,0,0,0,0,0,0,0,0,0
PUDUCHERRY,2001,By Other means (please specify),0,0,0,0,0,0,0,0,0,0,0,0,0
PUDUCHERRY,2001,Total,2,82,115,84,40,323,6,120,51,22,7,206,529
PUDUCHERRY,2001,Total (Poison),1,27,37,20,8,93,1,31,13,6,2,53,146
PUDUCHERRY,2001,Total (Jumping),0,1,0,0,0,1,0,0,0,0,0,0,1
PUDUCHERRY,2002,By Over Alcoholism,0,0,0,0,0,0,0,0,0,0,0,0,0
PUDUCHERRY,2002,By Drowning,1,2,3,1,2,9,0,1,1,1,3,6,15
PUDUCHERRY,2002,By Fire/Self Immolation,1,6,6,4,3,20,1,12,12,5,1,31,51
PUDUCHERRY,2002,By Fire-Arms,0,0,0,0,0,0,0,0,0,0,0,0,0
PUDUCHERRY,2002,By Hanging,2,55,107,69,27,260,2,45,22,13,11,93,353
PUDUCHERRY,2002,By Consuming Insecticides,1,23,36,29,4,93,0,11,2,0,1,14,107
PUDUCHERRY,2002,By Consuming Other Poison,0,11,5,6,3,25,0,5,4,3,0,12,37
PUDUCHERRY,2002,By Self Infliction of injury,0,0,0,0,0,0,0,0,0,0,0,0,0
PUDUCHERRY,2002,By Jumping from (Building),0,0,1,0,0,1,0,0,0,0,0,0,1
PUDUCHERRY,2002,By Jumping from (Other sites),0,0,0,0,0,0,0,0,0,0,0,0,0
PUDUCHERRY,2002,By Jumping off Moving Vehicles/Trains,0,0,0,0,0,0,0,0,0,0,0,0,0
PUDUCHERRY,2002,By Machine,0,0,0,0,0,0,0,0,0,0,0,0,0
PUDUCHERRY,2002,By Overdose of sleeping pills,0,1,1,0,0,2,0,0,0,1,0,1,3
PUDUCHERRY,2002,By touching electric wires,0,0,0,0,0,0,0,0,0,0,0,0,0
PUDUCHERRY,2002,By coming under running vehicles/trains,0,0,0,0,0,0,0,0,0,0,0,0,0
PUDUCHERRY,2002,By Other means,0,0,0,0,0,0,0,0,0,0,0,0,0
PUDUCHERRY,2002,Total,5,98,159,109,39,410,3,74,41,23,16,157,567
PUDUCHERRY,2002,Total (Poison),1,34,41,35,7,118,0,16,6,3,1,26,144
PUDUCHERRY,2002,Total (Jumping),0,0,1,0,0,1,0,0,0,0,0,0,1
PUDUCHERRY,2003,By Over Alcoholism,0,0,0,0,0,0,0,0,0,0,0,0,0
PUDUCHERRY,2003,By Drowning,0,1,0,1,0,2,0,2,0,0,1,3,5
PUDUCHERRY,2003,By Fire/Self Immolation,0,5,5,2,1,13,0,31,10,3,3,47,60
PUDUCHERRY,2003,By Fire-Arms,0,0,0,0,0,0,0,0,0,0,0,0,0
PUDUCHERRY,2003,By Hanging,4,68,97,65,24,258,0,70,16,9,10,105,363
PUDUCHERRY,2003,By Consuming Insecticides,0,28,27,13,7,75,0,8,3,1,2,14,89
PUDUCHERRY,2003,By Consuming Other Poison,0,12,15,7,4,38,0,14,3,4,2,23,61
PUDUCHERRY,2003,By Self Infliction of injury,0,0,1,0,0,1,0,0,0,1,0,1,2
PUDUCHERRY,2003,By Jumping from (Building),0,0,0,0,0,0,0,0,0,0,0,0,0
PUDUCHERRY,2003,By Jumping from (Other sites),0,0,0,0,0,0,0,0,0,0,0,0,0
PUDUCHERRY,2003,By Jumping off Moving Vehicles/Trains,0,0,0,0,0,0,0,0,0,0,0,0,0
PUDUCHERRY,2003,By Machine,0,0,0,0,0,0,0,0,0,0,0,0,0
PUDUCHERRY,2003,By Overdose of sleeping pills,0,0,1,0,0,1,0,1,0,0,0,1,2
PUDUCHERRY,2003,By touching electric wires,0,0,0,0,0,0,0,0,0,0,0,0,0
PUDUCHERRY,2003,By coming under running vehicles/trains,0,0,0,0,0,0,0,0,0,0,0,0,0
PUDUCHERRY,2003,By Other means (please specify),0,0,0,0,0,0,0,0,0,0,0,0,0
PUDUCHERRY,2003,Total,4,114,146,88,36,388,0,126,32,18,18,194,582
PUDUCHERRY,2003,Total (Poison),0,40,43,20,11,114,0,22,6,6,4,38,152
PUDUCHERRY,2003,Total (Jumping),0,0,0,0,0,0,0,0,0,0,0,0,0
PUDUCHERRY,2004,By Over Alcoholism,0,0,0,0,0,0,0,0,0,0,0,0,0
PUDUCHERRY,2004,By Drowning,0,0,0,0,0,0,0,0,0,0,0,0,0
PUDUCHERRY,2004,By Fire/Self Immolation,0,6,8,5,0,19,2,16,12,4,3,37,56
PUDUCHERRY,2004,By Fire-Arms,0,0,0,0,0,0,0,0,0,0,0,0,0
PUDUCHERRY,2004,By Hanging,1,51,78,76,22,228,2,61,42,11,10,126,354
PUDUCHERRY,2004,By Consuming Insecticides,0,20,31,17,9,77,0,13,8,5,1,27,104
PUDUCHERRY,2004,By Consuming Other Poison,0,4,2,1,0,7,0,5,2,0,1,8,15
PUDUCHERRY,2004,By Self Infliction of injury,0,0,0,0,0,0,0,1,1,0,0,2,2
PUDUCHERRY,2004,By Jumping from (Building),0,0,1,0,0,1,0,0,0,0,0,0,1
PUDUCHERRY,2004,By Jumping from (Other sites),0,0,0,1,0,1,0,0,0,0,0,0,1
PUDUCHERRY,2004,By Jumping off Moving Vehicles/Trains,0,0,0,1,0,1,0,0,0,0,0,0,1
PUDUCHERRY,2004,By Machine,0,0,0,0,0,0,0,0,0,0,0,0,0
PUDUCHERRY,2004,By Overdose of sleeping pills,0,1,1,1,1,4,0,1,0,0,0,1,5
PUDUCHERRY,2004,By touching electric wires,0,0,0,0,0,0,0,0,0,0,0,0,0
PUDUCHERRY,2004,By coming under running vehicles/trains,0,0,0,0,0,0,0,0,0,0,0,0,0
PUDUCHERRY,2004,By Other means (please specify),0,0,0,0,0,0,0,0,0,0,0,0,0
PUDUCHERRY,2004,Total,1,82,121,102,32,338,4,97,65,20,15,201,539
PUDUCHERRY,2004,Total (Poison),0,24,33,18,9,84,0,19,11,5,2,37,121
PUDUCHERRY,2004,Total (Jumping),0,0,1,1,0,2,0,0,0,0,0,0,2
PUDUCHERRY,2005,By Over Alcoholism,0,0,0,0,0,0,0,0,0,0,0,0,0
PUDUCHERRY,2005,By Drowning,0,0,0,0,0,0,0,0,0,0,0,0,0
PUDUCHERRY,2005,By Fire/Self Immolation,0,7,5,1,1,14,0,20,17,4,6,47,61
PUDUCHERRY,2005,By Fire-Arms,0,0,0,0,0,0,0,0,0,0,0,0,0
PUDUCHERRY,2005,By Hanging,0,47,86,91,26,250,1,62,27,12,11,113,363
PUDUCHERRY,2005,By Consuming Insecticides,0,13,21,11,2,47,1,9,4,0,0,14,61
PUDUCHERRY,2005,By Consuming Other Poison,1,8,15,2,0,26,0,9,8,1,0,18,44
PUDUCHERRY,2005,By Self Infliction of injury,0,0,1,0,0,1,0,1,0,1,0,2,3
PUDUCHERRY,2005,By Jumping from (Building),0,0,0,0,1,1,0,0,0,0,0,0,1
PUDUCHERRY,2005,By Jumping from (Other sites),0,0,1,0,0,1,0,0,0,1,3,4,5
PUDUCHERRY,2005,By Jumping off Moving Vehicles/Trains,0,0,0,0,0,0,0,0,0,0,0,0,0
PUDUCHERRY,2005,By Machine,0,0,0,0,0,0,0,0,0,0,0,0,0
PUDUCHERRY,2005,By Overdose of sleeping pills,0,0,0,0,0,0,0,0,0,0,0,0,0
PUDUCHERRY,2005,By touching electric wires,0,0,0,0,0,0,0,0,0,0,0,0,0
PUDUCHERRY,2005,By coming under running vehicles/trains,0,0,0,0,0,0,0,0,0,0,0,0,0
PUDUCHERRY,2005,By Other means (please specify),0,0,0,0,0,0,0,0,0,0,0,0,0
PUDUCHERRY,2005,Total,1,75,129,105,30,340,2,101,56,19,20,198,538
PUDUCHERRY,2005,Total (Poison),1,21,37,13,2,74,1,19,12,2,0,34,108
PUDUCHERRY,2005,Total (Jumping),0,0,1,0,1,2,0,0,0,1,3,4,6
PUDUCHERRY,2006,By Over Alcoholism,0,0,0,0,1,1,0,0,0,0,0,0,1
PUDUCHERRY,2006,By Drowning,0,0,0,0,0,0,0,0,0,0,0,0,0
PUDUCHERRY,2006,By Fire/Self Immolation,1,7,6,2,1,17,1,35,10,2,2,50,67
PUDUCHERRY,2006,By Fire-Arms,0,0,0,0,0,0,0,0,0,0,0,0,0
PUDUCHERRY,2006,By Hanging,2,55,100,68,26,251,7,48,20,11,9,95,346
PUDUCHERRY,2006,By Consuming Insecticides,1,12,12,16,2,43,0,7,3,1,0,11,54
PUDUCHERRY,2006,By Consuming Other Poison,1,8,15,6,0,30,0,11,5,0,0,16,46
PUDUCHERRY,2006,By Self Infliction of injury,0,0,1,0,0,1,0,0,0,0,0,0,1
PUDUCHERRY,2006,By Jumping from (Building),0,0,0,0,0,0,0,0,0,0,0,0,0
PUDUCHERRY,2006,By Jumping from (Other sites),0,0,2,0,0,2,0,1,0,0,2,3,5
PUDUCHERRY,2006,By Jumping off Moving Vehicles/Trains,0,0,0,0,0,0,0,0,0,0,0,0,0
PUDUCHERRY,2006,By Machine,0,0,0,0,0,0,0,0,0,0,0,0,0
PUDUCHERRY,2006,By Overdose of sleeping pills,0,2,1,0,0,3,0,1,0,1,0,2,5
PUDUCHERRY,2006,By touching electric wires,0,0,0,0,0,0,0,0,0,0,0,0,0
PUDUCHERRY,2006,By coming under running vehicles/trains,0,0,0,1,0,1,0,0,0,0,0,0,1
PUDUCHERRY,2006,By Other means (please specify),0,0,0,0,0,0,0,0,0,0,0,0,0
PUDUCHERRY,2006,Total,5,84,137,93,30,349,8,103,38,15,13,177,526
PUDUCHERRY,2006,Total (Poison),2,20,28,22,2,74,0,18,8,1,0,27,101
PUDUCHERRY,2006,Total (Jumping),0,0,2,0,0,2,0,1,0,0,2,3,5
PUDUCHERRY,2007,By Over Alcoholism,0,0,0,0,0,0,0,0,0,0,0,0,0
PUDUCHERRY,2007,By Drowning,0,0,1,2,0,3,0,0,2,0,1,3,6
PUDUCHERRY,2007,By Fire/Self Immolation,0,5,12,5,1,23,2,27,21,2,5,57,80
PUDUCHERRY,2007,By Fire-Arms,0,0,0,0,0,0,0,0,0,0,0,0,0
PUDUCHERRY,2007,By Hanging,2,54,107,66,15,244,3,67,24,5,5,104,348
PUDUCHERRY,2007,By Consuming Insecticides,0,7,9,10,5,31,1,9,2,0,0,12,43
PUDUCHERRY,2007,By Consuming Other Poison,0,5,2,3,2,12,0,16,3,1,0,20,32
PUDUCHERRY,2007,By Self Infliction of injury,0,0,1,1,0,2,0,0,0,0,0,0,2
PUDUCHERRY,2007,By Jumping from (Building),0,1,0,1,0,2,0,1,0,0,0,1,3
PUDUCHERRY,2007,By Jumping from (Other sites),0,0,1,0,0,1,0,0,0,0,1,1,2
PUDUCHERRY,2007,By Jumping off Moving Vehicles/Trains,0,1,0,0,0,1,0,0,0,0,0,0,1
PUDUCHERRY,2007,By Machine,0,0,0,0,0,0,0,0,0,0,0,0,0
PUDUCHERRY,2007,By Overdose of sleeping pills,0,0,0,0,0,0,0,0,0,0,0,0,0
PUDUCHERRY,2007,By touching electric wires,0,0,0,0,0,0,0,0,0,0,0,0,0
PUDUCHERRY,2007,By coming under running vehicles/trains,0,0,0,0,0,0,0,0,0,0,0,0,0
PUDUCHERRY,2007,By Other means (please specify),0,0,0,0,0,0,0,0,0,0,0,0,0
PUDUCHERRY,2007,Total,2,73,133,88,23,319,6,120,52,8,12,198,517
PUDUCHERRY,2007,Total (Poison),0,12,12,14,7,45,1,25,5,1,0,32,77
PUDUCHERRY,2007,Total (Jumping),0,1,1,1,0,3,0,1,0,0,1,2,5
PUDUCHERRY,2008,By Over Alcoholism,0,0,0,0,0,0,0,0,0,0,0,0,0
PUDUCHERRY,2008,By Drowning,0,0,0,0,0,0,0,1,0,0,0,1,1
PUDUCHERRY,2008,By Fire/Self Immolation,0,7,12,1,3,23,0,35,17,4,4,60,83
PUDUCHERRY,2008,By Fire-Arms,0,0,0,0,0,0,0,0,0,0,0,0,0
PUDUCHERRY,2008,By Hanging,1,59,92,77,20,249,0,49,19,3,8,79,328
PUDUCHERRY,2008,By Consuming Insecticides,0,14,11,11,3,39,0,6,4,1,0,11,50
PUDUCHERRY,2008,By Consuming Other Poison,1,9,5,5,0,20,0,13,6,1,0,20,40
PUDUCHERRY,2008,By Self Infliction of injury,0,1,0,0,0,1,0,0,0,0,1,1,2
PUDUCHERRY,2008,By Jumping from (Building),0,0,0,0,0,0,0,0,0,0,0,0,0
PUDUCHERRY,2008,By Jumping from (Other sites),0,0,0,0,0,0,0,1,0,0,0,1,1
PUDUCHERRY,2008,By Jumping off Moving Vehicles/Trains,0,0,1,0,0,1,0,0,0,0,0,0,1
PUDUCHERRY,2008,By Machine,0,0,0,0,0,0,0,0,0,0,0,0,0
PUDUCHERRY,2008,By Overdose of sleeping pills,0,0,1,0,0,1,0,0,0,0,0,0,1
PUDUCHERRY,2008,By touching electric wires,0,0,0,0,0,0,0,0,0,0,0,0,0
PUDUCHERRY,2008,By coming under running vehicles/trains,0,0,0,0,0,0,0,0,0,0,0,0,0
PUDUCHERRY,2008,By Other means (please specify),0,0,0,0,0,0,0,0,0,0,0,0,0
PUDUCHERRY,2008,Total,2,90,122,94,26,334,0,105,46,9,13,173,507
PUDUCHERRY,2008,Total (Poison),1,24,16,16,3,60,0,19,10,2,1,32,92
PUDUCHERRY,2008,Total (Jumping),0,0,0,0,0,0,0,1,0,0,0,1,1
PUDUCHERRY,2009,By Over Alcoholism,0,0,0,0,0,0,0,0,0,0,0,0,0
PUDUCHERRY,2009,By Drowning,0,0,0,0,2,2,0,2,0,1,7,10,12
PUDUCHERRY,2009,By Fire/Self Immolation,1,8,8,2,3,22,1,36,15,0,2,54,76
PUDUCHERRY,2009,By Fire-Arms,0,0,0,0,0,0,0,0,0,0,0,0,0
PUDUCHERRY,2009,By Hanging,1,64,66,81,30,242,3,54,23,14,3,97,339
PUDUCHERRY,2009,By Consuming Insecticides,0,8,14,12,2,36,0,1,2,3,1,7,43
PUDUCHERRY,2009,By Consuming Other Poison,0,10,3,6,1,20,0,8,5,8,0,21,41
PUDUCHERRY,2009,By Self Infliction of injury,0,1,0,1,0,2,0,0,0,0,0,0,2
PUDUCHERRY,2009,By Jumping from (Building),0,0,1,1,0,2,0,1,0,0,0,1,3
PUDUCHERRY,2009,By Jumping from (Other sites),0,0,0,0,0,0,0,0,0,0,0,0,0
PUDUCHERRY,2009,By Jumping off Moving Vehicles/Trains,0,0,0,0,0,0,0,0,0,0,0,0,0
PUDUCHERRY,2009,By Machine,0,0,0,0,0,0,0,0,0,0,0,0,0
PUDUCHERRY,2009,By Overdose of sleeping pills,0,0,0,0,0,0,0,1,0,1,0,2,2
PUDUCHERRY,2009,By touching electric wires,0,0,0,0,0,0,0,0,0,0,0,0,0
PUDUCHERRY,2009,By coming under running vehicles/trains,0,0,0,0,0,0,0,0,0,0,0,0,0
PUDUCHERRY,2009,By Other means (please specify),0,0,0,0,0,0,0,0,0,0,0,0,0
PUDUCHERRY,2009,Total,2,91,92,103,38,326,4,103,45,27,13,192,518
PUDUCHERRY,2009,Total (Poison),0,19,17,19,3,58,0,9,7,11,1,28,86
PUDUCHERRY,2009,Total (Jumping),0,0,1,1,0,2,0,1,0,0,0,1,3
PUDUCHERRY,2010,By Over Alcoholism,0,0,0,0,0,0,0,0,0,0,0,0,0
PUDUCHERRY,2010,By Drowning,0,0,1,0,0,1,0,0,0,0,0,0,1
PUDUCHERRY,2010,By Fire/Self Immolation,0,5,6,7,0,18,1,39,11,4,4,59,77
PUDUCHERRY,2010,By Fire-Arms,0,0,0,0,0,0,0,0,0,0,0,0,0
PUDUCHERRY,2010,By Hanging,2,48,116,68,23,257,2,49,25,6,11,93,350
PUDUCHERRY,2010,By Consuming Insecticides,0,12,10,13,1,36,0,2,1,0,2,5,41
PUDUCHERRY,2010,By Consuming Other Poison,0,2,7,2,1,12,0,7,0,0,0,7,19
PUDUCHERRY,2010,By Self Infliction of injury,0,0,0,2,0,2,0,0,0,1,0,1,3
PUDUCHERRY,2010,By Jumping from (Building),0,0,0,0,0,0,0,0,0,0,0,0,0
PUDUCHERRY,2010,By Jumping from (Other sites),0,3,1,3,0,7,0,0,2,0,2,4,11
PUDUCHERRY,2010,By Jumping off Moving Vehicles/Trains,0,0,0,0,0,0,0,0,0,0,0,0,0
PUDUCHERRY,2010,By Machine,0,0,0,0,0,0,0,0,0,0,0,0,0
PUDUCHERRY,2010,By Overdose of sleeping pills,0,0,0,0,0,0,0,2,3,1,0,6,6
PUDUCHERRY,2010,By touching electric wires,0,0,0,0,0,0,0,0,0,0,0,0,0
PUDUCHERRY,2010,By coming under running vehicles/trains,0,0,0,0,0,0,0,0,0,0,0,0,0
PUDUCHERRY,2010,By Other means (please specify),0,0,0,0,0,0,0,0,0,0,0,0,0
PUDUCHERRY,2010,Total,2,70,141,95,25,333,3,99,42,12,19,175,508
PUDUCHERRY,2010,Total (Poison),0,14,17,17,2,50,0,9,1,1,2,13,63
PUDUCHERRY,2010,Total (Jumping),0,3,1,3,0,7,0,0,2,0,2,4,11
PUDUCHERRY,2011,By Over Alcoholism,0,0,0,0,0,0,0,0,0,0,0,0,0
PUDUCHERRY,2011,By Drowning,0,1,2,1,0,4,0,0,0,0,1,1,5
PUDUCHERRY,2011,By Fire/Self Immolation,0,5,4,5,1,15,0,21,9,3,4,37,52
PUDUCHERRY,2011,By Fire-Arms,0,0,0,0,0,0,0,0,0,0,0,0,0
PUDUCHERRY,2011,By Hanging,2,73,116,94,25,310,6,56,17,6,9,94,404
PUDUCHERRY,2011,By Consuming Insecticides,0,4,14,16,6,40,1,3,2,3,0,9,49
PUDUCHERRY,2011,By Consuming Other Poison,0,8,6,6,3,23,0,6,5,5,2,18,41
PUDUCHERRY,2011,By Self Infliction of injury,0,0,0,0,0,0,0,0,0,0,0,0,0
PUDUCHERRY,2011,By Jumping from (Building),0,0,0,0,0,0,0,0,1,0,0,1,1
PUDUCHERRY,2011,By Jumping from (Other sites),0,0,0,0,0,0,0,0,0,0,0,0,0
PUDUCHERRY,2011,By Jumping off Moving Vehicles/Trains,0,2,1,0,0,3,0,0,0,0,1,1,4
PUDUCHERRY,2011,By Machine,0,0,0,0,0,0,0,0,0,0,0,0,0
PUDUCHERRY,2011,By Overdose of sleeping pills,0,0,0,0,0,0,0,0,0,0,0,0,0
PUDUCHERRY,2011,By touching electric wires,0,0,1,0,0,1,0,0,0,0,0,0,1
PUDUCHERRY,2011,By coming under running vehicles/trains,0,0,0,0,0,0,0,0,0,0,0,0,0
PUDUCHERRY,2011,By Other means (please specify),0,0,0,0,0,0,0,0,0,0,0,0,0
PUDUCHERRY,2011,Total,2,93,144,122,35,396,7,86,34,17,17,161,557
PUDUCHERRY,2011,Total (Poison),0,12,20,22,9,63,1,9,7,8,2,27,90
PUDUCHERRY,2011,Total (Jumping),0,0,0,0,0,0,0,0,1,0,0,1,1
PUDUCHERRY,2012,By Over Alcoholism,0,0,0,0,0,0,0,0,0,0,0,0,0
PUDUCHERRY,2012,By Drowning,0,0,0,0,0,0,0,0,0,0,0,0,0
PUDUCHERRY,2012,By Fire/Self Immolation,0,5,7,1,0,13,1,21,11,5,0,38,51
PUDUCHERRY,2012,By Fire-Arms,0,0,0,0,0,0,0,0,0,0,0,0,0
PUDUCHERRY,2012,By Hanging,0,69,103,90,39,301,2,41,37,11,16,107,408
PUDUCHERRY,2012,By Consuming Insecticides,0,4,7,4,4,19,0,1,3,2,0,6,25
PUDUCHERRY,2012,By Consuming Other Poison,0,10,5,6,4,25,1,8,1,2,0,12,37
PUDUCHERRY,2012,By Self Infliction of injury,0,1,0,0,0,1,0,0,0,0,0,0,1
PUDUCHERRY,2012,By Jumping from (Building),0,0,0,0,0,0,0,0,0,0,0,0,0
PUDUCHERRY,2012,By Jumping from (Other sites),0,2,3,0,2,7,0,2,2,0,1,5,12
PUDUCHERRY,2012,By Jumping off Moving Vehicles/Trains,0,0,0,0,0,0,0,0,0,0,0,0,0
PUDUCHERRY,2012,By Machine,0,0,0,0,0,0,0,0,0,0,0,0,0
PUDUCHERRY,2012,By Overdose of sleeping pills,0,0,0,0,0,0,0,0,0,0,0,0,0
PUDUCHERRY,2012,By touching electric wires,0,0,0,0,0,0,0,0,0,0,0,0,0
PUDUCHERRY,2012,By coming under running vehicles/trains,0,1,2,2,0,5,0,0,0,0,1,1,6
PUDUCHERRY,2012,By Other means (please specify),1,0,0,0,0,1,0,0,0,0,0,0,1
PUDUCHERRY,2012,Total,1,92,127,103,49,372,4,73,54,20,18,169,541
PUDUCHERRY,2012,Total (Poison),0,15,12,10,8,45,1,9,4,4,0,18,63
PUDUCHERRY,2012,Total (Jumping),0,2,3,0,2,7,0,2,2,0,1,5,12
TOTAL (UTs),2001,By Over Alcoholism,0,5,2,4,2,13,0,0,0,0,1,1,14
TOTAL (UTs),2001,By Drowning,2,9,4,4,1,20,3,4,3,1,0,11,31
TOTAL (UTs),2001,By Fire/Self Immolation,2,34,35,3,2,76,5,112,63,19,5,204,280
TOTAL (UTs),2001,By Fire-Arms,0,6,9,1,1,17,2,4,2,0,0,8,25
TOTAL (UTs),2001,By Hanging,7,251,238,148,52,696,11,223,103,20,10,367,1063
TOTAL (UTs),2001,By Consuming Insecticides,1,51,55,19,5,131,6,28,20,4,3,61,192
TOTAL (UTs),2001,By Consuming Other Poison,6,77,55,28,8,174,6,78,28,13,0,125,299
TOTAL (UTs),2001,By Self Infliction of injury,0,2,2,4,1,9,0,3,1,0,0,4,13
TOTAL (UTs),2001,By Jumping from (Building),0,3,1,3,1,8,0,1,2,0,1,4,12
TOTAL (UTs),2001,By Jumping from (Other sites),0,1,2,1,3,7,0,0,1,1,0,2,9
TOTAL (UTs),2001,By Jumping off Moving Vehicles/Trains,0,2,4,1,0,7,0,2,0,0,0,2,9
TOTAL (UTs),2001,By Machine,0,0,0,0,0,0,0,0,0,0,0,0,0
TOTAL (UTs),2001,By Overdose of sleeping pills,0,0,1,2,0,3,0,2,0,0,0,2,5
TOTAL (UTs),2001,By touching electric wires,0,2,0,0,0,2,0,1,0,0,0,1,3
TOTAL (UTs),2001,By coming under running vehicles/trains,0,0,1,1,0,2,0,1,0,0,0,1,3
TOTAL (UTs),2001,By Other means (please specify),1,13,20,10,7,51,4,5,9,3,1,22,73
TOTAL (UTs),2001,Total,19,456,429,229,83,1216,37,464,232,61,21,815,2031
TOTAL (UTs),2001,Total (Poison),7,130,112,51,14,314,12,109,49,17,3,190,504
TOTAL (UTs),2001,Total (Jumping),0,4,3,4,4,15,0,1,3,1,1,6,21
TOTAL (UTs),2002,By Over Alcoholism,0,6,3,1,0,10,0,0,0,0,0,0,10
TOTAL (UTs),2002,By Drowning,1,5,8,3,2,19,0,3,4,2,3,12,31
TOTAL (UTs),2002,By Fire/Self Immolation,1,35,29,8,5,78,2,80,47,10,5,144,222
TOTAL (UTs),2002,By Fire-Arms,0,5,5,1,0,11,0,1,0,0,0,1,12
TOTAL (UTs),2002,By Hanging,14,254,272,130,47,717,14,178,79,23,13,307,1024
TOTAL (UTs),2002,By Consuming Insecticides,2,56,63,41,6,168,3,40,16,10,2,71,239
TOTAL (UTs),2002,By Consuming Other Poison,5,79,53,33,12,182,1,71,41,9,4,126,308
TOTAL (UTs),2002,By Self Infliction of injury,0,3,2,2,0,7,0,0,0,0,0,0,7
TOTAL (UTs),2002,By Jumping from (Building),0,5,3,4,0,12,0,1,0,0,0,1,13
TOTAL (UTs),2002,By Jumping from (Other sites),0,1,3,1,0,5,0,0,1,0,0,1,6
TOTAL (UTs),2002,By Jumping off Moving Vehicles/Trains,0,0,1,0,0,1,0,0,0,0,0,0,1
TOTAL (UTs),2002,By Machine,0,0,1,0,0,1,0,0,0,0,0,0,1
TOTAL (UTs),2002,By Overdose of sleeping pills,0,1,3,3,0,7,0,0,0,1,0,1,8
TOTAL (UTs),2002,By touching electric wires,0,4,0,4,1,9,0,0,1,0,0,1,10
TOTAL (UTs),2002,By coming under running vehicles/trains,1,4,1,4,1,11,1,3,2,0,0,6,17
TOTAL (UTs),2002,By Other means (please specify),0,4,1,1,0,6,1,1,1,0,0,3,9
TOTAL (UTs),2002,Total,24,462,448,236,74,1244,22,378,192,55,27,674,1918
TOTAL (UTs),2002,Total (Poison),7,138,118,76,18,357,4,111,57,19,6,197,554
TOTAL (UTs),2002,Total (Jumping),0,6,6,5,0,17,0,1,1,0,0,2,19
TOTAL (UTs),2003,By Over Alcoholism,0,6,0,0,0,6,0,2,0,0,0,2,8
TOTAL (UTs),2003,By Drowning,2,2,2,1,1,8,0,3,0,0,1,4,12
TOTAL (UTs),2003,By Fire/Self Immolation,3,23,17,7,4,54,0,79,36,12,5,132,186
TOTAL (UTs),2003,By Fire-Arms,0,19,22,9,2,52,0,7,4,1,0,12,64
TOTAL (UTs),2003,By Hanging,8,279,295,132,47,761,9,211,75,22,13,330,1091
TOTAL (UTs),2003,By Consuming Insecticides,2,51,43,17,7,120,1,20,10,6,2,39,159
TOTAL (UTs),2003,By Consuming Other Poison,5,90,75,27,11,208,8,56,27,11,3,105,313
TOTAL (UTs),2003,By Self Infliction of injury,0,1,2,2,0,5,0,1,0,1,0,2,7
TOTAL (UTs),2003,By Jumping from (Building),0,9,7,7,5,28,0,10,3,13,0,26,54
TOTAL (UTs),2003,By Jumping from (Other sites),0,3,2,0,0,5,0,0,1,1,0,2,7
TOTAL (UTs),2003,By Jumping off Moving Vehicles/Trains,1,1,1,1,0,4,0,1,0,1,0,2,6
TOTAL (UTs),2003,By Machine,0,0,0,0,0,0,0,0,0,0,0,0,0
TOTAL (UTs),2003,By Overdose of sleeping pills,0,0,5,0,0,5,0,1,0,0,0,1,6
TOTAL (UTs),2003,By touching electric wires,0,7,3,0,1,11,0,1,0,1,0,2,13
TOTAL (UTs),2003,By coming under running vehicles/trains,0,6,0,2,0,8,1,4,0,0,1,6,14
TOTAL (UTs),2003,By Other means (please specify),5,13,16,7,0,41,5,25,13,4,1,48,89
TOTAL (UTs),2003,Total,26,510,490,212,78,1316,24,421,169,73,26,713,2029
TOTAL (UTs),2003,Total (Poison),7,142,120,46,18,333,9,77,37,18,5,146,479
TOTAL (UTs),2003,Total (Jumping),0,12,9,7,5,33,0,10,4,14,0,28,61
TOTAL (UTs),2004,By Over Alcoholism,0,1,0,0,0,1,0,0,0,0,0,0,1
TOTAL (UTs),2004,By Drowning,1,3,3,2,0,9,0,0,0,2,0,2,11
TOTAL (UTs),2004,By Fire/Self Immolation,0,20,24,17,2,63,4,62,34,7,7,114,177
TOTAL (UTs),2004,By Fire-Arms,1,2,2,3,1,9,0,3,1,2,0,6,15
TOTAL (UTs),2004,By Hanging,14,331,270,147,44,806,16,241,112,23,22,414,1220
TOTAL (UTs),2004,By Consuming Insecticides,0,26,42,20,9,97,0,24,10,6,1,41,138
TOTAL (UTs),2004,By Consuming Other Poison,3,59,56,16,2,136,1,67,21,6,1,96,232
TOTAL (UTs),2004,By Self Infliction of injury,0,1,3,0,0,4,0,1,1,0,2,4,8
TOTAL (UTs),2004,By Jumping from (Building),0,0,2,0,0,2,0,1,0,0,0,1,3
TOTAL (UTs),2004,By Jumping from (Other sites),0,3,4,2,0,9,0,7,0,0,0,7,16
TOTAL (UTs),2004,By Jumping off Moving Vehicles/Trains,0,2,3,4,0,9,0,3,1,0,0,4,13
TOTAL (UTs),2004,By Machine,0,0,0,0,0,0,0,0,0,0,0,0,0
TOTAL (UTs),2004,By Overdose of sleeping pills,0,2,1,1,1,5,0,1,0,0,0,1,6
TOTAL (UTs),2004,By touching electric wires,0,1,2,0,0,3,0,0,0,0,0,0,3
TOTAL (UTs),2004,By coming under running vehicles/trains,0,0,0,0,0,0,0,0,0,0,0,0,0
TOTAL (UTs),2004,By Other means (please specify),1,38,61,36,6,142,1,32,22,4,0,59,201
TOTAL (UTs),2004,Total,20,489,473,248,65,1295,22,442,202,50,33,749,2044
TOTAL (UTs),2004,Total (Poison),3,86,101,36,11,237,1,92,32,12,4,141,378
TOTAL (UTs),2004,Total (Jumping),0,3,6,2,0,11,0,8,0,0,0,8,19
TOTAL (UTs),2005,By Over Alcoholism,0,3,7,0,0,10,0,0,0,0,0,0,10
TOTAL (UTs),2005,By Drowning,0,18,11,4,1,34,0,6,2,0,0,8,42
TOTAL (UTs),2005,By Fire/Self Immolation,0,28,13,9,1,51,0,78,38,8,9,133,184
TOTAL (UTs),2005,By Fire-Arms,0,13,7,1,0,21,0,1,0,0,0,1,22
TOTAL (UTs),2005,By Hanging,9,325,302,191,65,892,12,244,111,40,16,423,1315
TOTAL (UTs),2005,By Consuming Insecticides,2,31,31,13,2,79,1,35,15,5,2,58,137
TOTAL (UTs),2005,By Consuming Other Poison,2,67,55,19,5,148,1,38,32,7,2,80,228
TOTAL (UTs),2005,By Self Infliction of injury,0,1,2,0,0,3,1,2,0,1,0,4,7
TOTAL (UTs),2005,By Jumping from (Building),0,7,7,2,1,17,0,2,1,1,0,4,21
TOTAL (UTs),2005,By Jumping from (Other sites),2,2,3,1,0,8,1,0,1,2,3,7,15
TOTAL (UTs),2005,By Jumping off Moving Vehicles/Trains,0,0,0,1,0,1,0,1,0,0,0,1,2
TOTAL (UTs),2005,By Machine,0,0,0,0,0,0,0,0,0,0,0,0,0
TOTAL (UTs),2005,By Overdose of sleeping pills,0,2,0,1,0,3,0,0,0,0,0,0,3
TOTAL (UTs),2005,By touching electric wires,0,1,3,2,0,6,1,1,1,0,0,3,9
TOTAL (UTs),2005,By coming under running vehicles/trains,0,2,1,1,1,5,0,2,0,0,0,2,7
TOTAL (UTs),2005,By Other means (please specify),2,19,10,22,1,54,2,31,19,2,2,56,110
TOTAL (UTs),2005,Total,17,519,452,267,77,1332,19,441,220,66,34,780,2112
TOTAL (UTs),2005,Total (Poison),4,99,88,32,7,230,3,75,47,13,4,142,372
TOTAL (UTs),2005,Total (Jumping),2,9,10,3,1,25,1,2,2,3,3,11,36
TOTAL (UTs),2006,By Over Alcoholism,0,9,4,2,1,16,0,0,0,0,0,0,16
TOTAL (UTs),2006,By Drowning,2,11,3,0,0,16,0,4,0,0,0,4,20
TOTAL (UTs),2006,By Fire/Self Immolation,1,28,37,13,6,85,2,95,34,6,4,141,226
TOTAL (UTs),2006,By Fire-Arms,0,4,6,1,1,12,0,0,1,0,0,1,13
TOTAL (UTs),2006,By Hanging,8,392,350,178,53,981,20,279,124,29,14,466,1447
TOTAL (UTs),2006,By Consuming Insecticides,2,39,33,22,3,99,1,29,13,4,2,49,148
TOTAL (UTs),2006,By Consuming Other Poison,2,73,60,18,2,155,5,53,25,3,0,86,241
TOTAL (UTs),2006,By Self Infliction of injury,1,3,3,0,1,8,0,1,0,0,0,1,9
TOTAL (UTs),2006,By Jumping from (Building),0,10,12,8,2,32,0,6,0,1,0,7,39
TOTAL (UTs),2006,By Jumping from (Other sites),2,5,8,0,0,15,0,2,0,0,2,4,19
TOTAL (UTs),2006,By Jumping off Moving Vehicles/Trains,0,5,0,3,0,8,0,4,1,0,0,5,13
TOTAL (UTs),2006,By Machine,0,0,1,0,0,1,0,0,0,0,0,0,1
TOTAL (UTs),2006,By Overdose of sleeping pills,0,4,1,2,2,9,0,1,0,1,0,2,11
TOTAL (UTs),2006,By touching electric wires,0,3,1,1,0,5,0,1,1,0,0,2,7
TOTAL (UTs),2006,By coming under running vehicles/trains,0,1,2,2,0,5,0,0,0,0,0,0,5
TOTAL (UTs),2006,By Other means (please specify),0,8,27,14,3,52,3,11,10,5,1,30,82
TOTAL (UTs),2006,Total,18,595,548,264,74,1499,31,486,209,49,23,798,2297
TOTAL (UTs),2006,Total (Poison),5,115,96,40,6,262,6,83,38,7,2,136,398
TOTAL (UTs),2006,Total (Jumping),2,15,20,8,2,47,0,8,0,1,2,11,58
TOTAL (UTs),2007,By Over Alcoholism,0,1,2,0,0,3,0,0,1,0,0,1,4
TOTAL (UTs),2007,By Drowning,0,1,4,2,2,9,1,2,3,0,1,7,16
TOTAL (UTs),2007,By Fire/Self Immolation,0,21,30,10,3,64,4,71,43,3,8,129,193
TOTAL (UTs),2007,By Fire-Arms,0,7,6,1,1,15,0,5,1,0,0,6,21
TOTAL (UTs),2007,By Hanging,11,415,405,160,45,1036,14,327,105,23,10,479,1515
TOTAL (UTs),2007,By Consuming Insecticides,0,18,19,14,5,56,1,21,6,3,0,31,87
TOTAL (UTs),2007,By Consuming Other Poison,1,59,50,31,14,155,4,70,30,6,2,112,267
TOTAL (UTs),2007,By Self Infliction of injury,0,2,3,1,2,8,1,0,0,1,0,2,10
TOTAL (UTs),2007,By Jumping from (Building),3,7,9,4,0,23,0,5,1,0,0,6,29
TOTAL (UTs),2007,By Jumping from (Other sites),0,2,3,2,0,7,1,1,0,0,2,4,11
TOTAL (UTs),2007,By Jumping off Moving Vehicles/Trains,0,1,1,0,0,2,0,0,0,0,0,0,2
TOTAL (UTs),2007,By Machine,0,1,0,3,0,4,0,0,0,0,0,0,4
TOTAL (UTs),2007,By Overdose of sleeping pills,0,2,1,0,0,3,0,0,0,0,0,0,3
TOTAL (UTs),2007,By touching electric wires,0,2,1,0,0,3,0,3,0,0,0,3,6
TOTAL (UTs),2007,By coming under running vehicles/trains,0,0,0,0,0,0,0,0,0,0,0,0,0
TOTAL (UTs),2007,By Other means (please specify),2,45,37,19,5,108,1,28,18,5,2,54,162
TOTAL (UTs),2007,Total,17,584,571,247,77,1496,27,533,208,41,25,834,2330
TOTAL (UTs),2007,Total (Poison),1,79,72,46,21,219,6,91,36,10,2,145,364
TOTAL (UTs),2007,Total (Jumping),3,9,12,6,0,30,1,6,1,0,2,10,40
TOTAL (UTs),2008,By Over Alcoholism,0,1,3,4,0,8,0,2,0,1,0,3,11
TOTAL (UTs),2008,By Drowning,1,1,1,3,0,6,0,2,0,0,2,4,10
TOTAL (UTs),2008,By Fire/Self Immolation,0,20,24,7,3,54,1,82,37,13,5,138,192
TOTAL (UTs),2008,By Fire-Arms,0,4,3,4,2,13,0,0,1,0,0,1,14
TOTAL (UTs),2008,By Hanging,11,388,341,165,43,948,12,311,103,26,12,464,1412
TOTAL (UTs),2008,By Consuming Insecticides,2,34,23,22,3,84,1,28,9,1,0,39,123
TOTAL (UTs),2008,By Consuming Other Poison,4,54,49,28,10,145,3,65,30,6,3,107,252
TOTAL (UTs),2008,By Self Infliction of injury,0,1,1,0,0,2,0,0,0,0,1,1,3
TOTAL (UTs),2008,By Jumping from (Building),0,10,9,4,0,23,0,5,1,0,1,7,30
TOTAL (UTs),2008,By Jumping from (Other sites),0,0,1,0,1,2,0,1,0,0,0,1,3
TOTAL (UTs),2008,By Jumping off Moving Vehicles/Trains,0,1,1,0,0,2,0,1,0,0,0,1,3
TOTAL (UTs),2008,By Machine,0,0,0,0,0,0,0,0,0,0,0,0,0
TOTAL (UTs),2008,By Overdose of sleeping pills,0,1,1,1,1,4,0,0,0,0,0,0,4
TOTAL (UTs),2008,By touching electric wires,0,1,2,0,0,3,0,0,0,0,0,0,3
TOTAL (UTs),2008,By coming under running vehicles/trains,0,0,0,1,0,1,0,0,0,0,0,0,1
TOTAL (UTs),2008,By Other means (please specify),1,13,15,3,4,36,1,10,6,1,0,18,54
TOTAL (UTs),2008,Total,19,529,474,242,67,1331,18,507,187,48,24,784,2115
TOTAL (UTs),2008,Total (Poison),6,89,73,50,13,231,4,93,39,7,4,147,378
TOTAL (UTs),2008,Total (Jumping),0,10,10,4,1,25,0,6,1,0,1,8,33
TOTAL (UTs),2009,By Over Alcoholism,0,2,2,4,1,9,0,0,0,0,0,0,9
TOTAL (UTs),2009,By Drowning,1,5,2,2,2,12,3,2,2,1,7,15,27
TOTAL (UTs),2009,By Fire/Self Immolation,1,28,24,12,6,71,3,70,50,4,5,132,203
TOTAL (UTs),2009,By Fire-Arms,0,8,5,1,1,15,0,0,1,0,0,1,16
TOTAL (UTs),2009,By Hanging,10,407,309,176,52,954,18,343,100,36,10,507,1461
TOTAL (UTs),2009,By Consuming Insecticides,0,26,24,14,2,66,0,12,4,3,3,22,88
TOTAL (UTs),2009,By Consuming Other Poison,3,90,49,25,6,173,2,67,28,14,4,115,288
TOTAL (UTs),2009,By Self Infliction of injury,0,3,0,1,0,4,0,1,0,0,0,1,5
TOTAL (UTs),2009,By Jumping from (Building),0,5,9,6,1,21,0,4,0,0,0,4,25
TOTAL (UTs),2009,By Jumping from (Other sites),0,3,1,0,1,5,0,1,0,0,0,1,6
TOTAL (UTs),2009,By Jumping off Moving Vehicles/Trains,0,4,1,2,1,8,0,0,1,0,0,1,9
TOTAL (UTs),2009,By Machine,0,0,0,0,0,0,0,0,0,0,0,0,0
TOTAL (UTs),2009,By Overdose of sleeping pills,0,0,0,0,0,0,0,3,0,1,0,4,4
TOTAL (UTs),2009,By touching electric wires,1,5,3,0,0,9,0,0,1,0,0,1,10
TOTAL (UTs),2009,By coming under running vehicles/trains,0,0,1,0,0,1,0,0,0,0,0,0,1
TOTAL (UTs),2009,By Other means (please specify),2,27,40,12,5,86,6,12,16,8,1,43,129
TOTAL (UTs),2009,Total,18,613,470,255,78,1434,32,515,203,67,30,847,2281
TOTAL (UTs),2009,Total (Poison),3,119,73,40,8,243,2,80,32,17,7,138,381
TOTAL (UTs),2009,Total (Jumping),0,8,10,6,2,26,0,5,0,0,0,5,31
TOTAL (UTs),2010,By Over Alcoholism,0,0,3,7,5,15,0,0,0,0,0,0,15
TOTAL (UTs),2010,By Drowning,1,14,12,0,3,30,1,9,3,1,1,15,45
TOTAL (UTs),2010,By Fire/Self Immolation,4,25,22,14,2,67,2,80,26,11,6,125,192
TOTAL (UTs),2010,By Fire-Arms,0,4,5,2,2,13,0,1,1,0,0,2,15
TOTAL (UTs),2010,By Hanging,15,392,390,166,68,1031,22,332,124,29,19,526,1557
TOTAL (UTs),2010,By Consuming Insecticides,1,52,43,25,4,125,1,30,16,2,3,52,177
TOTAL (UTs),2010,By Consuming Other Poison,2,48,32,22,9,113,1,59,26,6,1,93,206
TOTAL (UTs),2010,By Self Infliction of injury,0,2,1,2,0,5,0,1,0,1,0,2,7
TOTAL (UTs),2010,By Jumping from (Building),0,1,3,1,0,5,0,0,1,0,0,1,6
TOTAL (UTs),2010,By Jumping from (Other sites),0,5,5,3,0,13,2,3,2,0,2,9,22
TOTAL (UTs),2010,By Jumping off Moving Vehicles/Trains,0,4,5,2,0,11,0,2,0,0,0,2,13
TOTAL (UTs),2010,By Machine,0,0,0,0,0,0,0,0,0,0,0,0,0
TOTAL (UTs),2010,By Overdose of sleeping pills,0,0,0,0,0,0,0,2,3,1,0,6,6
TOTAL (UTs),2010,By touching electric wires,0,2,1,0,0,3,0,2,3,0,0,5,8
TOTAL (UTs),2010,By coming under running vehicles/trains,0,1,1,1,0,3,0,2,0,1,0,3,6
TOTAL (UTs),2010,By Other means (please specify),2,24,20,10,3,59,0,20,15,4,0,39,98
TOTAL (UTs),2010,Total,25,574,543,255,96,1493,29,543,220,56,32,880,2373
TOTAL (UTs),2010,Total (Poison),3,102,76,49,13,243,2,90,42,9,4,147,390
TOTAL (UTs),2010,Total (Jumping),0,6,8,4,0,18,2,3,3,0,2,10,28
TOTAL (UTs),2011,By Over Alcoholism,0,8,10,1,0,19,0,0,0,0,0,0,19
TOTAL (UTs),2011,By Drowning,2,11,8,3,1,25,0,2,1,0,1,4,29
TOTAL (UTs),2011,By Fire/Self Immolation,0,28,27,21,7,83,2,51,34,8,4,99,182
TOTAL (UTs),2011,By Fire-Arms,0,11,4,4,0,19,0,1,0,2,1,4,23
TOTAL (UTs),2011,By Hanging,15,540,420,196,47,1218,20,355,116,42,16,549,1767
TOTAL (UTs),2011,By Consuming Insecticides,0,17,21,18,8,64,1,12,5,3,2,23,87
TOTAL (UTs),2011,By Consuming Other Poison,2,107,57,27,12,205,3,50,31,11,7,102,307
TOTAL (UTs),2011,By Self Infliction of injury,0,7,2,4,0,13,0,1,0,0,0,1,14
TOTAL (UTs),2011,By Jumping from (Building),0,7,6,4,4,21,0,7,4,0,0,11,32
TOTAL (UTs),2011,By Jumping from (Other sites),0,3,0,0,0,3,0,0,0,0,0,0,3
TOTAL (UTs),2011,By Jumping off Moving Vehicles/Trains,0,2,1,0,0,3,0,0,0,0,1,1,4
TOTAL (UTs),2011,By Machine,0,0,0,0,0,0,0,0,0,0,0,0,0
TOTAL (UTs),2011,By Overdose of sleeping pills,0,0,3,0,1,4,0,0,0,0,0,0,4
TOTAL (UTs),2011,By touching electric wires,0,5,3,1,0,9,0,1,0,0,0,1,10
TOTAL (UTs),2011,By coming under running vehicles/trains,0,1,1,0,0,2,0,0,0,0,0,0,2
TOTAL (UTs),2011,By Other means (please specify),3,50,16,16,1,86,4,25,9,2,1,41,127
TOTAL (UTs),2011,Total,22,797,579,295,81,1774,30,505,200,68,33,836,2610
TOTAL (UTs),2011,Total (Poison),2,131,80,49,20,282,4,63,36,14,9,126,408
TOTAL (UTs),2011,Total (Jumping),0,10,6,4,4,24,0,7,4,0,0,11,35
TOTAL (UTs),2012,By Over Alcoholism,0,12,17,2,0,31,0,0,0,0,0,0,31
TOTAL (UTs),2012,By Drowning,2,6,7,3,0,18,0,5,1,0,2,8,26
TOTAL (UTs),2012,By Fire/Self Immolation,1,22,19,4,0,46,3,44,32,8,3,90,136
TOTAL (UTs),2012,By Fire-Arms,0,5,7,4,1,17,0,4,1,0,1,6,23
TOTAL (UTs),2012,By Hanging,24,594,461,204,70,1353,27,391,145,38,27,628,1981
TOTAL (UTs),2012,By Consuming Insecticides,0,6,10,7,6,29,0,4,5,2,0,11,40
TOTAL (UTs),2012,By Consuming Other Poison,2,80,56,27,15,180,7,67,35,14,3,126,306
TOTAL (UTs),2012,By Self Infliction of injury,0,8,2,1,1,12,0,8,2,0,0,10,22
TOTAL (UTs),2012,By Jumping from (Building),0,6,0,2,0,8,0,6,4,1,0,11,19
TOTAL (UTs),2012,By Jumping from (Other sites),0,9,4,3,2,18,0,6,3,0,1,10,28
TOTAL (UTs),2012,By Jumping off Moving Vehicles/Trains,0,2,3,0,2,7,0,2,1,0,0,3,10
TOTAL (UTs),2012,By Machine,0,0,0,0,0,0,0,0,1,0,0,1,1
TOTAL (UTs),2012,By Overdose of sleeping pills,0,1,0,3,0,4,0,2,1,0,0,3,7
TOTAL (UTs),2012,By touching electric wires,0,0,2,2,0,4,0,0,0,0,0,0,4
TOTAL (UTs),2012,By coming under running vehicles/trains,0,5,8,4,1,18,0,1,0,1,1,3,21
TOTAL (UTs),2012,By Other means (please specify),2,35,44,13,1,95,1,15,9,2,1,28,123
TOTAL (UTs),2012,Total,31,791,640,279,99,1840,38,555,240,66,39,938,2778
TOTAL (UTs),2012,Total (Poison),2,94,68,35,22,221,7,79,42,16,3,147,368
TOTAL (UTs),2012,Total (Jumping),0,15,4,5,2,26,0,12,7,1,1,21,47
TOTAL (ALL INDIA),2001,By Over Alcoholism,1,183,459,355,172,1170,0,32,36,42,11,121,1291
TOTAL (ALL INDIA),2001,By Drowning,277,1361,1630,954,473,4695,201,1533,962,509,353,3558,8253
TOTAL (ALL INDIA),2001,By Fire/Self Immolation,107,1074,1369,708,249,3507,170,3704,2277,803,361,7315,10822
TOTAL (ALL INDIA),2001,By Fire-Arms,12,107,74,53,22,268,3,75,29,15,5,127,395
TOTAL (ALL INDIA),2001,By Hanging,276,6097,7053,4558,1684,19668,283,4682,3107,1476,541,10089,29757
TOTAL (ALL INDIA),2001,By Consuming Insecticides,256,4268,4556,3200,1207,13487,297,3725,2541,1100,380,8043,21530
TOTAL (ALL INDIA),2001,By Consuming Other Poison,223,3896,4621,2892,945,12577,232,3361,2397,1149,346,7485,20062
TOTAL (ALL INDIA),2001,By Self Infliction of injury,10,58,150,104,52,374,2,74,43,17,10,146,520
TOTAL (ALL INDIA),2001,By Jumping from (Building),13,110,158,90,28,399,13,64,44,39,61,221,620
TOTAL (ALL INDIA),2001,By Jumping from (Other sites),21,132,186,102,39,480,16,89,89,33,21,248,728
TOTAL (ALL INDIA),2001,By Jumping off Moving Vehicles/Trains,5,152,188,104,68,517,10,54,53,29,8,154,671
TOTAL (ALL INDIA),2001,By Machine,5,88,73,32,3,201,3,5,5,1,2,16,217
TOTAL (ALL INDIA),2001,By Overdose of sleeping pills,11,143,236,191,112,693,7,113,93,93,89,395,1088
TOTAL (ALL INDIA),2001,By touching electric wires,17,271,249,193,90,820,16,68,60,41,28,213,1033
TOTAL (ALL INDIA),2001,By coming under running vehicles/trains,23,684,1093,647,256,2703,15,340,265,154,71,845,3548
TOTAL (ALL INDIA),2001,By Other means (please specify),241,1357,1408,1225,524,4755,241,1010,944,670,351,3216,7971
TOTAL (ALL INDIA),2001,Total,1498,19981,23503,15408,5924,66314,1509,18929,12945,6171,2638,42192,108506
TOTAL (ALL INDIA),2001,Total (Poison),489,8222,9327,6196,2204,26438,531,7160,4981,2266,736,15674,42112
TOTAL (ALL INDIA),2001,Total (Jumping),34,242,344,192,67,879,29,153,133,72,82,469,1348
TOTAL (ALL INDIA),2002,By Over Alcoholism,0,196,484,420,141,1241,2,15,24,23,14,78,1319
TOTAL (ALL INDIA),2002,By Drowning,196,1397,1488,1040,500,4621,165,1387,1071,560,346,3529,8150
TOTAL (ALL INDIA),2002,By Fire/Self Immolation,56,1152,1305,773,274,3560,170,3514,2218,860,333,7095,10655
TOTAL (ALL INDIA),2002,By Fire-Arms,9,117,137,72,22,357,2,49,50,13,0,114,471
TOTAL (ALL INDIA),2002,By Hanging,272,6487,7810,4795,1912,21276,328,4793,3060,1370,558,10109,31385
TOTAL (ALL INDIA),2002,By Consuming Insecticides,205,4463,4886,3026,1136,13716,245,3595,2328,1101,429,7698,21414
TOTAL (ALL INDIA),2002,By Consuming Other Poison,206,3770,4337,3006,1166,12485,223,3279,2139,1104,375,7120,19605
TOTAL (ALL INDIA),2002,By Self Infliction of injury,3,86,111,113,58,371,2,48,60,36,10,156,527
TOTAL (ALL INDIA),2002,By Jumping from (Building),8,107,192,112,42,461,16,65,68,58,18,225,686
TOTAL (ALL INDIA),2002,By Jumping from (Other sites),21,148,186,117,47,519,19,75,90,40,37,261,780
TOTAL (ALL INDIA),2002,By Jumping off Moving Vehicles/Trains,8,111,178,109,62,468,8,51,31,13,9,112,580
TOTAL (ALL INDIA),2002,By Machine,2,78,54,34,4,172,2,8,3,0,0,13,185
TOTAL (ALL INDIA),2002,By Overdose of sleeping pills,7,138,201,123,78,547,10,119,125,79,60,393,940
TOTAL (ALL INDIA),2002,By touching electric wires,33,185,188,118,50,574,11,43,48,24,17,143,717
TOTAL (ALL INDIA),2002,By coming under running vehicles/trains,23,881,1167,669,285,3025,19,277,265,129,50,740,3765
TOTAL (ALL INDIA),2002,By Other means (please specify),257,1601,2087,1428,566,5939,352,1053,1121,492,281,3299,9238
TOTAL (ALL INDIA),2002,Total,1306,20917,24811,15955,6343,69332,1574,18371,12701,5902,2537,41085,110417
TOTAL (ALL INDIA),2002,Total (Poison),414,8319,9334,6145,2360,26572,470,6922,4527,2241,814,14974,41546
TOTAL (ALL INDIA),2002,Total (Jumping),29,255,378,229,89,980,35,140,158,98,55,486,1466
TOTAL (ALL INDIA),2003,By Over Alcoholism,5,185,425,330,87,1032,3,19,25,20,7,74,1106
TOTAL (ALL INDIA),2003,By Drowning,250,1528,1708,909,425,4820,145,1332,959,380,320,3136,7956
TOTAL (ALL INDIA),2003,By Fire/Self Immolation,78,1244,1354,682,209,3567,146,3352,2123,883,324,6828,10395
TOTAL (ALL INDIA),2003,By Fire-Arms,6,146,148,96,15,411,8,70,37,16,2,133,544
TOTAL (ALL INDIA),2003,By Hanging,259,6843,7874,5021,1969,21966,264,5104,3157,1582,498,10605,32571
TOTAL (ALL INDIA),2003,By Consuming Insecticides,215,4875,5436,3363,1256,15145,245,3549,2317,1290,455,7856,23001
TOTAL (ALL INDIA),2003,By Consuming Other Poison,154,3755,4181,3089,1277,12456,238,2968,2292,1185,453,7136,19592
TOTAL (ALL INDIA),2003,By Self Infliction of injury,0,90,84,74,28,276,2,60,42,27,22,153,429
TOTAL (ALL INDIA),2003,By Jumping from (Building),11,133,168,110,44,466,7,87,76,44,17,231,697
TOTAL (ALL INDIA),2003,By Jumping from (Other sites),8,124,140,106,28,406,3,61,58,32,10,164,570
TOTAL (ALL INDIA),2003,By Jumping off Moving Vehicles/Trains,6,109,142,84,28,369,2,49,46,14,11,122,491
TOTAL (ALL INDIA),2003,By Machine,2,33,46,29,5,115,0,2,2,1,0,5,120
TOTAL (ALL INDIA),2003,By Overdose of sleeping pills,1,226,219,204,129,779,7,116,151,159,169,602,1381
TOTAL (ALL INDIA),2003,By touching electric wires,33,194,211,135,51,624,8,42,45,24,8,127,751
TOTAL (ALL INDIA),2003,By coming under running vehicles/trains,35,770,878,497,222,2402,21,212,186,107,63,589,2991
TOTAL (ALL INDIA),2003,By Other means (please specify),215,1442,1665,1382,683,5387,199,1108,822,457,283,2869,8256
TOTAL (ALL INDIA),2003,Total,1278,21697,24679,16111,6456,70221,1298,18131,12338,6221,2642,40630,110851
TOTAL (ALL INDIA),2003,Total (Poison),369,8720,9701,6526,2561,27877,485,6577,4651,2502,930,15145,43022
TOTAL (ALL INDIA),2003,Total (Jumping),19,257,308,216,72,872,10,148,134,76,27,395,1267
TOTAL (ALL INDIA),2004,By Over Alcoholism,1,171,419,357,87,1035,1,8,16,8,2,35,1070
TOTAL (ALL INDIA),2004,By Drowning,233,1247,1460,880,351,4171,156,1148,905,477,344,3030,7201
TOTAL (ALL INDIA),2004,By Fire/Self Immolation,61,872,1050,628,193,2804,145,2882,1834,739,293,5893,8697
TOTAL (ALL INDIA),2004,By Fire-Arms,5,110,162,65,22,364,4,71,40,22,2,139,503
TOTAL (ALL INDIA),2004,By Hanging,319,7228,8810,5560,2103,24020,315,5494,3567,1503,600,11479,35499
TOTAL (ALL INDIA),2004,By Consuming Insecticides,190,4866,5394,3431,1329,15210,273,3854,2322,1142,510,8101,23311
TOTAL (ALL INDIA),2004,By Consuming Other Poison,197,3689,4173,2878,1171,12108,271,3027,2102,1149,360,6909,19017
TOTAL (ALL INDIA),2004,By Self Infliction of injury,3,75,72,50,11,211,1,48,36,9,3,97,308
TOTAL (ALL INDIA),2004,By Jumping from (Building),9,81,119,63,22,294,4,49,33,17,4,107,401
TOTAL (ALL INDIA),2004,By Jumping from (Other sites),22,146,173,96,32,469,11,57,49,21,5,143,612
TOTAL (ALL INDIA),2004,By Jumping off Moving Vehicles/Trains,5,173,193,124,35,530,5,29,39,13,3,89,619
TOTAL (ALL INDIA),2004,By Machine,2,30,39,22,3,96,0,3,3,3,0,9,105
TOTAL (ALL INDIA),2004,By Overdose of sleeping pills,7,171,185,167,94,624,4,151,123,93,26,397,1021
TOTAL (ALL INDIA),2004,By touching electric wires,20,276,307,171,36,810,13,95,88,32,9,237,1047
TOTAL (ALL INDIA),2004,By coming under running vehicles/trains,22,661,930,578,270,2461,9,222,217,117,76,641,3102
TOTAL (ALL INDIA),2004,By Other means (please specify),371,1821,2364,1995,893,7444,234,1381,1072,729,324,3740,11184
TOTAL (ALL INDIA),2004,Total,1467,21617,25850,17065,6652,72651,1446,18519,12446,6074,2561,41046,113697
TOTAL (ALL INDIA),2004,Total (Poison),390,8630,9639,6359,2511,27529,545,6929,4460,2300,873,15107,42636
TOTAL (ALL INDIA),2004,Total (Jumping),31,227,292,159,54,763,15,106,82,38,9,250,1013
TOTAL (ALL INDIA),2005,By Over Alcoholism,3,187,402,324,49,965,5,20,32,21,7,85,1050
TOTAL (ALL INDIA),2005,By Drowning,216,1252,1575,998,514,4555,166,1332,937,480,313,3228,7783
TOTAL (ALL INDIA),2005,By Fire/Self Immolation,65,858,1152,581,218,2874,123,2892,1870,847,372,6104,8978
TOTAL (ALL INDIA),2005,By Fire-Arms,64,201,196,117,21,599,9,75,48,19,2,153,752
TOTAL (ALL INDIA),2005,By Hanging,286,7487,9131,5764,2118,24786,289,5793,3522,1590,579,11773,36559
TOTAL (ALL INDIA),2005,By Consuming Insecticides,178,4500,5058,3467,1313,14516,176,3529,2347,1230,518,7800,22316
TOTAL (ALL INDIA),2005,By Consuming Other Poison,179,3816,4177,2922,1100,12194,210,2981,2039,1208,470,6908,19102
TOTAL (ALL INDIA),2005,By Self Infliction of injury,1,65,69,39,9,183,5,38,24,8,1,76,259
TOTAL (ALL INDIA),2005,By Jumping from (Building),7,113,168,71,29,388,8,56,70,14,10,158,546
TOTAL (ALL INDIA),2005,By Jumping from (Other sites),15,103,137,59,24,338,3,36,31,16,8,94,432
TOTAL (ALL INDIA),2005,By Jumping off Moving Vehicles/Trains,4,194,223,127,41,589,1,57,62,22,10,152,741
TOTAL (ALL INDIA),2005,By Machine,0,26,36,16,1,79,2,1,3,0,0,6,85
TOTAL (ALL INDIA),2005,By Overdose of sleeping pills,3,72,137,204,89,505,1,118,90,57,57,323,828
TOTAL (ALL INDIA),2005,By touching electric wires,15,261,318,172,34,800,9,93,90,43,18,253,1053
TOTAL (ALL INDIA),2005,By coming under running vehicles/trains,22,777,785,569,242,2395,26,242,206,120,53,647,3042
TOTAL (ALL INDIA),2005,By Other means (please specify),270,1911,2368,1806,795,7150,194,1148,880,714,302,3238,10388
TOTAL (ALL INDIA),2005,Total,1328,21823,25932,17236,6597,72916,1227,18411,12251,6389,2720,40998,113914
TOTAL (ALL INDIA),2005,Total (Poison),358,8381,9304,6428,2422,26893,391,6548,4410,2446,989,14784,41677
TOTAL (ALL INDIA),2005,Total (Jumping),22,216,305,130,53,726,11,92,101,30,18,252,978
TOTAL (ALL INDIA),2006,By Over Alcoholism,4,194,552,357,98,1205,0,10,17,17,7,51,1256
TOTAL (ALL INDIA),2006,By Drowning,195,1528,1832,1139,521,5215,195,1330,980,495,364,3364,8579
TOTAL (ALL INDIA),2006,By Fire/Self Immolation,38,959,1425,766,246,3434,111,3441,2088,827,342,6809,10243
TOTAL (ALL INDIA),2006,By Fire-Arms,2,95,138,51,13,299,3,19,22,10,0,54,353
TOTAL (ALL INDIA),2006,By Hanging,257,7731,9731,5868,2023,25610,262,6397,3948,1915,574,13096,38706
TOTAL (ALL INDIA),2006,By Consuming Insecticides,193,4646,5625,3561,1373,15398,228,3500,2276,1060,485,7549,22947
TOTAL (ALL INDIA),2006,By Consuming Other Poison,159,4079,4323,2725,988,12274,235,2896,2004,1009,315,6459,18733
TOTAL (ALL INDIA),2006,By Self Infliction of injury,8,41,55,34,17,155,2,27,24,5,3,61,216
TOTAL (ALL INDIA),2006,By Jumping from (Building),4,129,148,67,24,372,4,81,34,18,7,144,516
TOTAL (ALL INDIA),2006,By Jumping from (Other sites),13,196,253,123,35,620,3,77,90,55,22,247,867
TOTAL (ALL INDIA),2006,By Jumping off Moving Vehicles/Trains,17,223,241,165,35,681,6,86,77,23,13,205,886
TOTAL (ALL INDIA),2006,By Machine,1,32,30,25,2,90,0,9,12,5,1,27,117
TOTAL (ALL INDIA),2006,By Overdose of sleeping pills,9,86,155,130,136,516,10,99,64,55,40,268,784
TOTAL (ALL INDIA),2006,By touching electric wires,14,200,180,76,22,492,5,44,46,11,3,109,601
TOTAL (ALL INDIA),2006,By coming under running vehicles/trains,37,836,1095,780,294,3042,22,276,253,160,69,780,3822
TOTAL (ALL INDIA),2006,By Other means (please specify),243,1782,2026,1478,770,6299,184,1167,955,596,285,3187,9486
TOTAL (ALL INDIA),2006,Total,1194,22757,27809,17345,6597,75702,1270,19459,12890,6261,2530,42410,118112
TOTAL (ALL INDIA),2006,Total (Poison),360,8766,10003,6320,2378,27827,465,6423,4304,2074,803,14069,41896
TOTAL (ALL INDIA),2006,Total (Jumping),17,325,401,190,59,992,7,158,124,73,29,391,1383
TOTAL (ALL INDIA),2007,By Over Alcoholism,0,194,528,432,108,1262,0,49,36,28,11,124,1386
TOTAL (ALL INDIA),2007,By Drowning,199,1430,1880,1208,485,5202,213,1190,905,525,303,3136,8338
TOTAL (ALL INDIA),2007,By Fire/Self Immolation,52,1009,1378,777,236,3452,155,3514,2125,756,389,6939,10391
TOTAL (ALL INDIA),2007,By Fire-Arms,2,125,216,147,58,548,5,70,60,26,10,171,719
TOTAL (ALL INDIA),2007,By Hanging,284,8354,9646,6211,2014,26509,266,6062,3911,1616,497,12352,38861
TOTAL (ALL INDIA),2007,By Consuming Insecticides,167,4665,5666,3753,1625,15876,238,3961,2322,1234,494,8249,24125
TOTAL (ALL INDIA),2007,By Consuming Other Poison,132,3689,4246,3035,999,12101,160,2659,2141,1116,371,6447,18548
TOTAL (ALL INDIA),2007,By Self Infliction of injury,1,61,76,34,26,198,2,29,31,8,9,79,277
TOTAL (ALL INDIA),2007,By Jumping from (Building),14,131,306,139,27,617,16,88,59,66,9,238,855
TOTAL (ALL INDIA),2007,By Jumping from (Other sites),7,95,79,75,34,290,8,53,38,16,5,120,410
TOTAL (ALL INDIA),2007,By Jumping off Moving Vehicles/Trains,5,142,212,93,50,502,5,54,59,26,12,156,658
TOTAL (ALL INDIA),2007,By Machine,0,71,35,18,5,129,0,23,6,5,0,34,163
TOTAL (ALL INDIA),2007,By Overdose of sleeping pills,15,113,192,104,50,474,4,158,111,45,27,345,819
TOTAL (ALL INDIA),2007,By touching electric wires,32,224,226,102,28,612,4,38,51,23,12,128,740
TOTAL (ALL INDIA),2007,By coming under running vehicles/trains,27,1001,1362,862,327,3579,27,326,273,141,60,827,4406
TOTAL (ALL INDIA),2007,By Other means (please specify),247,2142,2503,2123,929,7944,192,1440,1153,827,385,3997,11941
TOTAL (ALL INDIA),2007,Total,1184,23446,28551,19113,7001,79295,1295,19714,13281,6458,2594,43342,122637
TOTAL (ALL INDIA),2007,Total (Poison),300,8415,9988,6822,2650,28175,400,6649,4494,2358,874,14775,42950
TOTAL (ALL INDIA),2007,Total (Jumping),21,226,385,214,61,907,24,141,97,82,14,358,1265
TOTAL (ALL INDIA),2008,By Over Alcoholism,4,268,587,385,120,1364,0,61,61,27,10,159,1523
TOTAL (ALL INDIA),2008,By Drowning,181,1515,1904,1075,515,5190,190,1227,968,470,306,3161,8351
TOTAL (ALL INDIA),2008,By Fire/Self Immolation,47,1201,1604,875,255,3982,115,3644,2118,765,362,7004,10986
TOTAL (ALL INDIA),2008,By Fire-Arms,3,115,153,63,18,352,3,59,36,16,13,127,479
TOTAL (ALL INDIA),2008,By Hanging,298,8800,10218,6004,2012,27332,300,6256,4091,1735,554,12936,40268
TOTAL (ALL INDIA),2008,By Consuming Insecticides,159,4866,5732,3704,1305,15766,190,3754,2572,1121,492,8129,23895
TOTAL (ALL INDIA),2008,By Consuming Other Poison,120,3857,4362,3056,927,12322,144,3066,2422,1112,358,7102,19424
TOTAL (ALL INDIA),2008,By Self Infliction of injury,2,66,80,35,23,206,3,62,26,16,18,125,331
TOTAL (ALL INDIA),2008,By Jumping from (Building),5,139,214,100,26,484,4,65,62,30,25,186,670
TOTAL (ALL INDIA),2008,By Jumping from (Other sites),9,124,109,83,35,360,11,36,28,22,8,105,465
TOTAL (ALL INDIA),2008,By Jumping off Moving Vehicles/Trains,3,127,149,79,18,376,3,59,42,11,6,121,497
TOTAL (ALL INDIA),2008,By Machine,0,26,34,26,3,89,0,3,8,15,2,28,117
TOTAL (ALL INDIA),2008,By Overdose of sleeping pills,8,75,140,107,50,380,1,113,81,55,30,280,660
TOTAL (ALL INDIA),2008,By touching electric wires,27,289,302,169,30,817,5,55,59,39,10,168,985
TOTAL (ALL INDIA),2008,By coming under running vehicles/trains,30,804,977,843,262,2916,25,325,261,121,49,781,3697
TOTAL (ALL INDIA),2008,By Other means (please specify),269,2124,2954,2215,1046,8608,222,1471,1208,818,342,4061,12669
TOTAL (ALL INDIA),2008,Total,1165,24396,29519,18819,6645,80544,1216,20256,14043,6373,2585,44473,125017
TOTAL (ALL INDIA),2008,Total (Poison),281,8789,10174,6795,2255,28294,337,6882,5020,2249,868,15356,43650
TOTAL (ALL INDIA),2008,Total (Jumping),14,263,323,183,61,844,15,101,90,52,33,291,1135
TOTAL (ALL INDIA),2009,By Over Alcoholism,4,285,582,467,132,1470,1,17,41,24,19,102,1572
TOTAL (ALL INDIA),2009,By Drowning,264,1478,1652,948,452,4794,160,1032,928,516,319,2955,7749
TOTAL (ALL INDIA),2009,By Fire/Self Immolation,38,1151,1637,825,308,3959,131,3695,2489,978,398,7691,11650
TOTAL (ALL INDIA),2009,By Fire-Arms,3,137,163,83,26,412,6,68,45,24,5,148,560
TOTAL (ALL INDIA),2009,By Hanging,313,8675,9652,6271,2168,27079,326,6253,3960,1797,591,12927,40006
TOTAL (ALL INDIA),2009,By Consuming Insecticides,147,4868,6332,4257,1572,17176,228,3892,2684,1406,555,8765,25941
TOTAL (ALL INDIA),2009,By Consuming Other Poison,133,3197,3892,2609,777,10608,160,2826,1942,960,346,6234,16842
TOTAL (ALL INDIA),2009,By Self Infliction of injury,2,68,75,43,39,227,0,44,32,6,4,86,313
TOTAL (ALL INDIA),2009,By Jumping from (Building),18,147,237,126,62,590,21,91,76,35,20,243,833
TOTAL (ALL INDIA),2009,By Jumping from (Other sites),14,165,289,112,67,647,7,187,109,52,16,371,1018
TOTAL (ALL INDIA),2009,By Jumping off Moving Vehicles/Trains,16,182,361,164,28,751,7,76,84,29,13,209,960
TOTAL (ALL INDIA),2009,By Machine,1,23,58,49,3,134,0,7,4,4,1,16,150
TOTAL (ALL INDIA),2009,By Overdose of sleeping pills,2,112,130,86,46,376,6,89,90,42,19,246,622
TOTAL (ALL INDIA),2009,By touching electric wires,41,280,289,192,41,843,16,72,66,64,12,230,1073
TOTAL (ALL INDIA),2009,By coming under running vehicles/trains,31,765,1035,642,238,2711,19,363,262,166,96,906,3617
TOTAL (ALL INDIA),2009,By Other means (please specify),474,2213,2951,2722,1334,9694,362,1462,1341,904,482,4551,14245
TOTAL (ALL INDIA),2009,Total,1501,23746,29335,19596,7293,81471,1450,20174,14153,7007,2896,45680,127151
TOTAL (ALL INDIA),2009,Total (Poison),282,8133,10299,6909,2388,28011,388,6762,4658,2372,905,15085,43096
TOTAL (ALL INDIA),2009,Total (Jumping),32,312,526,238,129,1237,28,278,185,87,36,614,1851
TOTAL (ALL INDIA),2010,By Over Alcoholism,1,307,506,392,128,1334,0,75,19,41,21,156,1490
TOTAL (ALL INDIA),2010,By Drowning,288,1575,1636,1118,525,5142,160,1257,914,553,383,3267,8409
TOTAL (ALL INDIA),2010,By Fire/Self Immolation,79,1274,1693,801,290,4137,176,3806,2362,926,478,7748,11885
TOTAL (ALL INDIA),2010,By Fire-Arms,1,152,150,75,34,412,23,140,65,18,8,254,666
TOTAL (ALL INDIA),2010,By Hanging,375,9191,10477,6659,2286,28988,315,6569,4006,1754,634,13278,42266
TOTAL (ALL INDIA),2010,By Consuming Insecticides,223,5223,5928,4139,1309,16822,263,3960,2598,1159,486,8466,25288
TOTAL (ALL INDIA),2010,By Consuming Other Poison,119,3568,4178,3234,1341,12440,140,2818,2190,1177,482,6807,19247
TOTAL (ALL INDIA),2010,By Self Infliction of injury,12,226,219,125,42,624,9,98,66,26,13,212,836
TOTAL (ALL INDIA),2010,By Jumping from (Building),15,182,235,114,48,594,8,86,68,29,10,201,795
TOTAL (ALL INDIA),2010,By Jumping from (Other sites),13,203,208,125,34,583,12,88,92,65,35,292,875
TOTAL (ALL INDIA),2010,By Jumping off Moving Vehicles/Trains,9,177,209,120,63,578,9,78,47,21,10,165,743
TOTAL (ALL INDIA),2010,By Machine,1,47,66,24,4,142,3,15,10,5,2,35,177
TOTAL (ALL INDIA),2010,By Overdose of sleeping pills,5,119,121,83,26,354,1,98,79,42,15,235,589
TOTAL (ALL INDIA),2010,By touching electric wires,30,291,302,190,48,861,10,97,83,76,23,289,1150
TOTAL (ALL INDIA),2010,By coming under running vehicles/trains,29,989,1161,801,329,3309,21,327,283,197,67,895,4204
TOTAL (ALL INDIA),2010,By Other means (please specify),440,2863,3355,2768,1434,10860,340,1726,1520,1032,501,5119,15979
TOTAL (ALL INDIA),2010,Total,1640,26387,30444,20768,7941,87180,1490,21238,14402,7121,3168,47419,134599
TOTAL (ALL INDIA),2010,Total (Poison),354,9017,10325,7498,2692,29886,412,6876,4854,2362,981,15485,45371
TOTAL (ALL INDIA),2010,Total (Jumping),28,385,443,239,82,1177,20,174,160,94,45,493,1670
TOTAL (ALL INDIA),2011,By Over Alcoholism,3,230,547,400,144,1324,1,15,21,19,9,65,1389
TOTAL (ALL INDIA),2011,By Drowning,228,1510,1660,1055,554,5007,157,1297,842,470,287,3053,8060
TOTAL (ALL INDIA),2011,By Fire/Self Immolation,67,1351,1619,943,299,4279,161,3720,2343,905,458,7587,11866
TOTAL (ALL INDIA),2011,By Fire-Arms,1,113,128,58,19,319,2,50,22,8,1,83,402
TOTAL (ALL INDIA),2011,By Hanging,299,9678,11143,7258,2289,30667,335,7017,4386,1903,707,14348,45015
TOTAL (ALL INDIA),2011,By Consuming Insecticides,170,4638,4986,3316,1402,14512,210,3584,2101,1021,376,7292,21804
TOTAL (ALL INDIA),2011,By Consuming Other Poison,160,4001,4867,3294,1367,13689,201,3341,2674,1237,419,7872,21561
TOTAL (ALL INDIA),2011,By Self Infliction of injury,2,115,106,63,45,331,3,52,40,32,23,150,481
TOTAL (ALL INDIA),2011,By Jumping from (Building),9,142,165,96,40,452,13,102,73,37,9,234,686
TOTAL (ALL INDIA),2011,By Jumping from (Other sites),14,131,142,67,30,384,26,88,59,43,18,234,618
TOTAL (ALL INDIA),2011,By Jumping off Moving Vehicles/Trains,6,147,145,121,62,481,8,74,54,19,14,169,650
TOTAL (ALL INDIA),2011,By Machine,3,30,43,24,8,108,1,9,7,5,2,24,132
TOTAL (ALL INDIA),2011,By Overdose of sleeping pills,1,106,98,72,42,319,7,108,81,37,16,249,568
TOTAL (ALL INDIA),2011,By touching electric wires,24,222,211,100,43,600,7,62,41,24,8,142,742
TOTAL (ALL INDIA),2011,By coming under running vehicles/trains,16,989,1588,905,338,3836,5,390,398,145,72,1010,4846
TOTAL (ALL INDIA),2011,By Other means (please specify),571,3201,3952,2735,1072,11531,324,1501,1673,1124,612,5234,16765
TOTAL (ALL INDIA),2011,Total,1574,26604,31400,20507,7754,87839,1461,21410,14815,7029,3031,47746,135585
TOTAL (ALL INDIA),2011,Total (Poison),332,8754,9959,6673,2814,28532,414,6977,4815,2290,818,15314,43846
TOTAL (ALL INDIA),2011,Total (Jumping),23,273,307,163,70,836,39,190,132,80,27,468,1304
TOTAL (ALL INDIA),2012,By Over Alcoholism,6,245,567,420,176,1414,13,26,28,19,21,107,1521
TOTAL (ALL INDIA),2012,By Drowning,247,1459,1645,1108,535,4994,143,1112,877,460,296,2888,7882
TOTAL (ALL INDIA),2012,By Fire/Self Immolation,62,1182,1702,851,315,4112,153,3411,2323,937,502,7326,11438
TOTAL (ALL INDIA),2012,By Fire-Arms,0,127,123,74,25,349,2,64,19,8,8,101,450
TOTAL (ALL INDIA),2012,By Hanging,383,11015,12310,8135,2788,34631,388,7616,4618,2110,699,15431,50062
TOTAL (ALL INDIA),2012,By Consuming Insecticides,110,4005,4550,3261,1235,13161,174,3163,1997,1026,408,6768,19929
TOTAL (ALL INDIA),2012,By Consuming Other Poison,135,3331,4406,3100,1314,12286,199,2990,2256,1271,443,7159,19445
TOTAL (ALL INDIA),2012,By Self Infliction of injury,2,128,147,62,23,362,7,104,89,30,4,234,596
TOTAL (ALL INDIA),2012,By Jumping from (Building),8,130,132,91,39,400,8,81,46,18,13,166,566
TOTAL (ALL INDIA),2012,By Jumping from (Other sites),15,151,214,108,45,533,7,94,78,24,16,219,752
TOTAL (ALL INDIA),2012,By Jumping off Moving Vehicles/Trains,8,139,169,84,48,448,8,84,52,20,8,172,620
TOTAL (ALL INDIA),2012,By Machine,4,19,38,14,7,82,0,6,4,1,0,11,93
TOTAL (ALL INDIA),2012,By Overdose of sleeping pills,5,97,147,107,29,385,9,108,85,48,25,275,660
TOTAL (ALL INDIA),2012,By touching electric wires,26,251,269,181,48,775,4,54,50,20,21,149,924
TOTAL (ALL INDIA),2012,By coming under running vehicles/trains,11,1126,1221,850,346,3554,16,281,220,134,54,705,4259
TOTAL (ALL INDIA),2012,By Other means (please specify),331,2537,4064,2771,1264,10967,254,1499,1714,1156,658,5281,16248
TOTAL (ALL INDIA),2012,Total,1353,25942,31704,21217,8237,88453,1385,20693,14456,7282,3176,46992,135445
TOTAL (ALL INDIA),2012,Total (Poison),247,7464,9103,6423,2572,25809,380,6257,4342,2327,855,14161,39970
