State/UT,Year,Social Status,Male,Female,Total
ANDHRA PRADESH,2001,Never Married,819,591,1410
ANDHRA PRADESH,2001,Married,5135,3135,8270
ANDHRA PRADESH,2001,Widowed/Widower,183,236,419
ANDHRA PRADESH,2001,Divorcee,47,43,90
ANDHRA PRADESH,2001,Seperated,195,138,333
ANDHRA PRADESH,2001,Total,6379,4143,10522
ANDHRA PRADESH,2002,Never Married,908,689,1597
ANDHRA PRADESH,2002,Married,5435,2503,7938
ANDHRA PRADESH,2002,Widowed/Widower,847,704,1551
ANDHRA PRADESH,2002,Divorcee,72,77,149
ANDHRA PRADESH,2002,Seperated,309,149,458
ANDHRA PRADESH,2002,Total,7571,4122,11693
ANDHRA PRADESH,2003,Never Married,1205,774,1979
ANDHRA PRADESH,2003,Married,5673,2633,8306
ANDHRA PRADESH,2003,Widowed/Widower,324,274,598
ANDHRA PRADESH,2003,Divorcee,88,58,146
ANDHRA PRADESH,2003,Seperated,223,157,380
ANDHRA PRADESH,2003,Total,7513,3896,11409
ANDHRA PRADESH,2004,Never Married,1464,675,2139
ANDHRA PRADESH,2004,Married,6577,3154,9731
ANDHRA PRADESH,2004,Widowed/Widower,321,232,553
ANDHRA PRADESH,2004,Divorcee,142,65,207
ANDHRA PRADESH,2004,Seperated,578,318,896
ANDHRA PRADESH,2004,Total,9082,4444,13526
ANDHRA PRADESH,2005,Never Married,1389,692,2081
ANDHRA PRADESH,2005,Married,6344,3114,9458
ANDHRA PRADESH,2005,Widowed/Widower,555,391,946
ANDHRA PRADESH,2005,Divorcee,83,46,129
ANDHRA PRADESH,2005,Seperated,494,334,828
ANDHRA PRADESH,2005,Total,8865,4577,13442
ANDHRA PRADESH,2006,Never Married,1393,840,2233
ANDHRA PRADESH,2006,Married,6847,3125,9972
ANDHRA PRADESH,2006,Widowed/Widower,256,252,508
ANDHRA PRADESH,2006,Divorcee,75,54,129
ANDHRA PRADESH,2006,Seperated,292,142,434
ANDHRA PRADESH,2006,Total,8863,4413,13276
ANDHRA PRADESH,2007,Never Married,1156,651,1807
ANDHRA PRADESH,2007,Married,7905,3505,11410
ANDHRA PRADESH,2007,Widowed/Widower,351,248,599
ANDHRA PRADESH,2007,Divorcee,72,66,138
ANDHRA PRADESH,2007,Seperated,465,463,928
ANDHRA PRADESH,2007,Total,9949,4933,14882
ANDHRA PRADESH,2008,Never Married,1533,834,2367
ANDHRA PRADESH,2008,Married,7357,3212,10569
ANDHRA PRADESH,2008,Widowed/Widower,442,362,804
ANDHRA PRADESH,2008,Divorcee,193,110,303
ANDHRA PRADESH,2008,Seperated,196,115,311
ANDHRA PRADESH,2008,Total,9721,4633,14354
ANDHRA PRADESH,2009,Never Married,1527,792,2319
ANDHRA PRADESH,2009,Married,7439,3340,10779
ANDHRA PRADESH,2009,Widowed/Widower,336,276,612
ANDHRA PRADESH,2009,Divorcee,164,83,247
ANDHRA PRADESH,2009,Seperated,421,122,543
ANDHRA PRADESH,2009,Total,9887,4613,14500
ANDHRA PRADESH,2010,Never Married,1506,669,2175
ANDHRA PRADESH,2010,Married,8659,3706,12365
ANDHRA PRADESH,2010,Widowed/Widower,315,290,605
ANDHRA PRADESH,2010,Divorcee,122,104,226
ANDHRA PRADESH,2010,Seperated,345,185,530
ANDHRA PRADESH,2010,Total,10947,4954,15901
ANDHRA PRADESH,2011,Never Married,1028,571,1599
ANDHRA PRADESH,2011,Married,8241,3779,12020
ANDHRA PRADESH,2011,Widowed/Widower,336,270,606
ANDHRA PRADESH,2011,Divorcee,95,97,192
ANDHRA PRADESH,2011,Seperated,420,240,660
ANDHRA PRADESH,2011,Total,10120,4957,15077
ANDHRA PRADESH,2012,Never Married,1136,685,1821
ANDHRA PRADESH,2012,Married,7813,3630,11443
ANDHRA PRADESH,2012,Widowed/Widower,261,210,471
ANDHRA PRADESH,2012,Divorcee,98,94,192
ANDHRA PRADESH,2012,Seperated,219,92,311
ANDHRA PRADESH,2012,Total,9527,4711,14238
ARUNACHAL PRADESH,2001,Never Married,12,10,22
ARUNACHAL PRADESH,2001,Married,64,22,86
ARUNACHAL PRADESH,2001,Widowed/Widower,0,2,2
ARUNACHAL PRADESH,2001,Divorcee,0,0,0
ARUNACHAL PRADESH,2001,Seperated,0,1,1
ARUNACHAL PRADESH,2001,Total,76,35,111
ARUNACHAL PRADESH,2002,Never Married,12,20,32
ARUNACHAL PRADESH,2002,Married,59,22,81
ARUNACHAL PRADESH,2002,Widowed/Widower,0,1,1
ARUNACHAL PRADESH,2002,Divorcee,0,0,0
ARUNACHAL PRADESH,2002,Seperated,0,0,0
ARUNACHAL PRADESH,2002,Total,71,43,114
ARUNACHAL PRADESH,2003,Never Married,11,7,18
ARUNACHAL PRADESH,2003,Married,41,20,61
ARUNACHAL PRADESH,2003,Widowed/Widower,1,0,1
ARUNACHAL PRADESH,2003,Divorcee,0,0,0
ARUNACHAL PRADESH,2003,Seperated,1,0,1
ARUNACHAL PRADESH,2003,Total,54,27,81
ARUNACHAL PRADESH,2004,Never Married,11,10,21
ARUNACHAL PRADESH,2004,Married,38,20,58
ARUNACHAL PRADESH,2004,Widowed/Widower,0,0,0
ARUNACHAL PRADESH,2004,Divorcee,0,0,0
ARUNACHAL PRADESH,2004,Seperated,0,0,0
ARUNACHAL PRADESH,2004,Total,49,30,79
ARUNACHAL PRADESH,2005,Never Married,18,7,25
ARUNACHAL PRADESH,2005,Married,31,14,45
ARUNACHAL PRADESH,2005,Widowed/Widower,0,0,0
ARUNACHAL PRADESH,2005,Divorcee,0,0,0
ARUNACHAL PRADESH,2005,Seperated,0,0,0
ARUNACHAL PRADESH,2005,Total,49,21,70
ARUNACHAL PRADESH,2006,Never Married,20,7,27
ARUNACHAL PRADESH,2006,Married,76,26,102
ARUNACHAL PRADESH,2006,Widowed/Widower,0,0,0
ARUNACHAL PRADESH,2006,Divorcee,0,0,0
ARUNACHAL PRADESH,2006,Seperated,0,0,0
ARUNACHAL PRADESH,2006,Total,96,33,129
ARUNACHAL PRADESH,2007,Never Married,33,14,47
ARUNACHAL PRADESH,2007,Married,65,17,82
ARUNACHAL PRADESH,2007,Widowed/Widower,0,0,0
ARUNACHAL PRADESH,2007,Divorcee,0,0,0
ARUNACHAL PRADESH,2007,Seperated,0,0,0
ARUNACHAL PRADESH,2007,Total,98,31,129
ARUNACHAL PRADESH,2008,Never Married,13,8,21
ARUNACHAL PRADESH,2008,Married,63,22,85
ARUNACHAL PRADESH,2008,Widowed/Widower,0,3,3
ARUNACHAL PRADESH,2008,Divorcee,1,0,1
ARUNACHAL PRADESH,2008,Seperated,0,0,0
ARUNACHAL PRADESH,2008,Total,77,33,110
ARUNACHAL PRADESH,2009,Never Married,15,9,24
ARUNACHAL PRADESH,2009,Married,61,21,82
ARUNACHAL PRADESH,2009,Widowed/Widower,0,3,3
ARUNACHAL PRADESH,2009,Divorcee,1,0,1
ARUNACHAL PRADESH,2009,Seperated,0,0,0
ARUNACHAL PRADESH,2009,Total,77,33,110
ARUNACHAL PRADESH,2010,Never Married,20,16,36
ARUNACHAL PRADESH,2010,Married,71,24,95
ARUNACHAL PRADESH,2010,Widowed/Widower,0,0,0
ARUNACHAL PRADESH,2010,Divorcee,0,0,0
ARUNACHAL PRADESH,2010,Seperated,0,0,0
ARUNACHAL PRADESH,2010,Total,91,40,131
ARUNACHAL PRADESH,2011,Never Married,38,12,50
ARUNACHAL PRADESH,2011,Married,61,23,84
ARUNACHAL PRADESH,2011,Widowed/Widower,0,0,0
ARUNACHAL PRADESH,2011,Divorcee,0,0,0
ARUNACHAL PRADESH,2011,Seperated,0,0,0
ARUNACHAL PRADESH,2011,Total,99,35,134
ARUNACHAL PRADESH,2012,Never Married,23,11,34
ARUNACHAL PRADESH,2012,Married,75,18,93
ARUNACHAL PRADESH,2012,Widowed/Widower,2,0,2
ARUNACHAL PRADESH,2012,Divorcee,0,1,1
ARUNACHAL PRADESH,2012,Seperated,0,0,0
ARUNACHAL PRADESH,2012,Total,100,30,130
ASSAM,2001,Never Married,634,263,897
ASSAM,2001,Married,1032,475,1507
ASSAM,2001,Widowed/Widower,36,27,63
ASSAM,2001,Divorcee,21,12,33
ASSAM,2001,Seperated,113,34,147
ASSAM,2001,Total,1836,811,2647
ASSAM,2002,Never Married,533,225,758
ASSAM,2002,Married,927,466,1393
ASSAM,2002,Widowed/Widower,57,40,97
ASSAM,2002,Divorcee,44,25,69
ASSAM,2002,Seperated,141,52,193
ASSAM,2002,Total,1702,808,2510
ASSAM,2003,Never Married,466,273,739
ASSAM,2003,Married,770,434,1204
ASSAM,2003,Widowed/Widower,197,106,303
ASSAM,2003,Divorcee,43,13,56
ASSAM,2003,Seperated,200,94,294
ASSAM,2003,Total,1676,920,2596
ASSAM,2004,Never Married,590,233,823
ASSAM,2004,Married,1076,499,1575
ASSAM,2004,Widowed/Widower,46,37,83
ASSAM,2004,Divorcee,21,13,34
ASSAM,2004,Seperated,212,112,324
ASSAM,2004,Total,1945,894,2839
ASSAM,2005,Never Married,559,278,837
ASSAM,2005,Married,1149,491,1640
ASSAM,2005,Widowed/Widower,87,38,125
ASSAM,2005,Divorcee,27,11,38
ASSAM,2005,Seperated,129,77,206
ASSAM,2005,Total,1951,895,2846
ASSAM,2006,Never Married,648,287,935
ASSAM,2006,Married,1274,533,1807
ASSAM,2006,Widowed/Widower,69,37,106
ASSAM,2006,Divorcee,23,11,34
ASSAM,2006,Seperated,102,47,149
ASSAM,2006,Total,2116,915,3031
ASSAM,2007,Never Married,619,331,950
ASSAM,2007,Married,1249,514,1763
ASSAM,2007,Widowed/Widower,67,62,129
ASSAM,2007,Divorcee,38,14,52
ASSAM,2007,Seperated,143,25,168
ASSAM,2007,Total,2116,946,3062
ASSAM,2008,Never Married,496,249,745
ASSAM,2008,Married,1146,579,1725
ASSAM,2008,Widowed/Widower,91,95,186
ASSAM,2008,Divorcee,47,24,71
ASSAM,2008,Seperated,190,72,262
ASSAM,2008,Total,1970,1019,2989
ASSAM,2009,Never Married,633,337,970
ASSAM,2009,Married,1119,652,1771
ASSAM,2009,Widowed/Widower,32,25,57
ASSAM,2009,Divorcee,4,19,23
ASSAM,2009,Seperated,94,51,145
ASSAM,2009,Total,1882,1084,2966
ASSAM,2010,Never Married,582,252,834
ASSAM,2010,Married,1267,565,1832
ASSAM,2010,Widowed/Widower,16,22,38
ASSAM,2010,Divorcee,12,21,33
ASSAM,2010,Seperated,149,107,256
ASSAM,2010,Total,2026,967,2993
ASSAM,2011,Never Married,577,202,779
ASSAM,2011,Married,1097,546,1643
ASSAM,2011,Widowed/Widower,34,63,97
ASSAM,2011,Divorcee,22,23,45
ASSAM,2011,Seperated,96,66,162
ASSAM,2011,Total,1826,900,2726
ASSAM,2012,Never Married,673,217,890
ASSAM,2012,Married,1600,579,2179
ASSAM,2012,Widowed/Widower,34,27,61
ASSAM,2012,Divorcee,21,25,46
ASSAM,2012,Seperated,64,24,88
ASSAM,2012,Total,2392,872,3264
BIHAR,2001,Never Married,107,84,191
BIHAR,2001,Married,162,170,332
BIHAR,2001,Widowed/Widower,17,26,43
BIHAR,2001,Divorcee,7,4,11
BIHAR,2001,Seperated,14,12,26
BIHAR,2001,Total,307,296,603
BIHAR,2002,Never Married,135,69,204
BIHAR,2002,Married,261,203,464
BIHAR,2002,Widowed/Widower,9,16,25
BIHAR,2002,Divorcee,8,2,10
BIHAR,2002,Seperated,13,4,17
BIHAR,2002,Total,426,294,720
BIHAR,2003,Never Married,113,63,176
BIHAR,2003,Married,217,155,372
BIHAR,2003,Widowed/Widower,11,10,21
BIHAR,2003,Divorcee,3,6,9
BIHAR,2003,Seperated,7,14,21
BIHAR,2003,Total,351,248,599
BIHAR,2004,Never Married,53,28,81
BIHAR,2004,Married,136,98,234
BIHAR,2004,Widowed/Widower,20,12,32
BIHAR,2004,Divorcee,1,1,2
BIHAR,2004,Seperated,2,0,2
BIHAR,2004,Total,212,139,351
BIHAR,2005,Never Married,78,39,117
BIHAR,2005,Married,223,163,386
BIHAR,2005,Widowed/Widower,18,4,22
BIHAR,2005,Divorcee,4,7,11
BIHAR,2005,Seperated,4,3,7
BIHAR,2005,Total,327,216,543
BIHAR,2006,Never Married,91,72,163
BIHAR,2006,Married,151,197,348
BIHAR,2006,Widowed/Widower,26,32,58
BIHAR,2006,Divorcee,8,7,15
BIHAR,2006,Seperated,23,11,34
BIHAR,2006,Total,299,319,618
BIHAR,2007,Never Married,173,133,306
BIHAR,2007,Married,310,246,556
BIHAR,2007,Widowed/Widower,38,30,68
BIHAR,2007,Divorcee,1,16,17
BIHAR,2007,Seperated,12,6,18
BIHAR,2007,Total,534,431,965
BIHAR,2008,Never Married,174,107,281
BIHAR,2008,Married,361,256,617
BIHAR,2008,Widowed/Widower,32,21,53
BIHAR,2008,Divorcee,15,10,25
BIHAR,2008,Seperated,27,12,39
BIHAR,2008,Total,609,406,1015
BIHAR,2009,Never Married,155,112,267
BIHAR,2009,Married,327,389,716
BIHAR,2009,Widowed/Widower,25,32,57
BIHAR,2009,Divorcee,5,3,8
BIHAR,2009,Seperated,2,1,3
BIHAR,2009,Total,514,537,1051
BIHAR,2010,Never Married,155,149,304
BIHAR,2010,Married,495,283,778
BIHAR,2010,Widowed/Widower,20,33,53
BIHAR,2010,Divorcee,12,8,20
BIHAR,2010,Seperated,30,41,71
BIHAR,2010,Total,712,514,1226
BIHAR,2011,Never Married,125,85,210
BIHAR,2011,Married,281,229,510
BIHAR,2011,Widowed/Widower,24,14,38
BIHAR,2011,Divorcee,0,4,4
BIHAR,2011,Seperated,16,17,33
BIHAR,2011,Total,446,349,795
BIHAR,2012,Never Married,95,82,177
BIHAR,2012,Married,316,198,514
BIHAR,2012,Widowed/Widower,24,8,32
BIHAR,2012,Divorcee,0,0,0
BIHAR,2012,Seperated,20,16,36
BIHAR,2012,Total,455,304,759
CHHATTISGARH,2001,Never Married,539,291,830
CHHATTISGARH,2001,Married,1979,1014,2993
CHHATTISGARH,2001,Widowed/Widower,104,65,169
CHHATTISGARH,2001,Divorcee,9,7,16
CHHATTISGARH,2001,Seperated,9,8,17
CHHATTISGARH,2001,Total,2640,1385,4025
CHHATTISGARH,2002,Never Married,498,295,793
CHHATTISGARH,2002,Married,1957,945,2902
CHHATTISGARH,2002,Widowed/Widower,139,67,206
CHHATTISGARH,2002,Divorcee,25,7,32
CHHATTISGARH,2002,Seperated,10,7,17
CHHATTISGARH,2002,Total,2629,1321,3950
CHHATTISGARH,2003,Never Married,544,312,856
CHHATTISGARH,2003,Married,1854,846,2700
CHHATTISGARH,2003,Widowed/Widower,182,154,336
CHHATTISGARH,2003,Divorcee,2,3,5
CHHATTISGARH,2003,Seperated,10,12,22
CHHATTISGARH,2003,Total,2592,1327,3919
CHHATTISGARH,2004,Never Married,647,367,1014
CHHATTISGARH,2004,Married,2247,1028,3275
CHHATTISGARH,2004,Widowed/Widower,56,84,140
CHHATTISGARH,2004,Divorcee,3,8,11
CHHATTISGARH,2004,Seperated,33,22,55
CHHATTISGARH,2004,Total,2986,1509,4495
CHHATTISGARH,2005,Never Married,519,332,851
CHHATTISGARH,2005,Married,2672,1130,3802
CHHATTISGARH,2005,Widowed/Widower,82,78,160
CHHATTISGARH,2005,Divorcee,15,10,25
CHHATTISGARH,2005,Seperated,17,26,43
CHHATTISGARH,2005,Total,3305,1576,4881
CHHATTISGARH,2006,Never Married,766,431,1197
CHHATTISGARH,2006,Married,2216,1047,3263
CHHATTISGARH,2006,Widowed/Widower,70,83,153
CHHATTISGARH,2006,Divorcee,0,0,0
CHHATTISGARH,2006,Seperated,8,5,13
CHHATTISGARH,2006,Total,3060,1566,4626
CHHATTISGARH,2007,Never Married,646,327,973
CHHATTISGARH,2007,Married,2520,1179,3699
CHHATTISGARH,2007,Widowed/Widower,78,69,147
CHHATTISGARH,2007,Divorcee,2,3,5
CHHATTISGARH,2007,Seperated,10,5,15
CHHATTISGARH,2007,Total,3256,1583,4839
CHHATTISGARH,2008,Never Married,698,379,1077
CHHATTISGARH,2008,Married,2430,1149,3579
CHHATTISGARH,2008,Widowed/Widower,93,148,241
CHHATTISGARH,2008,Divorcee,4,6,10
CHHATTISGARH,2008,Seperated,23,15,38
CHHATTISGARH,2008,Total,3248,1697,4945
CHHATTISGARH,2009,Never Married,746,408,1154
CHHATTISGARH,2009,Married,3106,1365,4471
CHHATTISGARH,2009,Widowed/Widower,89,135,224
CHHATTISGARH,2009,Divorcee,2,7,9
CHHATTISGARH,2009,Seperated,11,14,25
CHHATTISGARH,2009,Total,3954,1929,5883
CHHATTISGARH,2010,Never Married,1381,641,2022
CHHATTISGARH,2010,Married,3064,1210,4274
CHHATTISGARH,2010,Widowed/Widower,89,120,209
CHHATTISGARH,2010,Divorcee,2,2,4
CHHATTISGARH,2010,Seperated,9,4,13
CHHATTISGARH,2010,Total,4545,1977,6522
CHHATTISGARH,2011,Never Married,1491,690,2181
CHHATTISGARH,2011,Married,2865,1366,4231
CHHATTISGARH,2011,Widowed/Widower,116,118,234
CHHATTISGARH,2011,Divorcee,12,12,24
CHHATTISGARH,2011,Seperated,43,43,86
CHHATTISGARH,2011,Total,4527,2229,6756
CHHATTISGARH,2012,Never Married,1085,456,1541
CHHATTISGARH,2012,Married,2696,1053,3749
CHHATTISGARH,2012,Widowed/Widower,137,77,214
CHHATTISGARH,2012,Divorcee,34,22,56
CHHATTISGARH,2012,Seperated,62,32,94
CHHATTISGARH,2012,Total,4014,1640,5654
GOA,2001,Never Married,60,29,89
GOA,2001,Married,98,55,153
GOA,2001,Widowed/Widower,4,5,9
GOA,2001,Divorcee,0,0,0
GOA,2001,Seperated,5,0,5
GOA,2001,Total,167,89,256
GOA,2002,Never Married,101,30,131
GOA,2002,Married,122,47,169
GOA,2002,Widowed/Widower,3,5,8
GOA,2002,Divorcee,0,0,0
GOA,2002,Seperated,0,1,1
GOA,2002,Total,226,83,309
GOA,2003,Never Married,92,32,124
GOA,2003,Married,115,53,168
GOA,2003,Widowed/Widower,6,2,8
GOA,2003,Divorcee,0,0,0
GOA,2003,Seperated,0,0,0
GOA,2003,Total,213,87,300
GOA,2004,Never Married,87,34,121
GOA,2004,Married,123,65,188
GOA,2004,Widowed/Widower,1,3,4
GOA,2004,Divorcee,0,0,0
GOA,2004,Seperated,1,0,1
GOA,2004,Total,212,102,314
GOA,2005,Never Married,82,32,114
GOA,2005,Married,114,50,164
GOA,2005,Widowed/Widower,1,2,3
GOA,2005,Divorcee,0,0,0
GOA,2005,Seperated,0,1,1
GOA,2005,Total,197,85,282
GOA,2006,Never Married,74,36,110
GOA,2006,Married,106,51,157
GOA,2006,Widowed/Widower,3,5,8
GOA,2006,Divorcee,0,0,0
GOA,2006,Seperated,0,0,0
GOA,2006,Total,183,92,275
GOA,2007,Never Married,66,28,94
GOA,2007,Married,111,58,169
GOA,2007,Widowed/Widower,1,6,7
GOA,2007,Divorcee,0,0,0
GOA,2007,Seperated,0,0,0
GOA,2007,Total,178,92,270
GOA,2008,Never Married,65,34,99
GOA,2008,Married,105,64,169
GOA,2008,Widowed/Widower,1,3,4
GOA,2008,Divorcee,6,3,9
GOA,2008,Seperated,6,0,6
GOA,2008,Total,183,104,287
GOA,2009,Never Married,70,31,101
GOA,2009,Married,99,58,157
GOA,2009,Widowed/Widower,2,4,6
GOA,2009,Divorcee,6,1,7
GOA,2009,Seperated,7,0,7
GOA,2009,Total,184,94,278
GOA,2010,Never Married,88,27,115
GOA,2010,Married,127,55,182
GOA,2010,Widowed/Widower,3,3,6
GOA,2010,Divorcee,1,0,1
GOA,2010,Seperated,17,1,18
GOA,2010,Total,236,86,322
GOA,2011,Never Married,78,38,116
GOA,2011,Married,117,57,174
GOA,2011,Widowed/Widower,0,2,2
GOA,2011,Divorcee,0,1,1
GOA,2011,Seperated,0,0,0
GOA,2011,Total,195,98,293
GOA,2012,Never Married,72,30,102
GOA,2012,Married,112,58,170
GOA,2012,Widowed/Widower,10,5,15
GOA,2012,Divorcee,2,0,2
GOA,2012,Seperated,0,0,0
GOA,2012,Total,196,93,289
GUJARAT,2001,Never Married,581,449,1030
GUJARAT,2001,Married,1948,1562,3510
GUJARAT,2001,Widowed/Widower,89,109,198
GUJARAT,2001,Divorcee,13,12,25
GUJARAT,2001,Seperated,18,10,28
GUJARAT,2001,Total,2649,2142,4791
GUJARAT,2002,Never Married,612,439,1051
GUJARAT,2002,Married,1952,1381,3333
GUJARAT,2002,Widowed/Widower,93,95,188
GUJARAT,2002,Divorcee,18,8,26
GUJARAT,2002,Seperated,31,15,46
GUJARAT,2002,Total,2706,1938,4644
GUJARAT,2003,Never Married,505,369,874
GUJARAT,2003,Married,1963,1395,3358
GUJARAT,2003,Widowed/Widower,113,110,223
GUJARAT,2003,Divorcee,35,27,62
GUJARAT,2003,Seperated,34,15,49
GUJARAT,2003,Total,2650,1916,4566
GUJARAT,2004,Never Married,589,376,965
GUJARAT,2004,Married,2049,1397,3446
GUJARAT,2004,Widowed/Widower,104,101,205
GUJARAT,2004,Divorcee,37,31,68
GUJARAT,2004,Seperated,71,21,92
GUJARAT,2004,Total,2850,1926,4776
GUJARAT,2005,Never Married,548,396,944
GUJARAT,2005,Married,2092,1294,3386
GUJARAT,2005,Widowed/Widower,160,124,284
GUJARAT,2005,Divorcee,28,20,48
GUJARAT,2005,Seperated,74,29,103
GUJARAT,2005,Total,2902,1863,4765
GUJARAT,2006,Never Married,657,474,1131
GUJARAT,2006,Married,2120,1333,3453
GUJARAT,2006,Widowed/Widower,156,120,276
GUJARAT,2006,Divorcee,41,36,77
GUJARAT,2006,Seperated,74,24,98
GUJARAT,2006,Total,3048,1987,5035
GUJARAT,2007,Never Married,652,444,1096
GUJARAT,2007,Married,2451,1549,4000
GUJARAT,2007,Widowed/Widower,131,126,257
GUJARAT,2007,Divorcee,47,49,96
GUJARAT,2007,Seperated,94,37,131
GUJARAT,2007,Total,3375,2205,5580
GUJARAT,2008,Never Married,776,483,1259
GUJARAT,2008,Married,2723,1754,4477
GUJARAT,2008,Widowed/Widower,125,118,243
GUJARAT,2008,Divorcee,36,49,85
GUJARAT,2008,Seperated,75,26,101
GUJARAT,2008,Total,3735,2430,6165
GUJARAT,2009,Never Married,707,489,1196
GUJARAT,2009,Married,2693,1800,4493
GUJARAT,2009,Widowed/Widower,152,121,273
GUJARAT,2009,Divorcee,53,54,107
GUJARAT,2009,Seperated,66,21,87
GUJARAT,2009,Total,3671,2485,6156
GUJARAT,2010,Never Married,818,557,1375
GUJARAT,2010,Married,2683,1613,4296
GUJARAT,2010,Widowed/Widower,171,142,313
GUJARAT,2010,Divorcee,50,57,107
GUJARAT,2010,Seperated,91,25,116
GUJARAT,2010,Total,3813,2394,6207
GUJARAT,2011,Never Married,838,591,1429
GUJARAT,2011,Married,2732,1709,4441
GUJARAT,2011,Widowed/Widower,225,115,340
GUJARAT,2011,Divorcee,50,34,84
GUJARAT,2011,Seperated,67,21,88
GUJARAT,2011,Total,3912,2470,6382
GUJARAT,2012,Never Married,984,641,1625
GUJARAT,2012,Married,3047,1903,4950
GUJARAT,2012,Widowed/Widower,184,130,314
GUJARAT,2012,Divorcee,63,47,110
GUJARAT,2012,Seperated,84,27,111
GUJARAT,2012,Total,4362,2748,7110
HARYANA,2001,Never Married,228,76,304
HARYANA,2001,Married,1008,487,1495
HARYANA,2001,Widowed/Widower,74,40,114
HARYANA,2001,Divorcee,10,24,34
HARYANA,2001,Seperated,44,16,60
HARYANA,2001,Total,1364,643,2007
HARYANA,2002,Never Married,214,76,290
HARYANA,2002,Married,1252,511,1763
HARYANA,2002,Widowed/Widower,53,19,72
HARYANA,2002,Divorcee,11,14,25
HARYANA,2002,Seperated,40,10,50
HARYANA,2002,Total,1570,630,2200
HARYANA,2003,Never Married,257,99,356
HARYANA,2003,Married,1246,449,1695
HARYANA,2003,Widowed/Widower,55,30,85
HARYANA,2003,Divorcee,12,24,36
HARYANA,2003,Seperated,43,12,55
HARYANA,2003,Total,1613,614,2227
HARYANA,2004,Never Married,218,81,299
HARYANA,2004,Married,1163,474,1637
HARYANA,2004,Widowed/Widower,47,25,72
HARYANA,2004,Divorcee,8,16,24
HARYANA,2004,Seperated,18,32,50
HARYANA,2004,Total,1454,628,2082
HARYANA,2005,Never Married,227,70,297
HARYANA,2005,Married,1180,460,1640
HARYANA,2005,Widowed/Widower,56,18,74
HARYANA,2005,Divorcee,8,1,9
HARYANA,2005,Seperated,22,4,26
HARYANA,2005,Total,1493,553,2046
HARYANA,2006,Never Married,314,106,420
HARYANA,2006,Married,1342,407,1749
HARYANA,2006,Widowed/Widower,81,28,109
HARYANA,2006,Divorcee,4,5,9
HARYANA,2006,Seperated,25,4,29
HARYANA,2006,Total,1766,550,2316
HARYANA,2007,Never Married,384,106,490
HARYANA,2007,Married,1370,428,1798
HARYANA,2007,Widowed/Widower,69,37,106
HARYANA,2007,Divorcee,8,5,13
HARYANA,2007,Seperated,21,5,26
HARYANA,2007,Total,1852,581,2433
HARYANA,2008,Never Married,342,139,481
HARYANA,2008,Married,1492,479,1971
HARYANA,2008,Widowed/Widower,96,52,148
HARYANA,2008,Divorcee,19,8,27
HARYANA,2008,Seperated,25,4,29
HARYANA,2008,Total,1974,682,2656
HARYANA,2009,Never Married,317,121,438
HARYANA,2009,Married,1381,518,1899
HARYANA,2009,Widowed/Widower,87,38,125
HARYANA,2009,Divorcee,10,3,13
HARYANA,2009,Seperated,20,8,28
HARYANA,2009,Total,1815,688,2503
HARYANA,2010,Never Married,337,133,470
HARYANA,2010,Married,1434,488,1922
HARYANA,2010,Widowed/Widower,76,43,119
HARYANA,2010,Divorcee,8,3,11
HARYANA,2010,Seperated,323,50,373
HARYANA,2010,Total,2178,717,2895
HARYANA,2011,Never Married,651,202,853
HARYANA,2011,Married,1676,509,2185
HARYANA,2011,Widowed/Widower,124,61,185
HARYANA,2011,Divorcee,7,6,13
HARYANA,2011,Seperated,6,3,9
HARYANA,2011,Total,2464,781,3245
HARYANA,2012,Never Married,550,155,705
HARYANA,2012,Married,1371,528,1899
HARYANA,2012,Widowed/Widower,105,42,147
HARYANA,2012,Divorcee,6,5,11
HARYANA,2012,Seperated,39,26,65
HARYANA,2012,Total,2071,756,2827
HIMACHAL PRADESH,2001,Never Married,42,28,70
HIMACHAL PRADESH,2001,Married,126,94,220
HIMACHAL PRADESH,2001,Widowed/Widower,2,2,4
HIMACHAL PRADESH,2001,Divorcee,3,3,6
HIMACHAL PRADESH,2001,Seperated,4,3,7
HIMACHAL PRADESH,2001,Total,177,130,307
HIMACHAL PRADESH,2002,Never Married,59,25,84
HIMACHAL PRADESH,2002,Married,140,93,233
HIMACHAL PRADESH,2002,Widowed/Widower,4,7,11
HIMACHAL PRADESH,2002,Divorcee,1,1,2
HIMACHAL PRADESH,2002,Seperated,4,0,4
HIMACHAL PRADESH,2002,Total,208,126,334
HIMACHAL PRADESH,2003,Never Married,64,38,102
HIMACHAL PRADESH,2003,Married,162,102,264
HIMACHAL PRADESH,2003,Widowed/Widower,6,2,8
HIMACHAL PRADESH,2003,Divorcee,0,2,2
HIMACHAL PRADESH,2003,Seperated,8,2,10
HIMACHAL PRADESH,2003,Total,240,146,386
HIMACHAL PRADESH,2004,Never Married,70,30,100
HIMACHAL PRADESH,2004,Married,148,94,242
HIMACHAL PRADESH,2004,Widowed/Widower,12,7,19
HIMACHAL PRADESH,2004,Divorcee,4,1,5
HIMACHAL PRADESH,2004,Seperated,2,3,5
HIMACHAL PRADESH,2004,Total,236,135,371
HIMACHAL PRADESH,2005,Never Married,69,39,108
HIMACHAL PRADESH,2005,Married,119,86,205
HIMACHAL PRADESH,2005,Widowed/Widower,2,5,7
HIMACHAL PRADESH,2005,Divorcee,5,2,7
HIMACHAL PRADESH,2005,Seperated,19,13,32
HIMACHAL PRADESH,2005,Total,214,145,359
HIMACHAL PRADESH,2006,Never Married,82,50,132
HIMACHAL PRADESH,2006,Married,212,99,311
HIMACHAL PRADESH,2006,Widowed/Widower,3,4,7
HIMACHAL PRADESH,2006,Divorcee,0,0,0
HIMACHAL PRADESH,2006,Seperated,4,3,7
HIMACHAL PRADESH,2006,Total,301,156,457
HIMACHAL PRADESH,2007,Never Married,65,38,103
HIMACHAL PRADESH,2007,Married,188,100,288
HIMACHAL PRADESH,2007,Widowed/Widower,1,5,6
HIMACHAL PRADESH,2007,Divorcee,1,0,1
HIMACHAL PRADESH,2007,Seperated,3,1,4
HIMACHAL PRADESH,2007,Total,258,144,402
HIMACHAL PRADESH,2008,Never Married,85,48,133
HIMACHAL PRADESH,2008,Married,310,147,457
HIMACHAL PRADESH,2008,Widowed/Widower,10,14,24
HIMACHAL PRADESH,2008,Divorcee,3,0,3
HIMACHAL PRADESH,2008,Seperated,9,4,13
HIMACHAL PRADESH,2008,Total,417,213,630
HIMACHAL PRADESH,2009,Never Married,79,44,123
HIMACHAL PRADESH,2009,Married,266,136,402
HIMACHAL PRADESH,2009,Widowed/Widower,17,11,28
HIMACHAL PRADESH,2009,Divorcee,0,0,0
HIMACHAL PRADESH,2009,Seperated,4,3,7
HIMACHAL PRADESH,2009,Total,366,194,560
HIMACHAL PRADESH,2010,Never Married,91,55,146
HIMACHAL PRADESH,2010,Married,238,124,362
HIMACHAL PRADESH,2010,Widowed/Widower,13,8,21
HIMACHAL PRADESH,2010,Divorcee,1,0,1
HIMACHAL PRADESH,2010,Seperated,5,7,12
HIMACHAL PRADESH,2010,Total,348,194,542
HIMACHAL PRADESH,2011,Never Married,73,49,122
HIMACHAL PRADESH,2011,Married,188,114,302
HIMACHAL PRADESH,2011,Widowed/Widower,3,3,6
HIMACHAL PRADESH,2011,Divorcee,0,0,0
HIMACHAL PRADESH,2011,Seperated,5,8,13
HIMACHAL PRADESH,2011,Total,269,174,443
HIMACHAL PRADESH,2012,Never Married,91,37,128
HIMACHAL PRADESH,2012,Married,237,113,350
HIMACHAL PRADESH,2012,Widowed/Widower,10,9,19
HIMACHAL PRADESH,2012,Divorcee,4,2,6
HIMACHAL PRADESH,2012,Seperated,12,13,25
HIMACHAL PRADESH,2012,Total,354,174,528
JAMMU & KASHMIR,2001,Never Married,11,15,26
JAMMU & KASHMIR,2001,Married,74,45,119
JAMMU & KASHMIR,2001,Widowed/Widower,6,2,8
JAMMU & KASHMIR,2001,Divorcee,0,0,0
JAMMU & KASHMIR,2001,Seperated,0,0,0
JAMMU & KASHMIR,2001,Total,91,62,153
JAMMU & KASHMIR,2002,Never Married,22,18,40
JAMMU & KASHMIR,2002,Married,63,60,123
JAMMU & KASHMIR,2002,Widowed/Widower,5,2,7
JAMMU & KASHMIR,2002,Divorcee,1,5,6
JAMMU & KASHMIR,2002,Seperated,5,3,8
JAMMU & KASHMIR,2002,Total,96,88,184
JAMMU & KASHMIR,2003,Never Married,21,19,40
JAMMU & KASHMIR,2003,Married,34,43,77
JAMMU & KASHMIR,2003,Widowed/Widower,2,5,7
JAMMU & KASHMIR,2003,Divorcee,3,2,5
JAMMU & KASHMIR,2003,Seperated,3,6,9
JAMMU & KASHMIR,2003,Total,63,75,138
JAMMU & KASHMIR,2004,Never Married,15,15,30
JAMMU & KASHMIR,2004,Married,31,44,75
JAMMU & KASHMIR,2004,Widowed/Widower,3,0,3
JAMMU & KASHMIR,2004,Divorcee,0,0,0
JAMMU & KASHMIR,2004,Seperated,2,2,4
JAMMU & KASHMIR,2004,Total,51,61,112
JAMMU & KASHMIR,2005,Never Married,56,23,79
JAMMU & KASHMIR,2005,Married,112,58,170
JAMMU & KASHMIR,2005,Widowed/Widower,0,3,3
JAMMU & KASHMIR,2005,Divorcee,0,2,2
JAMMU & KASHMIR,2005,Seperated,28,12,40
JAMMU & KASHMIR,2005,Total,196,98,294
JAMMU & KASHMIR,2006,Never Married,53,42,95
JAMMU & KASHMIR,2006,Married,95,58,153
JAMMU & KASHMIR,2006,Widowed/Widower,0,3,3
JAMMU & KASHMIR,2006,Divorcee,0,5,5
JAMMU & KASHMIR,2006,Seperated,4,2,6
JAMMU & KASHMIR,2006,Total,152,110,262
JAMMU & KASHMIR,2007,Never Married,50,23,73
JAMMU & KASHMIR,2007,Married,101,54,155
JAMMU & KASHMIR,2007,Widowed/Widower,0,2,2
JAMMU & KASHMIR,2007,Divorcee,0,2,2
JAMMU & KASHMIR,2007,Seperated,2,0,2
JAMMU & KASHMIR,2007,Total,153,81,234
JAMMU & KASHMIR,2008,Never Married,50,36,86
JAMMU & KASHMIR,2008,Married,127,94,221
JAMMU & KASHMIR,2008,Widowed/Widower,0,0,0
JAMMU & KASHMIR,2008,Divorcee,0,3,3
JAMMU & KASHMIR,2008,Seperated,0,0,0
JAMMU & KASHMIR,2008,Total,177,133,310
JAMMU & KASHMIR,2009,Never Married,62,63,125
JAMMU & KASHMIR,2009,Married,97,83,180
JAMMU & KASHMIR,2009,Widowed/Widower,6,5,11
JAMMU & KASHMIR,2009,Divorcee,0,0,0
JAMMU & KASHMIR,2009,Seperated,3,2,5
JAMMU & KASHMIR,2009,Total,168,153,321
JAMMU & KASHMIR,2010,Never Married,42,61,103
JAMMU & KASHMIR,2010,Married,72,71,143
JAMMU & KASHMIR,2010,Widowed/Widower,0,1,1
JAMMU & KASHMIR,2010,Divorcee,0,0,0
JAMMU & KASHMIR,2010,Seperated,8,4,12
JAMMU & KASHMIR,2010,Total,122,137,259
JAMMU & KASHMIR,2011,Never Married,38,59,97
JAMMU & KASHMIR,2011,Married,83,69,152
JAMMU & KASHMIR,2011,Widowed/Widower,7,5,12
JAMMU & KASHMIR,2011,Divorcee,6,2,8
JAMMU & KASHMIR,2011,Seperated,10,8,18
JAMMU & KASHMIR,2011,Total,144,143,287
JAMMU & KASHMIR,2012,Never Married,59,67,126
JAMMU & KASHMIR,2012,Married,110,128,238
JAMMU & KASHMIR,2012,Widowed/Widower,5,6,11
JAMMU & KASHMIR,2012,Divorcee,5,12,17
JAMMU & KASHMIR,2012,Seperated,13,9,22
JAMMU & KASHMIR,2012,Total,192,222,414
JHARKHAND,2001,Never Married,20,15,35
JHARKHAND,2001,Married,107,85,192
JHARKHAND,2001,Widowed/Widower,1,2,3
JHARKHAND,2001,Divorcee,1,1,2
JHARKHAND,2001,Seperated,12,6,18
JHARKHAND,2001,Total,141,109,250
JHARKHAND,2002,Never Married,14,14,28
JHARKHAND,2002,Married,84,85,169
JHARKHAND,2002,Widowed/Widower,24,10,34
JHARKHAND,2002,Divorcee,12,3,15
JHARKHAND,2002,Seperated,19,7,26
JHARKHAND,2002,Total,153,119,272
JHARKHAND,2003,Never Married,21,14,35
JHARKHAND,2003,Married,90,75,165
JHARKHAND,2003,Widowed/Widower,15,20,35
JHARKHAND,2003,Divorcee,12,3,15
JHARKHAND,2003,Seperated,15,7,22
JHARKHAND,2003,Total,153,119,272
JHARKHAND,2004,Never Married,44,29,73
JHARKHAND,2004,Married,139,115,254
JHARKHAND,2004,Widowed/Widower,24,13,37
JHARKHAND,2004,Divorcee,3,12,15
JHARKHAND,2004,Seperated,23,15,38
JHARKHAND,2004,Total,233,184,417
JHARKHAND,2005,Never Married,135,91,226
JHARKHAND,2005,Married,347,165,512
JHARKHAND,2005,Widowed/Widower,12,19,31
JHARKHAND,2005,Divorcee,4,4,8
JHARKHAND,2005,Seperated,25,6,31
JHARKHAND,2005,Total,523,285,808
JHARKHAND,2006,Never Married,199,104,303
JHARKHAND,2006,Married,290,211,501
JHARKHAND,2006,Widowed/Widower,17,11,28
JHARKHAND,2006,Divorcee,4,5,9
JHARKHAND,2006,Seperated,11,4,15
JHARKHAND,2006,Total,521,335,856
JHARKHAND,2007,Never Married,232,116,348
JHARKHAND,2007,Married,573,259,832
JHARKHAND,2007,Widowed/Widower,57,21,78
JHARKHAND,2007,Divorcee,14,7,21
JHARKHAND,2007,Seperated,4,6,10
JHARKHAND,2007,Total,880,409,1289
JHARKHAND,2008,Never Married,134,82,216
JHARKHAND,2008,Married,413,156,569
JHARKHAND,2008,Widowed/Widower,21,18,39
JHARKHAND,2008,Divorcee,5,28,33
JHARKHAND,2008,Seperated,29,25,54
JHARKHAND,2008,Total,602,309,911
JHARKHAND,2009,Never Married,192,110,302
JHARKHAND,2009,Married,491,215,706
JHARKHAND,2009,Widowed/Widower,45,28,73
JHARKHAND,2009,Divorcee,6,7,13
JHARKHAND,2009,Seperated,10,8,18
JHARKHAND,2009,Total,744,368,1112
JHARKHAND,2010,Never Married,222,142,364
JHARKHAND,2010,Married,522,254,776
JHARKHAND,2010,Widowed/Widower,37,25,62
JHARKHAND,2010,Divorcee,3,10,13
JHARKHAND,2010,Seperated,11,6,17
JHARKHAND,2010,Total,795,437,1232
JHARKHAND,2011,Never Married,205,103,308
JHARKHAND,2011,Married,591,250,841
JHARKHAND,2011,Widowed/Widower,18,24,42
JHARKHAND,2011,Divorcee,2,5,7
JHARKHAND,2011,Seperated,9,5,14
JHARKHAND,2011,Total,825,387,1212
JHARKHAND,2012,Never Married,302,165,467
JHARKHAND,2012,Married,453,273,726
JHARKHAND,2012,Widowed/Widower,37,22,59
JHARKHAND,2012,Divorcee,19,8,27
JHARKHAND,2012,Seperated,27,13,40
JHARKHAND,2012,Total,838,481,1319
KARNATAKA,2001,Never Married,1686,894,2580
KARNATAKA,2001,Married,5581,2607,8188
KARNATAKA,2001,Widowed/Widower,261,364,625
KARNATAKA,2001,Divorcee,32,35,67
KARNATAKA,2001,Seperated,311,110,421
KARNATAKA,2001,Total,7871,4010,11881
KARNATAKA,2002,Never Married,1794,969,2763
KARNATAKA,2002,Married,5865,2829,8694
KARNATAKA,2002,Widowed/Widower,138,193,331
KARNATAKA,2002,Divorcee,15,68,83
KARNATAKA,2002,Seperated,268,131,399
KARNATAKA,2002,Total,8080,4190,12270
KARNATAKA,2003,Never Married,1953,1007,2960
KARNATAKA,2003,Married,5912,2678,8590
KARNATAKA,2003,Widowed/Widower,251,206,457
KARNATAKA,2003,Divorcee,26,17,43
KARNATAKA,2003,Seperated,233,78,311
KARNATAKA,2003,Total,8375,3986,12361
KARNATAKA,2004,Never Married,1762,1000,2762
KARNATAKA,2004,Married,5841,2671,8512
KARNATAKA,2004,Widowed/Widower,159,165,324
KARNATAKA,2004,Divorcee,13,3,16
KARNATAKA,2004,Seperated,243,80,323
KARNATAKA,2004,Total,8018,3919,11937
KARNATAKA,2005,Never Married,1562,869,2431
KARNATAKA,2005,Married,5715,2706,8421
KARNATAKA,2005,Widowed/Widower,170,147,317
KARNATAKA,2005,Divorcee,28,24,52
KARNATAKA,2005,Seperated,232,104,336
KARNATAKA,2005,Total,7707,3850,11557
KARNATAKA,2006,Never Married,1761,956,2717
KARNATAKA,2006,Married,5806,2863,8669
KARNATAKA,2006,Widowed/Widower,204,214,418
KARNATAKA,2006,Divorcee,33,28,61
KARNATAKA,2006,Seperated,244,103,347
KARNATAKA,2006,Total,8048,4164,12212
KARNATAKA,2007,Never Married,1776,1052,2828
KARNATAKA,2007,Married,6137,2574,8711
KARNATAKA,2007,Widowed/Widower,320,187,507
KARNATAKA,2007,Divorcee,28,51,79
KARNATAKA,2007,Seperated,131,48,179
KARNATAKA,2007,Total,8392,3912,12304
KARNATAKA,2008,Never Married,1771,1026,2797
KARNATAKA,2008,Married,6068,2715,8783
KARNATAKA,2008,Widowed/Widower,184,180,364
KARNATAKA,2008,Divorcee,38,34,72
KARNATAKA,2008,Seperated,155,51,206
KARNATAKA,2008,Total,8216,4006,12222
KARNATAKA,2009,Never Married,1775,982,2757
KARNATAKA,2009,Married,5581,2397,7978
KARNATAKA,2009,Widowed/Widower,495,423,918
KARNATAKA,2009,Divorcee,75,49,124
KARNATAKA,2009,Seperated,283,135,418
KARNATAKA,2009,Total,8209,3986,12195
KARNATAKA,2010,Never Married,1921,1055,2976
KARNATAKA,2010,Married,5631,2730,8361
KARNATAKA,2010,Widowed/Widower,471,250,721
KARNATAKA,2010,Divorcee,125,84,209
KARNATAKA,2010,Seperated,259,125,384
KARNATAKA,2010,Total,8407,4244,12651
KARNATAKA,2011,Never Married,1873,996,2869
KARNATAKA,2011,Married,6002,2822,8824
KARNATAKA,2011,Widowed/Widower,283,184,467
KARNATAKA,2011,Divorcee,55,58,113
KARNATAKA,2011,Seperated,259,90,349
KARNATAKA,2011,Total,8472,4150,12622
KARNATAKA,2012,Never Married,1968,1032,3000
KARNATAKA,2012,Married,6216,2920,9136
KARNATAKA,2012,Widowed/Widower,180,133,313
KARNATAKA,2012,Divorcee,17,13,30
KARNATAKA,2012,Seperated,215,59,274
KARNATAKA,2012,Total,8596,4157,12753
KERALA,2001,Never Married,1187,601,1788
KERALA,2001,Married,5306,1915,7221
KERALA,2001,Widowed/Widower,119,148,267
KERALA,2001,Divorcee,45,66,111
KERALA,2001,Seperated,130,55,185
KERALA,2001,Total,6787,2785,9572
KERALA,2002,Never Married,1193,570,1763
KERALA,2002,Married,5600,1782,7382
KERALA,2002,Widowed/Widower,189,171,360
KERALA,2002,Divorcee,26,54,80
KERALA,2002,Seperated,157,68,225
KERALA,2002,Total,7165,2645,9810
KERALA,2003,Never Married,1236,587,1823
KERALA,2003,Married,5344,1678,7022
KERALA,2003,Widowed/Widower,187,173,360
KERALA,2003,Divorcee,36,20,56
KERALA,2003,Seperated,132,45,177
KERALA,2003,Total,6935,2503,9438
KERALA,2004,Never Married,1113,583,1696
KERALA,2004,Married,5120,1576,6696
KERALA,2004,Widowed/Widower,181,203,384
KERALA,2004,Divorcee,49,42,91
KERALA,2004,Seperated,135,51,186
KERALA,2004,Total,6598,2455,9053
KERALA,2005,Never Married,1238,528,1766
KERALA,2005,Married,5388,1675,7063
KERALA,2005,Widowed/Widower,128,150,278
KERALA,2005,Divorcee,16,20,36
KERALA,2005,Seperated,60,41,101
KERALA,2005,Total,6830,2414,9244
KERALA,2006,Never Married,999,479,1478
KERALA,2006,Married,5298,1697,6995
KERALA,2006,Widowed/Widower,143,181,324
KERALA,2006,Divorcee,36,41,77
KERALA,2006,Seperated,107,45,152
KERALA,2006,Total,6583,2443,9026
KERALA,2007,Never Married,996,433,1429
KERALA,2007,Married,5333,1666,6999
KERALA,2007,Widowed/Widower,142,183,325
KERALA,2007,Divorcee,40,47,87
KERALA,2007,Seperated,77,45,122
KERALA,2007,Total,6588,2374,8962
KERALA,2008,Never Married,891,446,1337
KERALA,2008,Married,4952,1723,6675
KERALA,2008,Widowed/Widower,154,182,336
KERALA,2008,Divorcee,36,37,73
KERALA,2008,Seperated,97,51,148
KERALA,2008,Total,6130,2439,8569
KERALA,2009,Never Married,932,417,1349
KERALA,2009,Married,5099,1754,6853
KERALA,2009,Widowed/Widower,163,164,327
KERALA,2009,Divorcee,38,35,73
KERALA,2009,Seperated,90,63,153
KERALA,2009,Total,6322,2433,8755
KERALA,2010,Never Married,909,424,1333
KERALA,2010,Married,5141,1575,6716
KERALA,2010,Widowed/Widower,172,164,336
KERALA,2010,Divorcee,33,40,73
KERALA,2010,Seperated,91,37,128
KERALA,2010,Total,6346,2240,8586
KERALA,2011,Never Married,985,408,1393
KERALA,2011,Married,4845,1548,6393
KERALA,2011,Widowed/Widower,197,160,357
KERALA,2011,Divorcee,91,45,136
KERALA,2011,Seperated,94,58,152
KERALA,2011,Total,6212,2219,8431
KERALA,2012,Never Married,1000,401,1401
KERALA,2012,Married,4998,1443,6441
KERALA,2012,Widowed/Widower,262,163,425
KERALA,2012,Divorcee,63,43,106
KERALA,2012,Seperated,86,31,117
KERALA,2012,Total,6409,2081,8490
MADHYA PRADESH,2001,Never Married,1125,862,1987
MADHYA PRADESH,2001,Married,2260,2255,4515
MADHYA PRADESH,2001,Widowed/Widower,137,180,317
MADHYA PRADESH,2001,Divorcee,6,13,19
MADHYA PRADESH,2001,Seperated,8,14,22
MADHYA PRADESH,2001,Total,3536,3324,6860
MADHYA PRADESH,2002,Never Married,971,670,1641
MADHYA PRADESH,2002,Married,2353,2370,4723
MADHYA PRADESH,2002,Widowed/Widower,152,194,346
MADHYA PRADESH,2002,Divorcee,50,32,82
MADHYA PRADESH,2002,Seperated,53,54,107
MADHYA PRADESH,2002,Total,3579,3320,6899
MADHYA PRADESH,2003,Never Married,976,686,1662
MADHYA PRADESH,2003,Married,2335,2251,4586
MADHYA PRADESH,2003,Widowed/Widower,166,223,389
MADHYA PRADESH,2003,Divorcee,22,29,51
MADHYA PRADESH,2003,Seperated,39,35,74
MADHYA PRADESH,2003,Total,3538,3224,6762
MADHYA PRADESH,2004,Never Married,935,560,1495
MADHYA PRADESH,2004,Married,2462,2337,4799
MADHYA PRADESH,2004,Widowed/Widower,155,187,342
MADHYA PRADESH,2004,Divorcee,32,35,67
MADHYA PRADESH,2004,Seperated,50,42,92
MADHYA PRADESH,2004,Total,3634,3161,6795
MADHYA PRADESH,2005,Never Married,600,587,1187
MADHYA PRADESH,2005,Married,2031,1780,3811
MADHYA PRADESH,2005,Widowed/Widower,126,132,258
MADHYA PRADESH,2005,Divorcee,21,42,63
MADHYA PRADESH,2005,Seperated,73,56,129
MADHYA PRADESH,2005,Total,2851,2597,5448
MADHYA PRADESH,2006,Never Married,786,671,1457
MADHYA PRADESH,2006,Married,2515,2050,4565
MADHYA PRADESH,2006,Widowed/Widower,149,122,271
MADHYA PRADESH,2006,Divorcee,14,34,48
MADHYA PRADESH,2006,Seperated,39,55,94
MADHYA PRADESH,2006,Total,3503,2932,6435
MADHYA PRADESH,2007,Never Married,911,728,1639
MADHYA PRADESH,2007,Married,2425,1917,4342
MADHYA PRADESH,2007,Widowed/Widower,100,149,249
MADHYA PRADESH,2007,Divorcee,11,25,36
MADHYA PRADESH,2007,Seperated,23,40,63
MADHYA PRADESH,2007,Total,3470,2859,6329
MADHYA PRADESH,2008,Never Married,1302,854,2156
MADHYA PRADESH,2008,Married,2693,2020,4713
MADHYA PRADESH,2008,Widowed/Widower,182,199,381
MADHYA PRADESH,2008,Divorcee,73,69,142
MADHYA PRADESH,2008,Seperated,115,122,237
MADHYA PRADESH,2008,Total,4365,3264,7629
MADHYA PRADESH,2009,Never Married,1417,1002,2419
MADHYA PRADESH,2009,Married,3366,2735,6101
MADHYA PRADESH,2009,Widowed/Widower,269,200,469
MADHYA PRADESH,2009,Divorcee,29,20,49
MADHYA PRADESH,2009,Seperated,19,56,75
MADHYA PRADESH,2009,Total,5100,4013,9113
MADHYA PRADESH,2010,Never Married,1356,998,2354
MADHYA PRADESH,2010,Married,3426,2644,6070
MADHYA PRADESH,2010,Widowed/Widower,189,161,350
MADHYA PRADESH,2010,Divorcee,72,61,133
MADHYA PRADESH,2010,Seperated,44,52,96
MADHYA PRADESH,2010,Total,5087,3916,9003
MADHYA PRADESH,2011,Never Married,1474,1040,2514
MADHYA PRADESH,2011,Married,3589,2757,6346
MADHYA PRADESH,2011,Widowed/Widower,123,127,250
MADHYA PRADESH,2011,Divorcee,20,31,51
MADHYA PRADESH,2011,Seperated,34,64,98
MADHYA PRADESH,2011,Total,5240,4019,9259
MADHYA PRADESH,2012,Never Married,1592,1108,2700
MADHYA PRADESH,2012,Married,3860,2672,6532
MADHYA PRADESH,2012,Widowed/Widower,242,161,403
MADHYA PRADESH,2012,Divorcee,19,30,49
MADHYA PRADESH,2012,Seperated,61,30,91
MADHYA PRADESH,2012,Total,5774,4001,9775
MAHARASHTRA,2001,Never Married,1892,1102,2994
MAHARASHTRA,2001,Married,7015,3734,10749
MAHARASHTRA,2001,Widowed/Widower,247,280,527
MAHARASHTRA,2001,Divorcee,64,95,159
MAHARASHTRA,2001,Seperated,120,69,189
MAHARASHTRA,2001,Total,9338,5280,14618
MAHARASHTRA,2002,Never Married,2046,1106,3152
MAHARASHTRA,2002,Married,6988,3621,10609
MAHARASHTRA,2002,Widowed/Widower,283,241,524
MAHARASHTRA,2002,Divorcee,45,51,96
MAHARASHTRA,2002,Seperated,85,63,148
MAHARASHTRA,2002,Total,9447,5082,14529
MAHARASHTRA,2003,Never Married,1925,1012,2937
MAHARASHTRA,2003,Married,7477,3563,11040
MAHARASHTRA,2003,Widowed/Widower,320,302,622
MAHARASHTRA,2003,Divorcee,20,33,53
MAHARASHTRA,2003,Seperated,68,40,108
MAHARASHTRA,2003,Total,9810,4950,14760
MAHARASHTRA,2004,Never Married,2000,1054,3054
MAHARASHTRA,2004,Married,7525,3454,10979
MAHARASHTRA,2004,Widowed/Widower,246,260,506
MAHARASHTRA,2004,Divorcee,51,36,87
MAHARASHTRA,2004,Seperated,81,22,103
MAHARASHTRA,2004,Total,9903,4826,14729
MAHARASHTRA,2005,Never Married,1937,1108,3045
MAHARASHTRA,2005,Married,7232,3410,10642
MAHARASHTRA,2005,Widowed/Widower,346,250,596
MAHARASHTRA,2005,Divorcee,36,38,74
MAHARASHTRA,2005,Seperated,52,17,69
MAHARASHTRA,2005,Total,9603,4823,14426
MAHARASHTRA,2006,Never Married,1994,955,2949
MAHARASHTRA,2006,Married,8133,3707,11840
MAHARASHTRA,2006,Widowed/Widower,293,257,550
MAHARASHTRA,2006,Divorcee,35,37,72
MAHARASHTRA,2006,Seperated,55,28,83
MAHARASHTRA,2006,Total,10510,4984,15494
MAHARASHTRA,2007,Never Married,2019,949,2968
MAHARASHTRA,2007,Married,8024,3519,11543
MAHARASHTRA,2007,Widowed/Widower,295,230,525
MAHARASHTRA,2007,Divorcee,33,48,81
MAHARASHTRA,2007,Seperated,49,18,67
MAHARASHTRA,2007,Total,10420,4764,15184
MAHARASHTRA,2008,Never Married,1979,991,2970
MAHARASHTRA,2008,Married,7634,3176,10810
MAHARASHTRA,2008,Widowed/Widower,211,258,469
MAHARASHTRA,2008,Divorcee,28,42,70
MAHARASHTRA,2008,Seperated,37,18,55
MAHARASHTRA,2008,Total,9889,4485,14374
MAHARASHTRA,2009,Never Married,1995,1037,3032
MAHARASHTRA,2009,Married,7511,3235,10746
MAHARASHTRA,2009,Widowed/Widower,228,212,440
MAHARASHTRA,2009,Divorcee,20,20,40
MAHARASHTRA,2009,Seperated,31,11,42
MAHARASHTRA,2009,Total,9785,4515,14300
MAHARASHTRA,2010,Never Married,2372,1271,3643
MAHARASHTRA,2010,Married,8138,3538,11676
MAHARASHTRA,2010,Widowed/Widower,300,225,525
MAHARASHTRA,2010,Divorcee,31,18,49
MAHARASHTRA,2010,Seperated,17,6,23
MAHARASHTRA,2010,Total,10858,5058,15916
MAHARASHTRA,2011,Never Married,2211,1144,3355
MAHARASHTRA,2011,Married,8387,3696,12083
MAHARASHTRA,2011,Widowed/Widower,229,196,425
MAHARASHTRA,2011,Divorcee,35,21,56
MAHARASHTRA,2011,Seperated,25,3,28
MAHARASHTRA,2011,Total,10887,5060,15947
MAHARASHTRA,2012,Never Married,2261,1179,3440
MAHARASHTRA,2012,Married,8756,3370,12126
MAHARASHTRA,2012,Widowed/Widower,228,220,448
MAHARASHTRA,2012,Divorcee,29,26,55
MAHARASHTRA,2012,Seperated,30,13,43
MAHARASHTRA,2012,Total,11304,4808,16112
MANIPUR,2001,Never Married,12,9,21
MANIPUR,2001,Married,12,8,20
MANIPUR,2001,Widowed/Widower,0,0,0
MANIPUR,2001,Divorcee,0,0,0
MANIPUR,2001,Seperated,0,0,0
MANIPUR,2001,Total,24,17,41
MANIPUR,2002,Never Married,9,4,13
MANIPUR,2002,Married,21,5,26
MANIPUR,2002,Widowed/Widower,0,0,0
MANIPUR,2002,Divorcee,0,0,0
MANIPUR,2002,Seperated,0,0,0
MANIPUR,2002,Total,30,9,39
MANIPUR,2003,Never Married,9,3,12
MANIPUR,2003,Married,12,2,14
MANIPUR,2003,Widowed/Widower,0,0,0
MANIPUR,2003,Divorcee,0,0,0
MANIPUR,2003,Seperated,0,0,0
MANIPUR,2003,Total,21,5,26
MANIPUR,2004,Never Married,13,8,21
MANIPUR,2004,Married,19,1,20
MANIPUR,2004,Widowed/Widower,0,0,0
MANIPUR,2004,Divorcee,0,0,0
MANIPUR,2004,Seperated,0,0,0
MANIPUR,2004,Total,32,9,41
MANIPUR,2005,Never Married,8,2,10
MANIPUR,2005,Married,15,2,17
MANIPUR,2005,Widowed/Widower,0,0,0
MANIPUR,2005,Divorcee,0,0,0
MANIPUR,2005,Seperated,0,0,0
MANIPUR,2005,Total,23,4,27
MANIPUR,2006,Never Married,9,9,18
MANIPUR,2006,Married,14,3,17
MANIPUR,2006,Widowed/Widower,1,0,1
MANIPUR,2006,Divorcee,0,0,0
MANIPUR,2006,Seperated,0,0,0
MANIPUR,2006,Total,24,12,36
MANIPUR,2007,Never Married,10,1,11
MANIPUR,2007,Married,18,10,28
MANIPUR,2007,Widowed/Widower,0,0,0
MANIPUR,2007,Divorcee,0,0,0
MANIPUR,2007,Seperated,0,0,0
MANIPUR,2007,Total,28,11,39
MANIPUR,2008,Never Married,5,4,9
MANIPUR,2008,Married,18,7,25
MANIPUR,2008,Widowed/Widower,0,0,0
MANIPUR,2008,Divorcee,0,0,0
MANIPUR,2008,Seperated,0,0,0
MANIPUR,2008,Total,23,11,34
MANIPUR,2009,Never Married,7,4,11
MANIPUR,2009,Married,11,5,16
MANIPUR,2009,Widowed/Widower,0,0,0
MANIPUR,2009,Divorcee,0,0,0
MANIPUR,2009,Seperated,0,0,0
MANIPUR,2009,Total,18,9,27
MANIPUR,2010,Never Married,11,4,15
MANIPUR,2010,Married,13,8,21
MANIPUR,2010,Widowed/Widower,0,1,1
MANIPUR,2010,Divorcee,0,0,0
MANIPUR,2010,Seperated,0,0,0
MANIPUR,2010,Total,24,13,37
MANIPUR,2011,Never Married,6,6,12
MANIPUR,2011,Married,12,9,21
MANIPUR,2011,Widowed/Widower,0,0,0
MANIPUR,2011,Divorcee,0,0,0
MANIPUR,2011,Seperated,0,0,0
MANIPUR,2011,Total,18,15,33
MANIPUR,2012,Never Married,12,9,21
MANIPUR,2012,Married,11,8,19
MANIPUR,2012,Widowed/Widower,0,1,1
MANIPUR,2012,Divorcee,0,0,0
MANIPUR,2012,Seperated,0,0,0
MANIPUR,2012,Total,23,18,41
MEGHALAYA,2001,Never Married,29,8,37
MEGHALAYA,2001,Married,35,7,42
MEGHALAYA,2001,Widowed/Widower,5,2,7
MEGHALAYA,2001,Divorcee,0,0,0
MEGHALAYA,2001,Seperated,0,1,1
MEGHALAYA,2001,Total,69,18,87
MEGHALAYA,2002,Never Married,23,6,29
MEGHALAYA,2002,Married,26,11,37
MEGHALAYA,2002,Widowed/Widower,0,1,1
MEGHALAYA,2002,Divorcee,0,0,0
MEGHALAYA,2002,Seperated,0,0,0
MEGHALAYA,2002,Total,49,18,67
MEGHALAYA,2003,Never Married,9,6,15
MEGHALAYA,2003,Married,17,1,18
MEGHALAYA,2003,Widowed/Widower,5,2,7
MEGHALAYA,2003,Divorcee,0,0,0
MEGHALAYA,2003,Seperated,1,0,1
MEGHALAYA,2003,Total,32,9,41
MEGHALAYA,2004,Never Married,16,8,24
MEGHALAYA,2004,Married,20,8,28
MEGHALAYA,2004,Widowed/Widower,2,0,2
MEGHALAYA,2004,Divorcee,0,0,0
MEGHALAYA,2004,Seperated,1,0,1
MEGHALAYA,2004,Total,39,16,55
MEGHALAYA,2005,Never Married,17,7,24
MEGHALAYA,2005,Married,32,14,46
MEGHALAYA,2005,Widowed/Widower,0,0,0
MEGHALAYA,2005,Divorcee,0,0,0
MEGHALAYA,2005,Seperated,1,0,1
MEGHALAYA,2005,Total,50,21,71
MEGHALAYA,2006,Never Married,20,10,30
MEGHALAYA,2006,Married,46,13,59
MEGHALAYA,2006,Widowed/Widower,2,0,2
MEGHALAYA,2006,Divorcee,0,0,0
MEGHALAYA,2006,Seperated,1,0,1
MEGHALAYA,2006,Total,69,23,92
MEGHALAYA,2007,Never Married,30,14,44
MEGHALAYA,2007,Married,24,12,36
MEGHALAYA,2007,Widowed/Widower,2,0,2
MEGHALAYA,2007,Divorcee,1,0,1
MEGHALAYA,2007,Seperated,3,1,4
MEGHALAYA,2007,Total,60,27,87
MEGHALAYA,2008,Never Married,16,12,28
MEGHALAYA,2008,Married,36,14,50
MEGHALAYA,2008,Widowed/Widower,4,2,6
MEGHALAYA,2008,Divorcee,0,0,0
MEGHALAYA,2008,Seperated,1,0,1
MEGHALAYA,2008,Total,57,28,85
MEGHALAYA,2009,Never Married,15,16,31
MEGHALAYA,2009,Married,37,23,60
MEGHALAYA,2009,Widowed/Widower,6,3,9
MEGHALAYA,2009,Divorcee,8,3,11
MEGHALAYA,2009,Seperated,1,0,1
MEGHALAYA,2009,Total,67,45,112
MEGHALAYA,2010,Never Married,27,12,39
MEGHALAYA,2010,Married,50,15,65
MEGHALAYA,2010,Widowed/Widower,2,1,3
MEGHALAYA,2010,Divorcee,0,0,0
MEGHALAYA,2010,Seperated,1,0,1
MEGHALAYA,2010,Total,80,28,108
MEGHALAYA,2011,Never Married,55,18,73
MEGHALAYA,2011,Married,50,22,72
MEGHALAYA,2011,Widowed/Widower,4,2,6
MEGHALAYA,2011,Divorcee,2,0,2
MEGHALAYA,2011,Seperated,0,0,0
MEGHALAYA,2011,Total,111,42,153
MEGHALAYA,2012,Never Married,30,20,50
MEGHALAYA,2012,Married,58,16,74
MEGHALAYA,2012,Widowed/Widower,2,1,3
MEGHALAYA,2012,Divorcee,0,1,1
MEGHALAYA,2012,Seperated,0,0,0
MEGHALAYA,2012,Total,90,38,128
MIZORAM,2001,Never Married,21,4,25
MIZORAM,2001,Married,18,2,20
MIZORAM,2001,Widowed/Widower,0,0,0
MIZORAM,2001,Divorcee,6,2,8
MIZORAM,2001,Seperated,1,0,1
MIZORAM,2001,Total,46,8,54
MIZORAM,2002,Never Married,15,2,17
MIZORAM,2002,Married,32,7,39
MIZORAM,2002,Widowed/Widower,1,1,2
MIZORAM,2002,Divorcee,4,0,4
MIZORAM,2002,Seperated,4,0,4
MIZORAM,2002,Total,56,10,66
MIZORAM,2003,Never Married,20,2,22
MIZORAM,2003,Married,16,6,22
MIZORAM,2003,Widowed/Widower,0,0,0
MIZORAM,2003,Divorcee,0,0,0
MIZORAM,2003,Seperated,5,3,8
MIZORAM,2003,Total,41,11,52
MIZORAM,2004,Never Married,18,1,19
MIZORAM,2004,Married,26,5,31
MIZORAM,2004,Widowed/Widower,2,1,3
MIZORAM,2004,Divorcee,4,0,4
MIZORAM,2004,Seperated,3,0,3
MIZORAM,2004,Total,53,7,60
MIZORAM,2005,Never Married,17,4,21
MIZORAM,2005,Married,30,4,34
MIZORAM,2005,Widowed/Widower,0,0,0
MIZORAM,2005,Divorcee,0,0,0
MIZORAM,2005,Seperated,0,0,0
MIZORAM,2005,Total,47,8,55
MIZORAM,2006,Never Married,22,3,25
MIZORAM,2006,Married,35,7,42
MIZORAM,2006,Widowed/Widower,0,0,0
MIZORAM,2006,Divorcee,0,0,0
MIZORAM,2006,Seperated,3,0,3
MIZORAM,2006,Total,60,10,70
MIZORAM,2007,Never Married,4,1,5
MIZORAM,2007,Married,3,1,4
MIZORAM,2007,Widowed/Widower,0,1,1
MIZORAM,2007,Divorcee,13,2,15
MIZORAM,2007,Seperated,2,1,3
MIZORAM,2007,Total,22,6,28
MIZORAM,2008,Never Married,12,2,14
MIZORAM,2008,Married,21,2,23
MIZORAM,2008,Widowed/Widower,0,2,2
MIZORAM,2008,Divorcee,0,0,0
MIZORAM,2008,Seperated,2,0,2
MIZORAM,2008,Total,35,6,41
MIZORAM,2009,Never Married,31,4,35
MIZORAM,2009,Married,20,3,23
MIZORAM,2009,Widowed/Widower,2,0,2
MIZORAM,2009,Divorcee,2,0,2
MIZORAM,2009,Seperated,7,0,7
MIZORAM,2009,Total,62,7,69
MIZORAM,2010,Never Married,33,5,38
MIZORAM,2010,Married,16,4,20
MIZORAM,2010,Widowed/Widower,0,0,0
MIZORAM,2010,Divorcee,11,0,11
MIZORAM,2010,Seperated,7,0,7
MIZORAM,2010,Total,67,9,76
MIZORAM,2011,Never Married,27,5,32
MIZORAM,2011,Married,40,5,45
MIZORAM,2011,Widowed/Widower,0,2,2
MIZORAM,2011,Divorcee,9,1,10
MIZORAM,2011,Seperated,1,0,1
MIZORAM,2011,Total,77,13,90
MIZORAM,2012,Never Married,73,14,87
MIZORAM,2012,Married,44,0,44
MIZORAM,2012,Widowed/Widower,4,0,4
MIZORAM,2012,Divorcee,0,0,0
MIZORAM,2012,Seperated,36,2,38
MIZORAM,2012,Total,157,16,173
NAGALAND,2001,Never Married,10,5,15
NAGALAND,2001,Married,15,9,24
NAGALAND,2001,Widowed/Widower,0,1,1
NAGALAND,2001,Divorcee,0,0,0
NAGALAND,2001,Seperated,0,0,0
NAGALAND,2001,Total,25,15,40
NAGALAND,2002,Never Married,9,3,12
NAGALAND,2002,Married,10,4,14
NAGALAND,2002,Widowed/Widower,0,1,1
NAGALAND,2002,Divorcee,0,0,0
NAGALAND,2002,Seperated,0,0,0
NAGALAND,2002,Total,19,8,27
NAGALAND,2003,Never Married,3,1,4
NAGALAND,2003,Married,11,4,15
NAGALAND,2003,Widowed/Widower,0,0,0
NAGALAND,2003,Divorcee,0,0,0
NAGALAND,2003,Seperated,3,0,3
NAGALAND,2003,Total,17,5,22
NAGALAND,2004,Never Married,12,3,15
NAGALAND,2004,Married,13,3,16
NAGALAND,2004,Widowed/Widower,0,0,0
NAGALAND,2004,Divorcee,0,0,0
NAGALAND,2004,Seperated,0,0,0
NAGALAND,2004,Total,25,6,31
NAGALAND,2005,Never Married,10,3,13
NAGALAND,2005,Married,10,2,12
NAGALAND,2005,Widowed/Widower,0,0,0
NAGALAND,2005,Divorcee,0,0,0
NAGALAND,2005,Seperated,1,1,2
NAGALAND,2005,Total,21,6,27
NAGALAND,2006,Never Married,10,3,13
NAGALAND,2006,Married,9,6,15
NAGALAND,2006,Widowed/Widower,0,0,0
NAGALAND,2006,Divorcee,0,0,0
NAGALAND,2006,Seperated,0,0,0
NAGALAND,2006,Total,19,9,28
NAGALAND,2007,Never Married,8,3,11
NAGALAND,2007,Married,9,4,13
NAGALAND,2007,Widowed/Widower,0,0,0
NAGALAND,2007,Divorcee,0,0,0
NAGALAND,2007,Seperated,0,0,0
NAGALAND,2007,Total,17,7,24
NAGALAND,2008,Never Married,14,4,18
NAGALAND,2008,Married,18,6,24
NAGALAND,2008,Widowed/Widower,0,0,0
NAGALAND,2008,Divorcee,0,0,0
NAGALAND,2008,Seperated,0,0,0
NAGALAND,2008,Total,32,10,42
NAGALAND,2009,Never Married,13,2,15
NAGALAND,2009,Married,12,4,16
NAGALAND,2009,Widowed/Widower,0,0,0
NAGALAND,2009,Divorcee,0,0,0
NAGALAND,2009,Seperated,0,0,0
NAGALAND,2009,Total,25,6,31
NAGALAND,2010,Never Married,3,0,3
NAGALAND,2010,Married,8,1,9
NAGALAND,2010,Widowed/Widower,0,0,0
NAGALAND,2010,Divorcee,0,0,0
NAGALAND,2010,Seperated,0,0,0
NAGALAND,2010,Total,11,1,12
NAGALAND,2011,Never Married,10,3,13
NAGALAND,2011,Married,15,5,20
NAGALAND,2011,Widowed/Widower,0,0,0
NAGALAND,2011,Divorcee,0,0,0
NAGALAND,2011,Seperated,0,0,0
NAGALAND,2011,Total,25,8,33
NAGALAND,2012,Never Married,12,4,16
NAGALAND,2012,Married,11,2,13
NAGALAND,2012,Widowed/Widower,0,0,0
NAGALAND,2012,Divorcee,1,0,1
NAGALAND,2012,Seperated,0,0,0
NAGALAND,2012,Total,24,6,30
ODISHA,2001,Never Married,576,503,1079
ODISHA,2001,Married,1294,1181,2475
ODISHA,2001,Widowed/Widower,99,117,216
ODISHA,2001,Divorcee,13,33,46
ODISHA,2001,Seperated,107,129,236
ODISHA,2001,Total,2089,1963,4052
ODISHA,2002,Never Married,688,513,1201
ODISHA,2002,Married,1681,1008,2689
ODISHA,2002,Widowed/Widower,197,133,330
ODISHA,2002,Divorcee,25,33,58
ODISHA,2002,Seperated,40,70,110
ODISHA,2002,Total,2631,1757,4388
ODISHA,2003,Never Married,606,439,1045
ODISHA,2003,Married,1871,1047,2918
ODISHA,2003,Widowed/Widower,166,108,274
ODISHA,2003,Divorcee,40,47,87
ODISHA,2003,Seperated,57,39,96
ODISHA,2003,Total,2740,1680,4420
ODISHA,2004,Never Married,652,396,1048
ODISHA,2004,Married,1806,1097,2903
ODISHA,2004,Widowed/Widower,38,95,133
ODISHA,2004,Divorcee,15,46,61
ODISHA,2004,Seperated,33,37,70
ODISHA,2004,Total,2544,1671,4215
ODISHA,2005,Never Married,839,419,1258
ODISHA,2005,Married,1621,1016,2637
ODISHA,2005,Widowed/Widower,55,99,154
ODISHA,2005,Divorcee,4,39,43
ODISHA,2005,Seperated,35,81,116
ODISHA,2005,Total,2554,1654,4208
ODISHA,2006,Never Married,588,383,971
ODISHA,2006,Married,1686,1178,2864
ODISHA,2006,Widowed/Widower,67,74,141
ODISHA,2006,Divorcee,13,31,44
ODISHA,2006,Seperated,19,26,45
ODISHA,2006,Total,2373,1692,4065
ODISHA,2007,Never Married,792,453,1245
ODISHA,2007,Married,1589,1233,2822
ODISHA,2007,Widowed/Widower,71,92,163
ODISHA,2007,Divorcee,19,23,42
ODISHA,2007,Seperated,17,19,36
ODISHA,2007,Total,2488,1820,4308
ODISHA,2008,Never Married,802,392,1194
ODISHA,2008,Married,2205,1153,3358
ODISHA,2008,Widowed/Widower,74,112,186
ODISHA,2008,Divorcee,20,36,56
ODISHA,2008,Seperated,54,56,110
ODISHA,2008,Total,3155,1749,4904
ODISHA,2009,Never Married,741,468,1209
ODISHA,2009,Married,1645,1118,2763
ODISHA,2009,Widowed/Widower,113,128,241
ODISHA,2009,Divorcee,29,36,65
ODISHA,2009,Seperated,39,48,87
ODISHA,2009,Total,2567,1798,4365
ODISHA,2010,Never Married,633,446,1079
ODISHA,2010,Married,1624,1157,2781
ODISHA,2010,Widowed/Widower,90,111,201
ODISHA,2010,Divorcee,12,47,59
ODISHA,2010,Seperated,71,64,135
ODISHA,2010,Total,2430,1825,4255
ODISHA,2011,Never Married,778,530,1308
ODISHA,2011,Married,1935,1330,3265
ODISHA,2011,Widowed/Widower,216,168,384
ODISHA,2011,Divorcee,17,58,75
ODISHA,2011,Seperated,114,95,209
ODISHA,2011,Total,3060,2181,5241
ODISHA,2012,Never Married,835,563,1398
ODISHA,2012,Married,1911,1361,3272
ODISHA,2012,Widowed/Widower,67,123,190
ODISHA,2012,Divorcee,19,28,47
ODISHA,2012,Seperated,64,56,120
ODISHA,2012,Total,2896,2131,5027
PUNJAB,2001,Never Married,110,34,144
PUNJAB,2001,Married,234,104,338
PUNJAB,2001,Widowed/Widower,25,19,44
PUNJAB,2001,Divorcee,12,42,54
PUNJAB,2001,Seperated,15,53,68
PUNJAB,2001,Total,396,252,648
PUNJAB,2002,Never Married,109,28,137
PUNJAB,2002,Married,266,79,345
PUNJAB,2002,Widowed/Widower,19,1,20
PUNJAB,2002,Divorcee,0,1,1
PUNJAB,2002,Seperated,3,1,4
PUNJAB,2002,Total,397,110,507
PUNJAB,2003,Never Married,127,30,157
PUNJAB,2003,Married,201,78,279
PUNJAB,2003,Widowed/Widower,29,13,42
PUNJAB,2003,Divorcee,68,3,71
PUNJAB,2003,Seperated,81,1,82
PUNJAB,2003,Total,506,125,631
PUNJAB,2004,Never Married,176,37,213
PUNJAB,2004,Married,252,83,335
PUNJAB,2004,Widowed/Widower,62,8,70
PUNJAB,2004,Divorcee,14,1,15
PUNJAB,2004,Seperated,12,0,12
PUNJAB,2004,Total,516,129,645
PUNJAB,2005,Never Married,143,27,170
PUNJAB,2005,Married,297,77,374
PUNJAB,2005,Widowed/Widower,21,2,23
PUNJAB,2005,Divorcee,9,0,9
PUNJAB,2005,Seperated,12,0,12
PUNJAB,2005,Total,482,106,588
PUNJAB,2006,Never Married,187,48,235
PUNJAB,2006,Married,406,104,510
PUNJAB,2006,Widowed/Widower,7,7,14
PUNJAB,2006,Divorcee,4,0,4
PUNJAB,2006,Seperated,6,3,9
PUNJAB,2006,Total,610,162,772
PUNJAB,2007,Never Married,198,68,266
PUNJAB,2007,Married,418,138,556
PUNJAB,2007,Widowed/Widower,7,9,16
PUNJAB,2007,Divorcee,0,0,0
PUNJAB,2007,Seperated,9,0,9
PUNJAB,2007,Total,632,215,847
PUNJAB,2008,Never Married,220,70,290
PUNJAB,2008,Married,404,149,553
PUNJAB,2008,Widowed/Widower,10,6,16
PUNJAB,2008,Divorcee,4,1,5
PUNJAB,2008,Seperated,5,0,5
PUNJAB,2008,Total,643,226,869
PUNJAB,2009,Never Married,218,55,273
PUNJAB,2009,Married,392,146,538
PUNJAB,2009,Widowed/Widower,16,8,24
PUNJAB,2009,Divorcee,1,2,3
PUNJAB,2009,Seperated,8,1,9
PUNJAB,2009,Total,635,212,847
PUNJAB,2010,Never Married,251,74,325
PUNJAB,2010,Married,445,122,567
PUNJAB,2010,Widowed/Widower,14,4,18
PUNJAB,2010,Divorcee,6,1,7
PUNJAB,2010,Seperated,3,0,3
PUNJAB,2010,Total,719,201,920
PUNJAB,2011,Never Married,258,66,324
PUNJAB,2011,Married,485,142,627
PUNJAB,2011,Widowed/Widower,1,3,4
PUNJAB,2011,Divorcee,0,0,0
PUNJAB,2011,Seperated,11,0,11
PUNJAB,2011,Total,755,211,966
PUNJAB,2012,Never Married,299,70,369
PUNJAB,2012,Married,470,169,639
PUNJAB,2012,Widowed/Widower,4,3,7
PUNJAB,2012,Divorcee,1,4,5
PUNJAB,2012,Seperated,10,0,10
PUNJAB,2012,Total,784,246,1030
RAJASTHAN,2001,Never Married,507,323,830
RAJASTHAN,2001,Married,1356,816,2172
RAJASTHAN,2001,Widowed/Widower,57,66,123
RAJASTHAN,2001,Divorcee,10,10,20
RAJASTHAN,2001,Seperated,29,21,50
RAJASTHAN,2001,Total,1959,1236,3195
RAJASTHAN,2002,Never Married,588,280,868
RAJASTHAN,2002,Married,1422,799,2221
RAJASTHAN,2002,Widowed/Widower,45,52,97
RAJASTHAN,2002,Divorcee,12,8,20
RAJASTHAN,2002,Seperated,25,17,42
RAJASTHAN,2002,Total,2092,1156,3248
RAJASTHAN,2003,Never Married,639,306,945
RAJASTHAN,2003,Married,1665,890,2555
RAJASTHAN,2003,Widowed/Widower,62,45,107
RAJASTHAN,2003,Divorcee,9,17,26
RAJASTHAN,2003,Seperated,14,14,28
RAJASTHAN,2003,Total,2389,1272,3661
RAJASTHAN,2004,Never Married,605,243,848
RAJASTHAN,2004,Married,1828,922,2750
RAJASTHAN,2004,Widowed/Widower,35,36,71
RAJASTHAN,2004,Divorcee,7,13,20
RAJASTHAN,2004,Seperated,11,25,36
RAJASTHAN,2004,Total,2486,1239,3725
RAJASTHAN,2005,Never Married,924,256,1180
RAJASTHAN,2005,Married,1869,1015,2884
RAJASTHAN,2005,Widowed/Widower,48,25,73
RAJASTHAN,2005,Divorcee,6,6,12
RAJASTHAN,2005,Seperated,11,18,29
RAJASTHAN,2005,Total,2858,1320,4178
RAJASTHAN,2006,Never Married,871,332,1203
RAJASTHAN,2006,Married,1958,976,2934
RAJASTHAN,2006,Widowed/Widower,34,21,55
RAJASTHAN,2006,Divorcee,9,7,16
RAJASTHAN,2006,Seperated,38,17,55
RAJASTHAN,2006,Total,2910,1353,4263
RAJASTHAN,2007,Never Married,960,264,1224
RAJASTHAN,2007,Married,2112,946,3058
RAJASTHAN,2007,Widowed/Widower,53,37,90
RAJASTHAN,2007,Divorcee,11,13,24
RAJASTHAN,2007,Seperated,18,23,41
RAJASTHAN,2007,Total,3154,1283,4437
RAJASTHAN,2008,Never Married,1043,357,1400
RAJASTHAN,2008,Married,2421,1094,3515
RAJASTHAN,2008,Widowed/Widower,108,74,182
RAJASTHAN,2008,Divorcee,14,14,28
RAJASTHAN,2008,Seperated,16,25,41
RAJASTHAN,2008,Total,3602,1564,5166
RAJASTHAN,2009,Never Married,874,393,1267
RAJASTHAN,2009,Married,2527,1090,3617
RAJASTHAN,2009,Widowed/Widower,77,49,126
RAJASTHAN,2009,Divorcee,7,8,15
RAJASTHAN,2009,Seperated,26,14,40
RAJASTHAN,2009,Total,3511,1554,5065
RAJASTHAN,2010,Never Married,949,390,1339
RAJASTHAN,2010,Married,2300,1101,3401
RAJASTHAN,2010,Widowed/Widower,74,42,116
RAJASTHAN,2010,Divorcee,8,6,14
RAJASTHAN,2010,Seperated,34,16,50
RAJASTHAN,2010,Total,3365,1555,4920
RAJASTHAN,2011,Never Married,776,315,1091
RAJASTHAN,2011,Married,2163,958,3121
RAJASTHAN,2011,Widowed/Widower,47,38,85
RAJASTHAN,2011,Divorcee,8,5,13
RAJASTHAN,2011,Seperated,22,16,38
RAJASTHAN,2011,Total,3016,1332,4348
RAJASTHAN,2012,Never Married,846,429,1275
RAJASTHAN,2012,Married,2273,1082,3355
RAJASTHAN,2012,Widowed/Widower,72,51,123
RAJASTHAN,2012,Divorcee,19,14,33
RAJASTHAN,2012,Seperated,17,18,35
RAJASTHAN,2012,Total,3227,1594,4821
SIKKIM,2001,Never Married,16,14,30
SIKKIM,2001,Married,41,17,58
SIKKIM,2001,Widowed/Widower,2,0,2
SIKKIM,2001,Divorcee,0,0,0
SIKKIM,2001,Seperated,3,1,4
SIKKIM,2001,Total,62,32,94
SIKKIM,2002,Never Married,12,6,18
SIKKIM,2002,Married,29,8,37
SIKKIM,2002,Widowed/Widower,6,3,9
SIKKIM,2002,Divorcee,3,2,5
SIKKIM,2002,Seperated,4,5,9
SIKKIM,2002,Total,54,24,78
SIKKIM,2003,Never Married,26,9,35
SIKKIM,2003,Married,38,26,64
SIKKIM,2003,Widowed/Widower,3,2,5
SIKKIM,2003,Divorcee,0,0,0
SIKKIM,2003,Seperated,1,0,1
SIKKIM,2003,Total,68,37,105
SIKKIM,2004,Never Married,0,1,1
SIKKIM,2004,Married,56,41,97
SIKKIM,2004,Widowed/Widower,0,0,0
SIKKIM,2004,Divorcee,0,0,0
SIKKIM,2004,Seperated,0,0,0
SIKKIM,2004,Total,56,42,98
SIKKIM,2005,Never Married,23,15,38
SIKKIM,2005,Married,38,23,61
SIKKIM,2005,Widowed/Widower,0,5,5
SIKKIM,2005,Divorcee,0,2,2
SIKKIM,2005,Seperated,1,2,3
SIKKIM,2005,Total,62,47,109
SIKKIM,2006,Never Married,37,14,51
SIKKIM,2006,Married,34,30,64
SIKKIM,2006,Widowed/Widower,18,2,20
SIKKIM,2006,Divorcee,0,1,1
SIKKIM,2006,Seperated,9,0,9
SIKKIM,2006,Total,98,47,145
SIKKIM,2007,Never Married,17,7,24
SIKKIM,2007,Married,40,20,60
SIKKIM,2007,Widowed/Widower,7,5,12
SIKKIM,2007,Divorcee,11,2,13
SIKKIM,2007,Seperated,9,4,13
SIKKIM,2007,Total,84,38,122
SIKKIM,2008,Never Married,72,18,90
SIKKIM,2008,Married,138,47,185
SIKKIM,2008,Widowed/Widower,4,4,8
SIKKIM,2008,Divorcee,2,2,4
SIKKIM,2008,Seperated,0,0,0
SIKKIM,2008,Total,216,71,287
SIKKIM,2009,Never Married,49,59,108
SIKKIM,2009,Married,28,29,57
SIKKIM,2009,Widowed/Widower,18,13,31
SIKKIM,2009,Divorcee,9,9,18
SIKKIM,2009,Seperated,18,9,27
SIKKIM,2009,Total,122,119,241
SIKKIM,2010,Never Married,96,15,111
SIKKIM,2010,Married,117,17,134
SIKKIM,2010,Widowed/Widower,10,7,17
SIKKIM,2010,Divorcee,5,2,7
SIKKIM,2010,Seperated,7,4,11
SIKKIM,2010,Total,235,45,280
SIKKIM,2011,Never Married,17,29,46
SIKKIM,2011,Married,82,36,118
SIKKIM,2011,Widowed/Widower,2,7,9
SIKKIM,2011,Divorcee,3,3,6
SIKKIM,2011,Seperated,3,2,5
SIKKIM,2011,Total,107,77,184
SIKKIM,2012,Never Married,23,20,43
SIKKIM,2012,Married,45,45,90
SIKKIM,2012,Widowed/Widower,7,10,17
SIKKIM,2012,Divorcee,13,5,18
SIKKIM,2012,Seperated,8,5,13
SIKKIM,2012,Total,96,85,181
TAMIL NADU,2001,Never Married,1379,795,2174
TAMIL NADU,2001,Married,4944,2833,7777
TAMIL NADU,2001,Widowed/Widower,377,304,681
TAMIL NADU,2001,Divorcee,49,35,84
TAMIL NADU,2001,Seperated,379,195,574
TAMIL NADU,2001,Total,7128,4162,11290
TAMIL NADU,2002,Never Married,1255,817,2072
TAMIL NADU,2002,Married,4863,2817,7680
TAMIL NADU,2002,Widowed/Widower,405,307,712
TAMIL NADU,2002,Divorcee,67,93,160
TAMIL NADU,2002,Seperated,393,227,620
TAMIL NADU,2002,Total,6983,4261,11244
TAMIL NADU,2003,Never Married,1311,914,2225
TAMIL NADU,2003,Married,4900,2963,7863
TAMIL NADU,2003,Widowed/Widower,435,369,804
TAMIL NADU,2003,Divorcee,36,80,116
TAMIL NADU,2003,Seperated,472,392,864
TAMIL NADU,2003,Total,7154,4718,11872
TAMIL NADU,2004,Never Married,1453,1026,2479
TAMIL NADU,2004,Married,5583,3151,8734
TAMIL NADU,2004,Widowed/Widower,481,453,934
TAMIL NADU,2004,Divorcee,92,91,183
TAMIL NADU,2004,Seperated,337,172,509
TAMIL NADU,2004,Total,7946,4893,12839
TAMIL NADU,2005,Never Married,1344,965,2309
TAMIL NADU,2005,Married,5400,2986,8386
TAMIL NADU,2005,Widowed/Widower,417,360,777
TAMIL NADU,2005,Divorcee,92,86,178
TAMIL NADU,2005,Seperated,254,172,426
TAMIL NADU,2005,Total,7507,4569,12076
TAMIL NADU,2006,Never Married,1197,827,2024
TAMIL NADU,2006,Married,5426,3452,8878
TAMIL NADU,2006,Widowed/Widower,399,288,687
TAMIL NADU,2006,Divorcee,70,65,135
TAMIL NADU,2006,Seperated,417,240,657
TAMIL NADU,2006,Total,7509,4872,12381
TAMIL NADU,2007,Never Married,1385,870,2255
TAMIL NADU,2007,Married,6277,3631,9908
TAMIL NADU,2007,Widowed/Widower,462,303,765
TAMIL NADU,2007,Divorcee,81,68,149
TAMIL NADU,2007,Seperated,482,252,734
TAMIL NADU,2007,Total,8687,5124,13811
TAMIL NADU,2008,Never Married,1442,914,2356
TAMIL NADU,2008,Married,6534,3814,10348
TAMIL NADU,2008,Widowed/Widower,481,318,799
TAMIL NADU,2008,Divorcee,84,71,155
TAMIL NADU,2008,Seperated,502,265,767
TAMIL NADU,2008,Total,9043,5382,14425
TAMIL NADU,2009,Never Married,1514,976,2490
TAMIL NADU,2009,Married,6373,3902,10275
TAMIL NADU,2009,Widowed/Widower,332,249,581
TAMIL NADU,2009,Divorcee,64,68,132
TAMIL NADU,2009,Seperated,667,279,946
TAMIL NADU,2009,Total,8950,5474,14424
TAMIL NADU,2010,Never Married,1861,1131,2992
TAMIL NADU,2010,Married,7423,4027,11450
TAMIL NADU,2010,Widowed/Widower,432,280,712
TAMIL NADU,2010,Divorcee,120,133,253
TAMIL NADU,2010,Seperated,716,438,1154
TAMIL NADU,2010,Total,10552,6009,16561
TAMIL NADU,2011,Never Married,1990,1040,3030
TAMIL NADU,2011,Married,7350,3919,11269
TAMIL NADU,2011,Widowed/Widower,177,279,456
TAMIL NADU,2011,Divorcee,38,70,108
TAMIL NADU,2011,Seperated,727,373,1100
TAMIL NADU,2011,Total,10282,5681,15963
TAMIL NADU,2012,Never Married,1614,985,2599
TAMIL NADU,2012,Married,8122,4315,12437
TAMIL NADU,2012,Widowed/Widower,311,295,606
TAMIL NADU,2012,Divorcee,39,85,124
TAMIL NADU,2012,Seperated,662,499,1161
TAMIL NADU,2012,Total,10748,6179,16927
TRIPURA,2001,Never Married,157,96,253
TRIPURA,2001,Married,270,250,520
TRIPURA,2001,Widowed/Widower,12,19,31
TRIPURA,2001,Divorcee,6,10,16
TRIPURA,2001,Seperated,18,16,34
TRIPURA,2001,Total,463,391,854
TRIPURA,2002,Never Married,186,93,279
TRIPURA,2002,Married,227,129,356
TRIPURA,2002,Widowed/Widower,32,31,63
TRIPURA,2002,Divorcee,8,7,15
TRIPURA,2002,Seperated,40,26,66
TRIPURA,2002,Total,493,286,779
TRIPURA,2003,Never Married,257,54,311
TRIPURA,2003,Married,219,295,514
TRIPURA,2003,Widowed/Widower,7,0,7
TRIPURA,2003,Divorcee,2,2,4
TRIPURA,2003,Seperated,3,5,8
TRIPURA,2003,Total,488,356,844
TRIPURA,2004,Never Married,189,136,325
TRIPURA,2004,Married,207,177,384
TRIPURA,2004,Widowed/Widower,25,20,45
TRIPURA,2004,Divorcee,4,4,8
TRIPURA,2004,Seperated,8,0,8
TRIPURA,2004,Total,433,337,770
TRIPURA,2005,Never Married,132,94,226
TRIPURA,2005,Married,202,162,364
TRIPURA,2005,Widowed/Widower,39,32,71
TRIPURA,2005,Divorcee,18,18,36
TRIPURA,2005,Seperated,10,8,18
TRIPURA,2005,Total,401,314,715
TRIPURA,2006,Never Married,193,147,340
TRIPURA,2006,Married,229,154,383
TRIPURA,2006,Widowed/Widower,6,36,42
TRIPURA,2006,Divorcee,0,0,0
TRIPURA,2006,Seperated,0,0,0
TRIPURA,2006,Total,428,337,765
TRIPURA,2007,Never Married,87,80,167
TRIPURA,2007,Married,323,194,517
TRIPURA,2007,Widowed/Widower,9,12,21
TRIPURA,2007,Divorcee,0,0,0
TRIPURA,2007,Seperated,0,0,0
TRIPURA,2007,Total,419,286,705
TRIPURA,2008,Never Married,99,60,159
TRIPURA,2008,Married,343,241,584
TRIPURA,2008,Widowed/Widower,0,9,9
TRIPURA,2008,Divorcee,0,0,0
TRIPURA,2008,Seperated,0,0,0
TRIPURA,2008,Total,442,310,752
TRIPURA,2009,Never Married,132,78,210
TRIPURA,2009,Married,324,185,509
TRIPURA,2009,Widowed/Widower,8,8,16
TRIPURA,2009,Divorcee,0,0,0
TRIPURA,2009,Seperated,3,0,3
TRIPURA,2009,Total,467,271,738
TRIPURA,2010,Never Married,95,97,192
TRIPURA,2010,Married,346,178,524
TRIPURA,2010,Widowed/Widower,0,9,9
TRIPURA,2010,Divorcee,0,0,0
TRIPURA,2010,Seperated,0,0,0
TRIPURA,2010,Total,441,284,725
TRIPURA,2011,Never Married,93,76,169
TRIPURA,2011,Married,332,162,494
TRIPURA,2011,Widowed/Widower,0,4,4
TRIPURA,2011,Divorcee,0,0,0
TRIPURA,2011,Seperated,22,14,36
TRIPURA,2011,Total,447,256,703
TRIPURA,2012,Never Married,144,73,217
TRIPURA,2012,Married,387,186,573
TRIPURA,2012,Widowed/Widower,9,11,20
TRIPURA,2012,Divorcee,0,0,0
TRIPURA,2012,Seperated,20,14,34
TRIPURA,2012,Total,560,284,844
UTTAR PRADESH,2001,Never Married,376,381,757
UTTAR PRADESH,2001,Married,1294,1184,2478
UTTAR PRADESH,2001,Widowed/Widower,75,75,150
UTTAR PRADESH,2001,Divorcee,17,16,33
UTTAR PRADESH,2001,Seperated,39,59,98
UTTAR PRADESH,2001,Total,1801,1715,3516
UTTAR PRADESH,2002,Never Married,578,410,988
UTTAR PRADESH,2002,Married,1490,1302,2792
UTTAR PRADESH,2002,Widowed/Widower,158,145,303
UTTAR PRADESH,2002,Divorcee,45,24,69
UTTAR PRADESH,2002,Seperated,55,43,98
UTTAR PRADESH,2002,Total,2326,1924,4250
UTTAR PRADESH,2003,Never Married,523,375,898
UTTAR PRADESH,2003,Married,1328,1163,2491
UTTAR PRADESH,2003,Widowed/Widower,78,83,161
UTTAR PRADESH,2003,Divorcee,21,26,47
UTTAR PRADESH,2003,Seperated,37,29,66
UTTAR PRADESH,2003,Total,1987,1676,3663
UTTAR PRADESH,2004,Never Married,537,337,874
UTTAR PRADESH,2004,Married,1301,1179,2480
UTTAR PRADESH,2004,Widowed/Widower,57,98,155
UTTAR PRADESH,2004,Divorcee,23,15,38
UTTAR PRADESH,2004,Seperated,36,54,90
UTTAR PRADESH,2004,Total,1954,1683,3637
UTTAR PRADESH,2005,Never Married,457,326,783
UTTAR PRADESH,2005,Married,1195,1214,2409
UTTAR PRADESH,2005,Widowed/Widower,70,68,138
UTTAR PRADESH,2005,Divorcee,12,24,36
UTTAR PRADESH,2005,Seperated,38,45,83
UTTAR PRADESH,2005,Total,1772,1677,3449
UTTAR PRADESH,2006,Never Married,534,279,813
UTTAR PRADESH,2006,Married,1079,974,2053
UTTAR PRADESH,2006,Widowed/Widower,60,44,104
UTTAR PRADESH,2006,Divorcee,9,16,25
UTTAR PRADESH,2006,Seperated,79,25,104
UTTAR PRADESH,2006,Total,1761,1338,3099
UTTAR PRADESH,2007,Never Married,599,373,972
UTTAR PRADESH,2007,Married,1253,1305,2558
UTTAR PRADESH,2007,Widowed/Widower,79,103,182
UTTAR PRADESH,2007,Divorcee,13,42,55
UTTAR PRADESH,2007,Seperated,110,50,160
UTTAR PRADESH,2007,Total,2054,1873,3927
UTTAR PRADESH,2008,Never Married,541,437,978
UTTAR PRADESH,2008,Married,1471,1344,2815
UTTAR PRADESH,2008,Widowed/Widower,101,78,179
UTTAR PRADESH,2008,Divorcee,18,27,45
UTTAR PRADESH,2008,Seperated,48,23,71
UTTAR PRADESH,2008,Total,2179,1909,4088
UTTAR PRADESH,2009,Never Married,529,404,933
UTTAR PRADESH,2009,Married,1532,1322,2854
UTTAR PRADESH,2009,Widowed/Widower,108,114,222
UTTAR PRADESH,2009,Divorcee,20,37,57
UTTAR PRADESH,2009,Seperated,50,42,92
UTTAR PRADESH,2009,Total,2239,1919,4158
UTTAR PRADESH,2010,Never Married,554,425,979
UTTAR PRADESH,2010,Married,1083,1254,2337
UTTAR PRADESH,2010,Widowed/Widower,74,75,149
UTTAR PRADESH,2010,Divorcee,25,34,59
UTTAR PRADESH,2010,Seperated,51,53,104
UTTAR PRADESH,2010,Total,1787,1841,3628
UTTAR PRADESH,2011,Never Married,664,440,1104
UTTAR PRADESH,2011,Married,1847,1515,3362
UTTAR PRADESH,2011,Widowed/Widower,118,76,194
UTTAR PRADESH,2011,Divorcee,15,36,51
UTTAR PRADESH,2011,Seperated,69,63,132
UTTAR PRADESH,2011,Total,2713,2130,4843
UTTAR PRADESH,2012,Never Married,625,518,1143
UTTAR PRADESH,2012,Married,1546,1216,2762
UTTAR PRADESH,2012,Widowed/Widower,204,103,307
UTTAR PRADESH,2012,Divorcee,19,52,71
UTTAR PRADESH,2012,Seperated,101,38,139
UTTAR PRADESH,2012,Total,2495,1927,4422
UTTARAKHAND,2001,Never Married,40,40,80
UTTARAKHAND,2001,Married,139,79,218
UTTARAKHAND,2001,Widowed/Widower,1,5,6
UTTARAKHAND,2001,Divorcee,0,4,4
UTTARAKHAND,2001,Seperated,2,1,3
UTTARAKHAND,2001,Total,182,129,311
UTTARAKHAND,2002,Never Married,60,29,89
UTTARAKHAND,2002,Married,136,120,256
UTTARAKHAND,2002,Widowed/Widower,6,4,10
UTTARAKHAND,2002,Divorcee,2,2,4
UTTARAKHAND,2002,Seperated,1,1,2
UTTARAKHAND,2002,Total,205,156,361
UTTARAKHAND,2003,Never Married,85,36,121
UTTARAKHAND,2003,Married,165,81,246
UTTARAKHAND,2003,Widowed/Widower,7,7,14
UTTARAKHAND,2003,Divorcee,1,5,6
UTTARAKHAND,2003,Seperated,4,0,4
UTTARAKHAND,2003,Total,262,129,391
UTTARAKHAND,2004,Never Married,44,16,60
UTTARAKHAND,2004,Married,91,63,154
UTTARAKHAND,2004,Widowed/Widower,10,4,14
UTTARAKHAND,2004,Divorcee,1,4,5
UTTARAKHAND,2004,Seperated,2,2,4
UTTARAKHAND,2004,Total,148,89,237
UTTARAKHAND,2005,Never Married,65,26,91
UTTARAKHAND,2005,Married,105,55,160
UTTARAKHAND,2005,Widowed/Widower,6,10,16
UTTARAKHAND,2005,Divorcee,1,2,3
UTTARAKHAND,2005,Seperated,3,0,3
UTTARAKHAND,2005,Total,180,93,273
UTTARAKHAND,2006,Never Married,40,47,87
UTTARAKHAND,2006,Married,101,79,180
UTTARAKHAND,2006,Widowed/Widower,15,14,29
UTTARAKHAND,2006,Divorcee,10,6,16
UTTARAKHAND,2006,Seperated,7,7,14
UTTARAKHAND,2006,Total,173,153,326
UTTARAKHAND,2007,Never Married,33,23,56
UTTARAKHAND,2007,Married,75,75,150
UTTARAKHAND,2007,Widowed/Widower,11,12,23
UTTARAKHAND,2007,Divorcee,6,5,11
UTTARAKHAND,2007,Seperated,5,3,8
UTTARAKHAND,2007,Total,130,118,248
UTTARAKHAND,2008,Never Married,28,28,56
UTTARAKHAND,2008,Married,69,54,123
UTTARAKHAND,2008,Widowed/Widower,3,3,6
UTTARAKHAND,2008,Divorcee,2,1,3
UTTARAKHAND,2008,Seperated,2,1,3
UTTARAKHAND,2008,Total,104,87,191
UTTARAKHAND,2009,Never Married,56,36,92
UTTARAKHAND,2009,Married,137,96,233
UTTARAKHAND,2009,Widowed/Widower,3,3,6
UTTARAKHAND,2009,Divorcee,1,1,2
UTTARAKHAND,2009,Seperated,5,4,9
UTTARAKHAND,2009,Total,202,140,342
UTTARAKHAND,2010,Never Married,39,34,73
UTTARAKHAND,2010,Married,118,82,200
UTTARAKHAND,2010,Widowed/Widower,4,0,4
UTTARAKHAND,2010,Divorcee,0,0,0
UTTARAKHAND,2010,Seperated,3,1,4
UTTARAKHAND,2010,Total,164,117,281
UTTARAKHAND,2011,Never Married,72,43,115
UTTARAKHAND,2011,Married,104,78,182
UTTARAKHAND,2011,Widowed/Widower,7,3,10
UTTARAKHAND,2011,Divorcee,3,0,3
UTTARAKHAND,2011,Seperated,6,1,7
UTTARAKHAND,2011,Total,192,125,317
UTTARAKHAND,2012,Never Married,96,44,140
UTTARAKHAND,2012,Married,134,122,256
UTTARAKHAND,2012,Widowed/Widower,17,3,20
UTTARAKHAND,2012,Divorcee,0,6,6
UTTARAKHAND,2012,Seperated,2,0,2
UTTARAKHAND,2012,Total,249,175,424
WEST BENGAL,2001,Never Married,2028,1853,3881
WEST BENGAL,2001,Married,4385,3557,7942
WEST BENGAL,2001,Widowed/Widower,432,435,867
WEST BENGAL,2001,Divorcee,337,175,512
WEST BENGAL,2001,Seperated,313,175,488
WEST BENGAL,2001,Total,7495,6195,13690
WEST BENGAL,2002,Never Married,2057,1633,3690
WEST BENGAL,2002,Married,4266,3276,7542
WEST BENGAL,2002,Widowed/Widower,446,563,1009
WEST BENGAL,2002,Divorcee,190,155,345
WEST BENGAL,2002,Seperated,165,256,421
WEST BENGAL,2002,Total,7124,5883,13007
WEST BENGAL,2003,Never Married,1952,1106,3058
WEST BENGAL,2003,Married,4980,4212,9192
WEST BENGAL,2003,Widowed/Widower,282,307,589
WEST BENGAL,2003,Divorcee,109,117,226
WEST BENGAL,2003,Seperated,101,114,215
WEST BENGAL,2003,Total,7424,5856,13280
WEST BENGAL,2004,Never Married,2084,1270,3354
WEST BENGAL,2004,Married,4854,3833,8687
WEST BENGAL,2004,Widowed/Widower,264,316,580
WEST BENGAL,2004,Divorcee,139,94,233
WEST BENGAL,2004,Seperated,320,250,570
WEST BENGAL,2004,Total,7661,5763,13424
WEST BENGAL,2005,Never Married,1934,1137,3071
WEST BENGAL,2005,Married,6010,4520,10530
WEST BENGAL,2005,Widowed/Widower,254,426,680
WEST BENGAL,2005,Divorcee,142,158,300
WEST BENGAL,2005,Seperated,274,160,434
WEST BENGAL,2005,Total,8614,6401,15015
WEST BENGAL,2006,Never Married,1650,944,2594
WEST BENGAL,2006,Married,6933,4967,11900
WEST BENGAL,2006,Widowed/Widower,303,385,688
WEST BENGAL,2006,Divorcee,126,198,324
WEST BENGAL,2006,Seperated,108,111,219
WEST BENGAL,2006,Total,9120,6605,15725
WEST BENGAL,2007,Never Married,2154,1208,3362
WEST BENGAL,2007,Married,5637,4377,10014
WEST BENGAL,2007,Widowed/Widower,291,412,703
WEST BENGAL,2007,Divorcee,75,155,230
WEST BENGAL,2007,Seperated,348,203,551
WEST BENGAL,2007,Total,8505,6355,14860
WEST BENGAL,2008,Never Married,2844,1580,4424
WEST BENGAL,2008,Married,5182,4265,9447
WEST BENGAL,2008,Widowed/Widower,172,440,612
WEST BENGAL,2008,Divorcee,78,98,176
WEST BENGAL,2008,Seperated,93,100,193
WEST BENGAL,2008,Total,8369,6483,14852
WEST BENGAL,2009,Never Married,2580,1354,3934
WEST BENGAL,2009,Married,5521,4133,9654
WEST BENGAL,2009,Widowed/Widower,190,399,589
WEST BENGAL,2009,Divorcee,76,147,223
WEST BENGAL,2009,Seperated,127,121,248
WEST BENGAL,2009,Total,8494,6154,14648
WEST BENGAL,2010,Never Married,2941,1766,4707
WEST BENGAL,2010,Married,5938,4331,10269
WEST BENGAL,2010,Widowed/Widower,184,331,515
WEST BENGAL,2010,Divorcee,65,146,211
WEST BENGAL,2010,Seperated,173,162,335
WEST BENGAL,2010,Total,9301,6736,16037
WEST BENGAL,2011,Never Married,2973,1718,4691
WEST BENGAL,2011,Married,6072,4415,10487
WEST BENGAL,2011,Widowed/Widower,251,409,660
WEST BENGAL,2011,Divorcee,61,213,274
WEST BENGAL,2011,Seperated,267,113,380
WEST BENGAL,2011,Total,9624,6868,16492
WEST BENGAL,2012,Never Married,2658,1513,4171
WEST BENGAL,2012,Married,5451,3927,9378
WEST BENGAL,2012,Widowed/Widower,233,455,688
WEST BENGAL,2012,Divorcee,189,182,371
WEST BENGAL,2012,Seperated,149,200,349
WEST BENGAL,2012,Total,8680,6277,14957
TOTAL (STATES),2001,Never Married,14204,9375,23579
TOTAL (STATES),2001,Married,45932,27702,73634
TOTAL (STATES),2001,Widowed/Widower,2365,2531,4896
TOTAL (STATES),2001,Divorcee,708,642,1350
TOTAL (STATES),2001,Seperated,1889,1127,3016
TOTAL (STATES),2001,Total,65098,41377,106475
TOTAL (STATES),2002,Never Married,14701,9039,23740
TOTAL (STATES),2002,Married,47527,26483,74010
TOTAL (STATES),2002,Widowed/Widower,3311,3007,6318
TOTAL (STATES),2002,Divorcee,684,672,1356
TOTAL (STATES),2002,Seperated,1865,1210,3075
TOTAL (STATES),2002,Total,68088,40411,108499
TOTAL (STATES),2003,Never Married,14956,8573,23529
TOTAL (STATES),2003,Married,48656,27143,75799
TOTAL (STATES),2003,Widowed/Widower,2910,2553,5463
TOTAL (STATES),2003,Divorcee,588,534,1122
TOTAL (STATES),2003,Seperated,1795,1114,2909
TOTAL (STATES),2003,Total,68905,39917,108822
TOTAL (STATES),2004,Never Married,15397,8557,23954
TOTAL (STATES),2004,Married,50731,27589,78320
TOTAL (STATES),2004,Widowed/Widower,2351,2360,4711
TOTAL (STATES),2004,Divorcee,663,531,1194
TOTAL (STATES),2004,Seperated,2214,1260,3474
TOTAL (STATES),2004,Total,71356,40297,111653
TOTAL (STATES),2005,Never Married,14930,8372,23302
TOTAL (STATES),2005,Married,51573,27686,79259
TOTAL (STATES),2005,Widowed/Widower,2653,2388,5041
TOTAL (STATES),2005,Divorcee,559,562,1121
TOTAL (STATES),2005,Seperated,1869,1210,3079
TOTAL (STATES),2005,Total,71584,40218,111802
TOTAL (STATES),2006,Never Married,15195,8556,23751
TOTAL (STATES),2006,Married,54437,29347,83784
TOTAL (STATES),2006,Widowed/Widower,2382,2220,4602
TOTAL (STATES),2006,Divorcee,514,587,1101
TOTAL (STATES),2006,Seperated,1675,902,2577
TOTAL (STATES),2006,Total,74203,41612,115815
TOTAL (STATES),2007,Never Married,16055,8738,24793
TOTAL (STATES),2007,Married,56540,29531,86071
TOTAL (STATES),2007,Widowed/Widower,2642,2341,4983
TOTAL (STATES),2007,Divorcee,525,643,1168
TOTAL (STATES),2007,Seperated,2037,1255,3292
TOTAL (STATES),2007,Total,77799,42508,120307
TOTAL (STATES),2008,Never Married,17447,9594,27041
TOTAL (STATES),2008,Married,56734,29736,86470
TOTAL (STATES),2008,Widowed/Widower,2599,2701,5300
TOTAL (STATES),2008,Divorcee,726,673,1399
TOTAL (STATES),2008,Seperated,1707,985,2692
TOTAL (STATES),2008,Total,79213,43689,122902
TOTAL (STATES),2009,Never Married,17381,9803,27184
TOTAL (STATES),2009,Married,57195,30754,87949
TOTAL (STATES),2009,Widowed/Widower,2819,2651,5470
TOTAL (STATES),2009,Divorcee,630,612,1242
TOTAL (STATES),2009,Seperated,2012,1013,3025
TOTAL (STATES),2009,Total,80037,44833,124870
TOTAL (STATES),2010,Never Married,19293,10849,30142
TOTAL (STATES),2010,Married,60449,31177,91626
TOTAL (STATES),2010,Widowed/Widower,2756,2348,5104
TOTAL (STATES),2010,Divorcee,724,777,1501
TOTAL (STATES),2010,Seperated,2465,1388,3853
TOTAL (STATES),2010,Total,85687,46539,132226
TOTAL (STATES),2011,Never Married,19404,10479,29883
TOTAL (STATES),2011,Married,61242,32070,93312
TOTAL (STATES),2011,Widowed/Widower,2542,2333,4875
TOTAL (STATES),2011,Divorcee,551,725,1276
TOTAL (STATES),2011,Seperated,2326,1303,3629
TOTAL (STATES),2011,Total,86065,46910,132975
TOTAL (STATES),2012,Never Married,19158,10528,29686
TOTAL (STATES),2012,Married,62123,31335,93458
TOTAL (STATES),2012,Widowed/Widower,2651,2269,4920
TOTAL (STATES),2012,Divorcee,680,705,1385
TOTAL (STATES),2012,Seperated,2001,1217,3218
TOTAL (STATES),2012,Total,86613,46054,132667
A & N ISLANDS,2001,Never Married,24,12,36
A & N ISLANDS,2001,Married,55,38,93
A & N ISLANDS,2001,Widowed/Widower,0,0,0
A & N ISLANDS,2001,Divorcee,0,0,0
A & N ISLANDS,2001,Seperated,0,0,0
A & N ISLANDS,2001,Total,79,50,129
A & N ISLANDS,2002,Never Married,37,17,54
A & N ISLANDS,2002,Married,54,36,90
A & N ISLANDS,2002,Widowed/Widower,0,0,0
A & N ISLANDS,2002,Divorcee,0,0,0
A & N ISLANDS,2002,Seperated,0,0,0
A & N ISLANDS,2002,Total,91,53,144
A & N ISLANDS,2003,Never Married,19,15,34
A & N ISLANDS,2003,Married,51,28,79
A & N ISLANDS,2003,Widowed/Widower,0,0,0
A & N ISLANDS,2003,Divorcee,0,0,0
A & N ISLANDS,2003,Seperated,0,0,0
A & N ISLANDS,2003,Total,70,43,113
A & N ISLANDS,2004,Never Married,23,15,38
A & N ISLANDS,2004,Married,57,26,83
A & N ISLANDS,2004,Widowed/Widower,0,0,0
A & N ISLANDS,2004,Divorcee,1,0,1
A & N ISLANDS,2004,Seperated,0,0,0
A & N ISLANDS,2004,Total,81,41,122
A & N ISLANDS,2005,Never Married,25,18,43
A & N ISLANDS,2005,Married,60,35,95
A & N ISLANDS,2005,Widowed/Widower,1,0,1
A & N ISLANDS,2005,Divorcee,0,0,0
A & N ISLANDS,2005,Seperated,0,0,0
A & N ISLANDS,2005,Total,86,53,139
A & N ISLANDS,2006,Never Married,47,10,57
A & N ISLANDS,2006,Married,49,27,76
A & N ISLANDS,2006,Widowed/Widower,0,0,0
A & N ISLANDS,2006,Divorcee,0,0,0
A & N ISLANDS,2006,Seperated,0,0,0
A & N ISLANDS,2006,Total,96,37,133
A & N ISLANDS,2007,Never Married,45,23,68
A & N ISLANDS,2007,Married,55,33,88
A & N ISLANDS,2007,Widowed/Widower,0,0,0
A & N ISLANDS,2007,Divorcee,0,0,0
A & N ISLANDS,2007,Seperated,0,0,0
A & N ISLANDS,2007,Total,100,56,156
A & N ISLANDS,2008,Never Married,27,12,39
A & N ISLANDS,2008,Married,71,33,104
A & N ISLANDS,2008,Widowed/Widower,0,0,0
A & N ISLANDS,2008,Divorcee,0,0,0
A & N ISLANDS,2008,Seperated,0,0,0
A & N ISLANDS,2008,Total,98,45,143
A & N ISLANDS,2009,Never Married,20,17,37
A & N ISLANDS,2009,Married,66,28,94
A & N ISLANDS,2009,Widowed/Widower,0,0,0
A & N ISLANDS,2009,Divorcee,0,0,0
A & N ISLANDS,2009,Seperated,0,0,0
A & N ISLANDS,2009,Total,86,45,131
A & N ISLANDS,2010,Never Married,42,11,53
A & N ISLANDS,2010,Married,64,31,95
A & N ISLANDS,2010,Widowed/Widower,3,2,5
A & N ISLANDS,2010,Divorcee,1,0,1
A & N ISLANDS,2010,Seperated,2,0,2
A & N ISLANDS,2010,Total,112,44,156
A & N ISLANDS,2011,Never Married,20,15,35
A & N ISLANDS,2011,Married,73,26,99
A & N ISLANDS,2011,Widowed/Widower,0,0,0
A & N ISLANDS,2011,Divorcee,0,1,1
A & N ISLANDS,2011,Seperated,1,0,1
A & N ISLANDS,2011,Total,94,42,136
A & N ISLANDS,2012,Never Married,28,11,39
A & N ISLANDS,2012,Married,52,30,82
A & N ISLANDS,2012,Widowed/Widower,0,0,0
A & N ISLANDS,2012,Divorcee,0,0,0
A & N ISLANDS,2012,Seperated,0,0,0
A & N ISLANDS,2012,Total,80,41,121
CHANDIGARH,2001,Never Married,5,6,11
CHANDIGARH,2001,Married,34,25,59
CHANDIGARH,2001,Widowed/Widower,0,0,0
CHANDIGARH,2001,Divorcee,0,0,0
CHANDIGARH,2001,Seperated,0,0,0
CHANDIGARH,2001,Total,39,31,70
CHANDIGARH,2002,Never Married,19,12,31
CHANDIGARH,2002,Married,34,22,56
CHANDIGARH,2002,Widowed/Widower,0,0,0
CHANDIGARH,2002,Divorcee,0,0,0
CHANDIGARH,2002,Seperated,0,0,0
CHANDIGARH,2002,Total,53,34,87
CHANDIGARH,2003,Never Married,18,13,31
CHANDIGARH,2003,Married,50,22,72
CHANDIGARH,2003,Widowed/Widower,0,0,0
CHANDIGARH,2003,Divorcee,0,0,0
CHANDIGARH,2003,Seperated,0,0,0
CHANDIGARH,2003,Total,68,35,103
CHANDIGARH,2004,Never Married,18,10,28
CHANDIGARH,2004,Married,34,13,47
CHANDIGARH,2004,Widowed/Widower,0,0,0
CHANDIGARH,2004,Divorcee,0,0,0
CHANDIGARH,2004,Seperated,0,0,0
CHANDIGARH,2004,Total,52,23,75
CHANDIGARH,2005,Never Married,26,11,37
CHANDIGARH,2005,Married,37,15,52
CHANDIGARH,2005,Widowed/Widower,0,0,0
CHANDIGARH,2005,Divorcee,0,0,0
CHANDIGARH,2005,Seperated,0,0,0
CHANDIGARH,2005,Total,63,26,89
CHANDIGARH,2006,Never Married,27,14,41
CHANDIGARH,2006,Married,29,10,39
CHANDIGARH,2006,Widowed/Widower,0,0,0
CHANDIGARH,2006,Divorcee,0,0,0
CHANDIGARH,2006,Seperated,0,0,0
CHANDIGARH,2006,Total,56,24,80
CHANDIGARH,2007,Never Married,19,2,21
CHANDIGARH,2007,Married,41,20,61
CHANDIGARH,2007,Widowed/Widower,0,0,0
CHANDIGARH,2007,Divorcee,0,0,0
CHANDIGARH,2007,Seperated,0,0,0
CHANDIGARH,2007,Total,60,22,82
CHANDIGARH,2008,Never Married,17,8,25
CHANDIGARH,2008,Married,41,16,57
CHANDIGARH,2008,Widowed/Widower,0,0,0
CHANDIGARH,2008,Divorcee,0,1,1
CHANDIGARH,2008,Seperated,0,0,0
CHANDIGARH,2008,Total,58,25,83
CHANDIGARH,2009,Never Married,11,14,25
CHANDIGARH,2009,Married,33,17,50
CHANDIGARH,2009,Widowed/Widower,0,0,0
CHANDIGARH,2009,Divorcee,0,0,0
CHANDIGARH,2009,Seperated,0,0,0
CHANDIGARH,2009,Total,44,31,75
CHANDIGARH,2010,Never Married,10,17,27
CHANDIGARH,2010,Married,21,23,44
CHANDIGARH,2010,Widowed/Widower,0,0,0
CHANDIGARH,2010,Divorcee,0,0,0
CHANDIGARH,2010,Seperated,0,0,0
CHANDIGARH,2010,Total,31,40,71
CHANDIGARH,2011,Never Married,22,18,40
CHANDIGARH,2011,Married,35,30,65
CHANDIGARH,2011,Widowed/Widower,0,0,0
CHANDIGARH,2011,Divorcee,0,0,0
CHANDIGARH,2011,Seperated,0,0,0
CHANDIGARH,2011,Total,57,48,105
CHANDIGARH,2012,Never Married,26,20,46
CHANDIGARH,2012,Married,49,18,67
CHANDIGARH,2012,Widowed/Widower,0,0,0
CHANDIGARH,2012,Divorcee,0,1,1
CHANDIGARH,2012,Seperated,0,0,0
CHANDIGARH,2012,Total,75,39,114
D & N HAVELI,2001,Never Married,8,2,10
D & N HAVELI,2001,Married,27,13,40
D & N HAVELI,2001,Widowed/Widower,0,0,0
D & N HAVELI,2001,Divorcee,0,0,0
D & N HAVELI,2001,Seperated,0,0,0
D & N HAVELI,2001,Total,35,15,50
D & N HAVELI,2002,Never Married,5,6,11
D & N HAVELI,2002,Married,27,11,38
D & N HAVELI,2002,Widowed/Widower,0,1,1
D & N HAVELI,2002,Divorcee,0,0,0
D & N HAVELI,2002,Seperated,0,0,0
D & N HAVELI,2002,Total,32,18,50
D & N HAVELI,2003,Never Married,9,1,10
D & N HAVELI,2003,Married,18,20,38
D & N HAVELI,2003,Widowed/Widower,2,0,2
D & N HAVELI,2003,Divorcee,0,1,1
D & N HAVELI,2003,Seperated,1,0,1
D & N HAVELI,2003,Total,30,22,52
D & N HAVELI,2004,Never Married,4,2,6
D & N HAVELI,2004,Married,16,17,33
D & N HAVELI,2004,Widowed/Widower,0,0,0
D & N HAVELI,2004,Divorcee,0,0,0
D & N HAVELI,2004,Seperated,0,0,0
D & N HAVELI,2004,Total,20,19,39
D & N HAVELI,2005,Never Married,5,3,8
D & N HAVELI,2005,Married,36,24,60
D & N HAVELI,2005,Widowed/Widower,0,1,1
D & N HAVELI,2005,Divorcee,0,0,0
D & N HAVELI,2005,Seperated,0,0,0
D & N HAVELI,2005,Total,41,28,69
D & N HAVELI,2006,Never Married,8,7,15
D & N HAVELI,2006,Married,14,12,26
D & N HAVELI,2006,Widowed/Widower,0,0,0
D & N HAVELI,2006,Divorcee,0,0,0
D & N HAVELI,2006,Seperated,1,0,1
D & N HAVELI,2006,Total,23,19,42
D & N HAVELI,2007,Never Married,6,4,10
D & N HAVELI,2007,Married,37,28,65
D & N HAVELI,2007,Widowed/Widower,0,0,0
D & N HAVELI,2007,Divorcee,0,0,0
D & N HAVELI,2007,Seperated,1,0,1
D & N HAVELI,2007,Total,44,32,76
D & N HAVELI,2008,Never Married,8,6,14
D & N HAVELI,2008,Married,24,22,46
D & N HAVELI,2008,Widowed/Widower,0,0,0
D & N HAVELI,2008,Divorcee,0,0,0
D & N HAVELI,2008,Seperated,0,0,0
D & N HAVELI,2008,Total,32,28,60
D & N HAVELI,2009,Never Married,7,4,11
D & N HAVELI,2009,Married,22,18,40
D & N HAVELI,2009,Widowed/Widower,1,3,4
D & N HAVELI,2009,Divorcee,0,1,1
D & N HAVELI,2009,Seperated,0,0,0
D & N HAVELI,2009,Total,30,26,56
D & N HAVELI,2010,Never Married,11,9,20
D & N HAVELI,2010,Married,25,16,41
D & N HAVELI,2010,Widowed/Widower,1,0,1
D & N HAVELI,2010,Divorcee,0,1,1
D & N HAVELI,2010,Seperated,0,0,0
D & N HAVELI,2010,Total,37,26,63
D & N HAVELI,2011,Never Married,15,7,22
D & N HAVELI,2011,Married,26,11,37
D & N HAVELI,2011,Widowed/Widower,0,2,2
D & N HAVELI,2011,Divorcee,0,0,0
D & N HAVELI,2011,Seperated,0,2,2
D & N HAVELI,2011,Total,41,22,63
D & N HAVELI,2012,Never Married,12,8,20
D & N HAVELI,2012,Married,27,17,44
D & N HAVELI,2012,Widowed/Widower,0,0,0
D & N HAVELI,2012,Divorcee,1,0,1
D & N HAVELI,2012,Seperated,1,0,1
D & N HAVELI,2012,Total,41,25,66
DAMAN & DIU,2001,Never Married,5,1,6
DAMAN & DIU,2001,Married,5,3,8
DAMAN & DIU,2001,Widowed/Widower,0,0,0
DAMAN & DIU,2001,Divorcee,0,0,0
DAMAN & DIU,2001,Seperated,0,0,0
DAMAN & DIU,2001,Total,10,4,14
DAMAN & DIU,2002,Never Married,6,0,6
DAMAN & DIU,2002,Married,9,2,11
DAMAN & DIU,2002,Widowed/Widower,0,0,0
DAMAN & DIU,2002,Divorcee,0,0,0
DAMAN & DIU,2002,Seperated,0,0,0
DAMAN & DIU,2002,Total,15,2,17
DAMAN & DIU,2003,Never Married,7,2,9
DAMAN & DIU,2003,Married,10,4,14
DAMAN & DIU,2003,Widowed/Widower,1,0,1
DAMAN & DIU,2003,Divorcee,0,0,0
DAMAN & DIU,2003,Seperated,0,0,0
DAMAN & DIU,2003,Total,18,6,24
DAMAN & DIU,2004,Never Married,3,2,5
DAMAN & DIU,2004,Married,2,6,8
DAMAN & DIU,2004,Widowed/Widower,0,0,0
DAMAN & DIU,2004,Divorcee,0,0,0
DAMAN & DIU,2004,Seperated,0,0,0
DAMAN & DIU,2004,Total,5,8,13
DAMAN & DIU,2005,Never Married,10,4,14
DAMAN & DIU,2005,Married,14,3,17
DAMAN & DIU,2005,Widowed/Widower,0,0,0
DAMAN & DIU,2005,Divorcee,0,0,0
DAMAN & DIU,2005,Seperated,1,0,1
DAMAN & DIU,2005,Total,25,7,32
DAMAN & DIU,2006,Never Married,7,4,11
DAMAN & DIU,2006,Married,6,4,10
DAMAN & DIU,2006,Widowed/Widower,1,0,1
DAMAN & DIU,2006,Divorcee,0,0,0
DAMAN & DIU,2006,Seperated,0,0,0
DAMAN & DIU,2006,Total,14,8,22
DAMAN & DIU,2007,Never Married,2,6,8
DAMAN & DIU,2007,Married,4,3,7
DAMAN & DIU,2007,Widowed/Widower,0,0,0
DAMAN & DIU,2007,Divorcee,0,0,0
DAMAN & DIU,2007,Seperated,0,0,0
DAMAN & DIU,2007,Total,6,9,15
DAMAN & DIU,2008,Never Married,7,1,8
DAMAN & DIU,2008,Married,6,1,7
DAMAN & DIU,2008,Widowed/Widower,0,3,3
DAMAN & DIU,2008,Divorcee,1,0,1
DAMAN & DIU,2008,Seperated,0,0,0
DAMAN & DIU,2008,Total,14,5,19
DAMAN & DIU,2009,Never Married,8,4,12
DAMAN & DIU,2009,Married,6,4,10
DAMAN & DIU,2009,Widowed/Widower,1,0,1
DAMAN & DIU,2009,Divorcee,0,0,0
DAMAN & DIU,2009,Seperated,0,0,0
DAMAN & DIU,2009,Total,15,8,23
DAMAN & DIU,2010,Never Married,10,5,15
DAMAN & DIU,2010,Married,9,7,16
DAMAN & DIU,2010,Widowed/Widower,0,0,0
DAMAN & DIU,2010,Divorcee,0,0,0
DAMAN & DIU,2010,Seperated,0,0,0
DAMAN & DIU,2010,Total,19,12,31
DAMAN & DIU,2011,Never Married,6,9,15
DAMAN & DIU,2011,Married,11,6,17
DAMAN & DIU,2011,Widowed/Widower,0,0,0
DAMAN & DIU,2011,Divorcee,0,0,0
DAMAN & DIU,2011,Seperated,1,0,1
DAMAN & DIU,2011,Total,18,15,33
DAMAN & DIU,2012,Never Married,18,1,19
DAMAN & DIU,2012,Married,6,10,16
DAMAN & DIU,2012,Widowed/Widower,0,0,0
DAMAN & DIU,2012,Divorcee,0,0,0
DAMAN & DIU,2012,Seperated,1,0,1
DAMAN & DIU,2012,Total,25,11,36
DELHI (UT),2001,Never Married,192,124,316
DELHI (UT),2001,Married,508,365,873
DELHI (UT),2001,Widowed/Widower,12,9,21
DELHI (UT),2001,Divorcee,0,1,1
DELHI (UT),2001,Seperated,18,10,28
DELHI (UT),2001,Total,730,509,1239
DELHI (UT),2002,Never Married,172,110,282
DELHI (UT),2002,Married,434,274,708
DELHI (UT),2002,Widowed/Widower,15,9,24
DELHI (UT),2002,Divorcee,0,3,3
DELHI (UT),2002,Seperated,22,14,36
DELHI (UT),2002,Total,643,410,1053
DELHI (UT),2003,Never Married,232,122,354
DELHI (UT),2003,Married,471,272,743
DELHI (UT),2003,Widowed/Widower,4,6,10
DELHI (UT),2003,Divorcee,0,4,4
DELHI (UT),2003,Seperated,34,8,42
DELHI (UT),2003,Total,741,412,1153
DELHI (UT),2004,Never Married,263,175,438
DELHI (UT),2004,Married,508,270,778
DELHI (UT),2004,Widowed/Widower,10,2,12
DELHI (UT),2004,Divorcee,1,1,2
DELHI (UT),2004,Seperated,17,9,26
DELHI (UT),2004,Total,799,457,1256
DELHI (UT),2005,Never Married,218,150,368
DELHI (UT),2005,Married,501,301,802
DELHI (UT),2005,Widowed/Widower,10,4,14
DELHI (UT),2005,Divorcee,0,0,0
DELHI (UT),2005,Seperated,48,13,61
DELHI (UT),2005,Total,777,468,1245
DELHI (UT),2006,Never Married,241,158,399
DELHI (UT),2006,Married,656,358,1014
DELHI (UT),2006,Widowed/Widower,7,3,10
DELHI (UT),2006,Divorcee,0,1,1
DELHI (UT),2006,Seperated,56,12,68
DELHI (UT),2006,Total,960,532,1492
DELHI (UT),2007,Never Married,253,162,415
DELHI (UT),2007,Married,661,334,995
DELHI (UT),2007,Widowed/Widower,12,2,14
DELHI (UT),2007,Divorcee,1,1,2
DELHI (UT),2007,Seperated,39,16,55
DELHI (UT),2007,Total,966,515,1481
DELHI (UT),2008,Never Married,216,157,373
DELHI (UT),2008,Married,516,309,825
DELHI (UT),2008,Widowed/Widower,36,18,54
DELHI (UT),2008,Divorcee,3,3,6
DELHI (UT),2008,Seperated,24,21,45
DELHI (UT),2008,Total,795,508,1303
DELHI (UT),2009,Never Married,240,160,400
DELHI (UT),2009,Married,615,357,972
DELHI (UT),2009,Widowed/Widower,27,10,37
DELHI (UT),2009,Divorcee,5,0,5
DELHI (UT),2009,Seperated,46,17,63
DELHI (UT),2009,Total,933,544,1477
DELHI (UT),2010,Never Married,264,164,428
DELHI (UT),2010,Married,624,392,1016
DELHI (UT),2010,Widowed/Widower,17,6,23
DELHI (UT),2010,Divorcee,10,4,14
DELHI (UT),2010,Seperated,46,16,62
DELHI (UT),2010,Total,961,582,1543
DELHI (UT),2011,Never Married,348,182,530
DELHI (UT),2011,Married,742,337,1079
DELHI (UT),2011,Widowed/Widower,24,6,30
DELHI (UT),2011,Divorcee,3,3,6
DELHI (UT),2011,Seperated,51,20,71
DELHI (UT),2011,Total,1168,548,1716
DELHI (UT),2012,Never Married,405,216,621
DELHI (UT),2012,Married,793,405,1198
DELHI (UT),2012,Widowed/Widower,7,7,14
DELHI (UT),2012,Divorcee,1,2,3
DELHI (UT),2012,Seperated,40,23,63
DELHI (UT),2012,Total,1246,653,1899
LAKSHADWEEP,2001,Never Married,0,0,0
LAKSHADWEEP,2001,Married,0,0,0
LAKSHADWEEP,2001,Widowed/Widower,0,0,0
LAKSHADWEEP,2001,Divorcee,0,0,0
LAKSHADWEEP,2001,Seperated,0,0,0
LAKSHADWEEP,2001,Total,0,0,0
LAKSHADWEEP,2002,Never Married,0,0,0
LAKSHADWEEP,2002,Married,0,0,0
LAKSHADWEEP,2002,Widowed/Widower,0,0,0
LAKSHADWEEP,2002,Divorcee,0,0,0
LAKSHADWEEP,2002,Seperated,0,0,0
LAKSHADWEEP,2002,Total,0,0,0
LAKSHADWEEP,2003,Never Married,0,0,0
LAKSHADWEEP,2003,Married,1,1,2
LAKSHADWEEP,2003,Widowed/Widower,0,0,0
LAKSHADWEEP,2003,Divorcee,0,0,0
LAKSHADWEEP,2003,Seperated,0,0,0
LAKSHADWEEP,2003,Total,1,1,2
LAKSHADWEEP,2004,Never Married,0,0,0
LAKSHADWEEP,2004,Married,0,0,0
LAKSHADWEEP,2004,Widowed/Widower,0,0,0
LAKSHADWEEP,2004,Divorcee,0,0,0
LAKSHADWEEP,2004,Seperated,0,0,0
LAKSHADWEEP,2004,Total,0,0,0
LAKSHADWEEP,2005,Never Married,0,0,0
LAKSHADWEEP,2005,Married,0,0,0
LAKSHADWEEP,2005,Widowed/Widower,0,0,0
LAKSHADWEEP,2005,Divorcee,0,0,0
LAKSHADWEEP,2005,Seperated,0,0,0
LAKSHADWEEP,2005,Total,0,0,0
LAKSHADWEEP,2006,Never Married,0,0,0
LAKSHADWEEP,2006,Married,1,1,2
LAKSHADWEEP,2006,Widowed/Widower,0,0,0
LAKSHADWEEP,2006,Divorcee,0,0,0
LAKSHADWEEP,2006,Seperated,0,0,0
LAKSHADWEEP,2006,Total,1,1,2
LAKSHADWEEP,2007,Never Married,0,0,0
LAKSHADWEEP,2007,Married,1,2,3
LAKSHADWEEP,2007,Widowed/Widower,0,0,0
LAKSHADWEEP,2007,Divorcee,0,0,0
LAKSHADWEEP,2007,Seperated,0,0,0
LAKSHADWEEP,2007,Total,1,2,3
LAKSHADWEEP,2008,Never Married,0,0,0
LAKSHADWEEP,2008,Married,0,0,0
LAKSHADWEEP,2008,Widowed/Widower,0,0,0
LAKSHADWEEP,2008,Divorcee,0,0,0
LAKSHADWEEP,2008,Seperated,0,0,0
LAKSHADWEEP,2008,Total,0,0,0
LAKSHADWEEP,2009,Never Married,0,0,0
LAKSHADWEEP,2009,Married,0,1,1
LAKSHADWEEP,2009,Widowed/Widower,0,0,0
LAKSHADWEEP,2009,Divorcee,0,0,0
LAKSHADWEEP,2009,Seperated,0,0,0
LAKSHADWEEP,2009,Total,0,1,1
LAKSHADWEEP,2010,Never Married,0,0,0
LAKSHADWEEP,2010,Married,0,1,1
LAKSHADWEEP,2010,Widowed/Widower,0,0,0
LAKSHADWEEP,2010,Divorcee,0,0,0
LAKSHADWEEP,2010,Seperated,0,0,0
LAKSHADWEEP,2010,Total,0,1,1
LAKSHADWEEP,2011,Never Married,0,0,0
LAKSHADWEEP,2011,Married,0,0,0
LAKSHADWEEP,2011,Widowed/Widower,0,0,0
LAKSHADWEEP,2011,Divorcee,0,0,0
LAKSHADWEEP,2011,Seperated,0,0,0
LAKSHADWEEP,2011,Total,0,0,0
LAKSHADWEEP,2012,Never Married,0,0,0
LAKSHADWEEP,2012,Married,1,0,1
LAKSHADWEEP,2012,Widowed/Widower,0,0,0
LAKSHADWEEP,2012,Divorcee,0,0,0
LAKSHADWEEP,2012,Seperated,0,0,0
LAKSHADWEEP,2012,Total,1,0,1
PUDUCHERRY,2001,Never Married,42,63,105
PUDUCHERRY,2001,Married,281,135,416
PUDUCHERRY,2001,Widowed/Widower,0,8,8
PUDUCHERRY,2001,Divorcee,0,0,0
PUDUCHERRY,2001,Seperated,0,0,0
PUDUCHERRY,2001,Total,323,206,529
PUDUCHERRY,2002,Never Married,86,41,127
PUDUCHERRY,2002,Married,324,108,432
PUDUCHERRY,2002,Widowed/Widower,0,8,8
PUDUCHERRY,2002,Divorcee,0,0,0
PUDUCHERRY,2002,Seperated,0,0,0
PUDUCHERRY,2002,Total,410,157,567
PUDUCHERRY,2003,Never Married,98,72,170
PUDUCHERRY,2003,Married,288,113,401
PUDUCHERRY,2003,Widowed/Widower,2,9,11
PUDUCHERRY,2003,Divorcee,0,0,0
PUDUCHERRY,2003,Seperated,0,0,0
PUDUCHERRY,2003,Total,388,194,582
PUDUCHERRY,2004,Never Married,61,62,123
PUDUCHERRY,2004,Married,275,124,399
PUDUCHERRY,2004,Widowed/Widower,2,15,17
PUDUCHERRY,2004,Divorcee,0,0,0
PUDUCHERRY,2004,Seperated,0,0,0
PUDUCHERRY,2004,Total,338,201,539
PUDUCHERRY,2005,Never Married,78,60,138
PUDUCHERRY,2005,Married,262,124,386
PUDUCHERRY,2005,Widowed/Widower,0,14,14
PUDUCHERRY,2005,Divorcee,0,0,0
PUDUCHERRY,2005,Seperated,0,0,0
PUDUCHERRY,2005,Total,340,198,538
PUDUCHERRY,2006,Never Married,82,63,145
PUDUCHERRY,2006,Married,260,110,370
PUDUCHERRY,2006,Widowed/Widower,7,4,11
PUDUCHERRY,2006,Divorcee,0,0,0
PUDUCHERRY,2006,Seperated,0,0,0
PUDUCHERRY,2006,Total,349,177,526
PUDUCHERRY,2007,Never Married,65,74,139
PUDUCHERRY,2007,Married,254,113,367
PUDUCHERRY,2007,Widowed/Widower,0,11,11
PUDUCHERRY,2007,Divorcee,0,0,0
PUDUCHERRY,2007,Seperated,0,0,0
PUDUCHERRY,2007,Total,319,198,517
PUDUCHERRY,2008,Never Married,87,57,144
PUDUCHERRY,2008,Married,247,107,354
PUDUCHERRY,2008,Widowed/Widower,0,9,9
PUDUCHERRY,2008,Divorcee,0,0,0
PUDUCHERRY,2008,Seperated,0,0,0
PUDUCHERRY,2008,Total,334,173,507
PUDUCHERRY,2009,Never Married,71,61,132
PUDUCHERRY,2009,Married,255,121,376
PUDUCHERRY,2009,Widowed/Widower,0,10,10
PUDUCHERRY,2009,Divorcee,0,0,0
PUDUCHERRY,2009,Seperated,0,0,0
PUDUCHERRY,2009,Total,326,192,518
PUDUCHERRY,2010,Never Married,72,53,125
PUDUCHERRY,2010,Married,261,107,368
PUDUCHERRY,2010,Widowed/Widower,0,15,15
PUDUCHERRY,2010,Divorcee,0,0,0
PUDUCHERRY,2010,Seperated,0,0,0
PUDUCHERRY,2010,Total,333,175,508
PUDUCHERRY,2011,Never Married,92,46,138
PUDUCHERRY,2011,Married,304,102,406
PUDUCHERRY,2011,Widowed/Widower,0,13,13
PUDUCHERRY,2011,Divorcee,0,0,0
PUDUCHERRY,2011,Seperated,0,0,0
PUDUCHERRY,2011,Total,396,161,557
PUDUCHERRY,2012,Never Married,80,46,126
PUDUCHERRY,2012,Married,292,106,398
PUDUCHERRY,2012,Widowed/Widower,0,17,17
PUDUCHERRY,2012,Divorcee,0,0,0
PUDUCHERRY,2012,Seperated,0,0,0
PUDUCHERRY,2012,Total,372,169,541
TOTAL (UTs),2001,Never Married,276,208,484
TOTAL (UTs),2001,Married,910,579,1489
TOTAL (UTs),2001,Widowed/Widower,12,17,29
TOTAL (UTs),2001,Divorcee,0,1,1
TOTAL (UTs),2001,Seperated,18,10,28
TOTAL (UTs),2001,Total,1216,815,2031
TOTAL (UTs),2002,Never Married,325,186,511
TOTAL (UTs),2002,Married,882,453,1335
TOTAL (UTs),2002,Widowed/Widower,15,18,33
TOTAL (UTs),2002,Divorcee,0,3,3
TOTAL (UTs),2002,Seperated,22,14,36
TOTAL (UTs),2002,Total,1244,674,1918
TOTAL (UTs),2003,Never Married,383,225,608
TOTAL (UTs),2003,Married,889,460,1349
TOTAL (UTs),2003,Widowed/Widower,9,15,24
TOTAL (UTs),2003,Divorcee,0,5,5
TOTAL (UTs),2003,Seperated,35,8,43
TOTAL (UTs),2003,Total,1316,713,2029
TOTAL (UTs),2004,Never Married,372,266,638
TOTAL (UTs),2004,Married,892,456,1348
TOTAL (UTs),2004,Widowed/Widower,12,17,29
TOTAL (UTs),2004,Divorcee,2,1,3
TOTAL (UTs),2004,Seperated,17,9,26
TOTAL (UTs),2004,Total,1295,749,2044
TOTAL (UTs),2005,Never Married,362,246,608
TOTAL (UTs),2005,Married,910,502,1412
TOTAL (UTs),2005,Widowed/Widower,11,19,30
TOTAL (UTs),2005,Divorcee,0,0,0
TOTAL (UTs),2005,Seperated,49,13,62
TOTAL (UTs),2005,Total,1332,780,2112
TOTAL (UTs),2006,Never Married,412,256,668
TOTAL (UTs),2006,Married,1015,522,1537
TOTAL (UTs),2006,Widowed/Widower,15,7,22
TOTAL (UTs),2006,Divorcee,0,1,1
TOTAL (UTs),2006,Seperated,57,12,69
TOTAL (UTs),2006,Total,1499,798,2297
TOTAL (UTs),2007,Never Married,390,271,661
TOTAL (UTs),2007,Married,1053,533,1586
TOTAL (UTs),2007,Widowed/Widower,12,13,25
TOTAL (UTs),2007,Divorcee,1,1,2
TOTAL (UTs),2007,Seperated,40,16,56
TOTAL (UTs),2007,Total,1496,834,2330
TOTAL (UTs),2008,Never Married,362,241,603
TOTAL (UTs),2008,Married,905,488,1393
TOTAL (UTs),2008,Widowed/Widower,36,30,66
TOTAL (UTs),2008,Divorcee,4,4,8
TOTAL (UTs),2008,Seperated,24,21,45
TOTAL (UTs),2008,Total,1331,784,2115
TOTAL (UTs),2009,Never Married,357,260,617
TOTAL (UTs),2009,Married,997,546,1543
TOTAL (UTs),2009,Widowed/Widower,29,23,52
TOTAL (UTs),2009,Divorcee,5,1,6
TOTAL (UTs),2009,Seperated,46,17,63
TOTAL (UTs),2009,Total,1434,847,2281
TOTAL (UTs),2010,Never Married,409,259,668
TOTAL (UTs),2010,Married,1004,577,1581
TOTAL (UTs),2010,Widowed/Widower,21,23,44
TOTAL (UTs),2010,Divorcee,11,5,16
TOTAL (UTs),2010,Seperated,48,16,64
TOTAL (UTs),2010,Total,1493,880,2373
TOTAL (UTs),2011,Never Married,503,277,780
TOTAL (UTs),2011,Married,1191,512,1703
TOTAL (UTs),2011,Widowed/Widower,24,21,45
TOTAL (UTs),2011,Divorcee,3,4,7
TOTAL (UTs),2011,Seperated,53,22,75
TOTAL (UTs),2011,Total,1774,836,2610
TOTAL (UTs),2012,Never Married,569,302,871
TOTAL (UTs),2012,Married,1220,586,1806
TOTAL (UTs),2012,Widowed/Widower,7,24,31
TOTAL (UTs),2012,Divorcee,2,3,5
TOTAL (UTs),2012,Seperated,42,23,65
TOTAL (UTs),2012,Total,1840,938,2778
TOTAL (ALL INDIA),2001,Never Married,14480,9583,24063
TOTAL (ALL INDIA),2001,Married,46842,28281,75123
TOTAL (ALL INDIA),2001,Widowed/Widower,2377,2548,4925
TOTAL (ALL INDIA),2001,Divorcee,708,643,1351
TOTAL (ALL INDIA),2001,Seperated,1907,1137,3044
TOTAL (ALL INDIA),2001,Total,66314,42192,108506
TOTAL (ALL INDIA),2002,Never Married,15026,9225,24251
TOTAL (ALL INDIA),2002,Married,48409,26936,75345
TOTAL (ALL INDIA),2002,Widowed/Widower,3326,3025,6351
TOTAL (ALL INDIA),2002,Divorcee,684,675,1359
TOTAL (ALL INDIA),2002,Seperated,1887,1224,3111
TOTAL (ALL INDIA),2002,Total,69332,41085,110417
TOTAL (ALL INDIA),2003,Never Married,15339,8798,24137
TOTAL (ALL INDIA),2003,Married,49545,27603,77148
TOTAL (ALL INDIA),2003,Widowed/Widower,2919,2568,5487
TOTAL (ALL INDIA),2003,Divorcee,588,539,1127
TOTAL (ALL INDIA),2003,Seperated,1830,1122,2952
TOTAL (ALL INDIA),2003,Total,70221,40630,110851
TOTAL (ALL INDIA),2004,Never Married,15769,8823,24592
TOTAL (ALL INDIA),2004,Married,51623,28045,79668
TOTAL (ALL INDIA),2004,Widowed/Widower,2363,2377,4740
TOTAL (ALL INDIA),2004,Divorcee,665,532,1197
TOTAL (ALL INDIA),2004,Seperated,2231,1269,3500
TOTAL (ALL INDIA),2004,Total,72651,41046,113697
TOTAL (ALL INDIA),2005,Never Married,15292,8618,23910
TOTAL (ALL INDIA),2005,Married,52483,28188,80671
TOTAL (ALL INDIA),2005,Widowed/Widower,2664,2407,5071
TOTAL (ALL INDIA),2005,Divorcee,559,562,1121
TOTAL (ALL INDIA),2005,Seperated,1918,1223,3141
TOTAL (ALL INDIA),2005,Total,72916,40998,113914
TOTAL (ALL INDIA),2006,Never Married,15607,8812,24419
TOTAL (ALL INDIA),2006,Married,55452,29869,85321
TOTAL (ALL INDIA),2006,Widowed/Widower,2397,2227,4624
TOTAL (ALL INDIA),2006,Divorcee,514,588,1102
TOTAL (ALL INDIA),2006,Seperated,1732,914,2646
TOTAL (ALL INDIA),2006,Total,75702,42410,118112
TOTAL (ALL INDIA),2007,Never Married,16445,9009,25454
TOTAL (ALL INDIA),2007,Married,57593,30064,87657
TOTAL (ALL INDIA),2007,Widowed/Widower,2654,2354,5008
TOTAL (ALL INDIA),2007,Divorcee,526,644,1170
TOTAL (ALL INDIA),2007,Seperated,2077,1271,3348
TOTAL (ALL INDIA),2007,Total,79295,43342,122637
TOTAL (ALL INDIA),2008,Never Married,17809,9835,27644
TOTAL (ALL INDIA),2008,Married,57639,30224,87863
TOTAL (ALL INDIA),2008,Widowed/Widower,2635,2731,5366
TOTAL (ALL INDIA),2008,Divorcee,730,677,1407
TOTAL (ALL INDIA),2008,Seperated,1731,1006,2737
TOTAL (ALL INDIA),2008,Total,80544,44473,125017
TOTAL (ALL INDIA),2009,Never Married,17738,10063,27801
TOTAL (ALL INDIA),2009,Married,58192,31300,89492
TOTAL (ALL INDIA),2009,Widowed/Widower,2848,2674,5522
TOTAL (ALL INDIA),2009,Divorcee,635,613,1248
TOTAL (ALL INDIA),2009,Seperated,2058,1030,3088
TOTAL (ALL INDIA),2009,Total,81471,45680,127151
TOTAL (ALL INDIA),2010,Never Married,19702,11108,30810
TOTAL (ALL INDIA),2010,Married,61453,31754,93207
TOTAL (ALL INDIA),2010,Widowed/Widower,2777,2371,5148
TOTAL (ALL INDIA),2010,Divorcee,735,782,1517
TOTAL (ALL INDIA),2010,Seperated,2513,1404,3917
TOTAL (ALL INDIA),2010,Total,87180,47419,134599
TOTAL (ALL INDIA),2011,Never Married,19907,10756,30663
TOTAL (ALL INDIA),2011,Married,62433,32582,95015
TOTAL (ALL INDIA),2011,Widowed/Widower,2566,2354,4920
TOTAL (ALL INDIA),2011,Divorcee,554,729,1283
TOTAL (ALL INDIA),2011,Seperated,2379,1325,3704
TOTAL (ALL INDIA),2011,Total,87839,47746,135585
TOTAL (ALL INDIA),2012,Never Married,19727,10830,30557
TOTAL (ALL INDIA),2012,Married,63343,31921,95264
TOTAL (ALL INDIA),2012,Widowed/Widower,2658,2293,4951
TOTAL (ALL INDIA),2012,Divorcee,682,708,1390
TOTAL (ALL INDIA),2012,Seperated,2043,1240,3283
